"Account","Flag","Check Number","Date","Payee","Category","Master Category","Sub Category","Memo","Outflow","Inflow","Cleared","Running Balance"
"Us Bank",,,09/18/2013,"Starting Balance","Income:Available this month","Income","Available this month",,$0.00,$2275.09,R,$2275.09
"Us Bank",,,09/18/2013,,"Income:Available this month","Income","Available this month","Balancing",$0.00,$37.24,R,$2312.33
"Us Bank",,,09/19/2013,"Download from usbank.com. Sqwiggle Inc.","Income:Available this month","Income","Available this month","Sqwiggle back pay",$0.00,$1783.36,R,$4095.69
"Us Bank",,,09/19/2013,"Download from usbank.com. HLU*HuluPlus 541HULU.COM/BILCA","Monthly Bills:Web Stuff","Monthly Bills","Web Stuff",,$7.99,$0.00,R,$4087.70
"Us Bank",,,09/19/2013,"Download from usbank.com. CUP A JOES COFFESAN FRANCISCCA","Everyday Expenses:Spending Money","Everyday Expenses","Spending Money",,$9.25,$0.00,R,$4078.45
"Us Bank",,,09/20/2013,"Download from usbank.com. THE POSH BAGEL SAN FRANCISCCA","Everyday Expenses:Spending Money","Everyday Expenses","Spending Money",,$6.10,$0.00,R,$4072.35
"Us Bank",,,09/20/2013,"Download from usbank.com. TRADER JOE'S #20SAN FRANCISCCA","Everyday Expenses:Spending Money","Everyday Expenses","Spending Money",,$9.07,$0.00,R,$4063.28
"Us Bank",,,09/20/2013,"Download from usbank.com. PAYPAL","Everyday Expenses:Spending Money","Everyday Expenses","Spending Money",,$9.99,$0.00,R,$4053.29
"Us Bank",,,09/20/2013,"Download from usbank.com. LYFT 855-865-9553CA","Everyday Expenses:Transportation","Everyday Expenses","Transportation",,$14.00,$0.00,R,$4039.29
"Us Bank",,,09/20/2013,"Download from usbank.com. LYFT 855-865-9553CA","Everyday Expenses:Transportation","Everyday Expenses","Transportation",,$16.00,$0.00,R,$4023.29
"Us Bank",,,09/20/2013,"Download from usbank.com. WOK SHOP CAFE INSAN FRANCISCCA","Everyday Expenses:Spending Money","Everyday Expenses","Spending Money",,$19.50,$0.00,R,$4003.79
"Us Bank",,,09/20/2013,"Download from usbank.com. WALGREENS 1300 BSAN FRANCISCCA","Everyday Expenses:Household Goods","Everyday Expenses","Household Goods",,$21.75,$0.00,R,$3982.04
"Us Bank",,,09/20/2013,"Download from usbank.com. AT&T","Monthly Bills:Cell Phone","Monthly Bills","Cell Phone",,$100.58,$0.00,R,$3881.46
"Us Bank",,,09/23/2013,"Download from usbank.com. CUP A JOES COFFESAN FRANCISCCA","Everyday Expenses:Spending Money","Everyday Expenses","Spending Money",,$2.75,$0.00,R,$3878.71
"Us Bank",,,09/23/2013,"Download from usbank.com. COFFEE BAR - BRYSAN FRANCISCCA","Everyday Expenses:Spending Money","Everyday Expenses","Spending Money",,$3.00,$0.00,R,$3875.71
"Us Bank",,,09/23/2013,"Download from usbank.com. COFFEE BAR - BRYSAN FRANCISCCA","Everyday Expenses:Spending Money","Everyday Expenses","Spending Money",,$3.00,$0.00,R,$3872.71
"Us Bank",,,09/23/2013,"Download from usbank.com. SUTTER FINE FOODSAN FRANCISCCA","Everyday Expenses:Groceries","Everyday Expenses","Groceries",,$5.75,$0.00,R,$3866.96
"Us Bank",,,09/23/2013,"Download from usbank.com. APL*APPLE ITUNES866-712-7753CA","Everyday Expenses:Spending Money","Everyday Expenses","Spending Money",,$5.98,$0.00,R,$3860.98
"Us Bank",,,09/23/2013,"Download from usbank.com. CUP A JOES COFFESAN FRANCISCCA","Everyday Expenses:Spending Money","Everyday Expenses","Spending Money",,$7.50,$0.00,R,$3853.48
"Us Bank",,,09/23/2013,"Download from usbank.com. COFFEE BAR - BRYSAN FRANCISCCA","Everyday Expenses:Spending Money","Everyday Expenses","Spending Money",,$7.89,$0.00,R,$3845.59
"Us Bank",,,09/23/2013,"Download from usbank.com. PINKBERRY SAN FRSAN FRANCISCCA","Everyday Expenses:Spending Money","Everyday Expenses","Spending Money",,$9.90,$0.00,R,$3835.69
"Us Bank",,,09/23/2013,"Download from usbank.com. SMALL FOODS SAN FRANCISCCA","Everyday Expenses:Groceries","Everyday Expenses","Groceries",,$10.97,$0.00,R,$3824.72
"Us Bank",,,09/23/2013,"Download from usbank.com. THE IRON CACTUS SAN FRANCISCCA","Everyday Expenses:Spending Money","Everyday Expenses","Spending Money",,$11.91,$0.00,R,$3812.81
"Us Bank",,,09/23/2013,"Download from usbank.com. GROUPON INC 877-788-7858IL","Everyday Expenses:Spending Money","Everyday Expenses","Spending Money",,$12.00,$0.00,R,$3800.81
"Us Bank",,,09/23/2013,"Download from usbank.com. FLY SAN FRANCISCCA","Everyday Expenses:Spending Money","Everyday Expenses","Spending Money",,$13.00,$0.00,R,$3787.81
"Us Bank",,,09/23/2013,"Download from usbank.com. SEAMLESS 800-905-9322NY","Everyday Expenses:Spending Money","Everyday Expenses","Spending Money",,$22.29,$0.00,R,$3765.52
"Us Bank",,,09/23/2013,"Download from usbank.com. FLY SAN FRANCISCCA","Everyday Expenses:Spending Money","Everyday Expenses","Spending Money",,$23.00,$0.00,R,$3742.52
"Us Bank",,,09/23/2013,"Download from usbank.com. SQ *JAMES L CHENSan FranciscCA","Everyday Expenses:Medical","Everyday Expenses","Medical",,$25.00,$0.00,R,$3717.52
"Us Bank",,,09/23/2013,"Download from usbank.com. MOULIN CAFE/887 SAN FRANCISCCA","Everyday Expenses:Spending Money","Everyday Expenses","Spending Money",,$26.03,$0.00,R,$3691.49
"Us Bank",,,09/23/2013,"Download from usbank.com. APPLE STORE #R0SAN FRANCISCCA","Everyday Expenses:Spending Money","Everyday Expenses","Spending Money",,$31.54,$0.00,R,$3659.95
"Us Bank",,,09/23/2013,"Download from usbank.com. APL*APPLE ONLINE800-676-2775CA","Everyday Expenses:Spending Money","Everyday Expenses","Spending Money",,$42.41,$0.00,R,$3617.54
"Us Bank",,,09/23/2013,"Download from usbank.com. WPY*Honeyfund 855-469-3729CA","Rainy Day Funds:Gifts","Rainy Day Funds","Gifts",,$50.00,$0.00,R,$3567.54
"Us Bank",,,09/23/2013,"Download from usbank.com. FLOUR AND WATER SAN FRANCISCCA","Everyday Expenses:Spending Money","Everyday Expenses","Spending Money",,$57.90,$0.00,R,$3509.64
"Us Bank",,,09/23/2013,"Download from usbank.com. BT *TASKRABBIT 888-661-8105CA","Everyday Expenses:Household Goods","Everyday Expenses","Household Goods",,$87.00,$0.00,R,$3422.64
"Us Bank",,,09/23/2013,"Download from usbank.com. FLY SAN FRANCISCCA","Everyday Expenses:Spending Money","Everyday Expenses","Spending Money",,$109.73,$0.00,R,$3312.91
"Us Bank",,,09/23/2013,"Download from usbank.com. AMAZON MKTPLACE AMZN.COM/BILWA","Everyday Expenses:Household Goods","Everyday Expenses","Household Goods",,$134.47,$0.00,R,$3178.44
"Us Bank",,,09/23/2013,"Download from usbank.com. POTTERY BARN E-C800-922-9934CA","Everyday Expenses:Household Goods","Everyday Expenses","Household Goods",,$143.55,$0.00,R,$3034.89
"Us Bank",,,09/23/2013,"Download from usbank.com. APPLE STORE #R0SAN FRANCISCCA","Everyday Expenses:Spending Money","Everyday Expenses","Spending Money",,$147.04,$0.00,R,$2887.85
"Us Bank",,,09/23/2013,"Download from usbank.com. SOUTHWES 5260800-435-9792TX","Rainy Day Funds:Gifts","Rainy Day Funds","Gifts",,$250.00,$0.00,R,$2637.85
"Us Bank",,,09/23/2013,"Download from usbank.com. 7246","Debt:Eric's Credit Card","Debt","Eric's Credit Card",,$438.22,$0.00,R,$2199.63
"Us Bank",,,09/24/2013,"Download from usbank.com. SQ *CAFE BEAN San FranciscCA","Everyday Expenses:Spending Money","Everyday Expenses","Spending Money",,$2.45,$0.00,R,$2197.18
"Us Bank",,,09/24/2013,"Download from usbank.com. NNT VILLAGE PETSSAN FRANCISCCA","Everyday Expenses:Household Goods","Everyday Expenses","Household Goods",,$5.43,$0.00,R,$2191.75
"Us Bank",,,09/24/2013,"Download from usbank.com. WALGREENS 901 HYSAN FRANCISCCA","Everyday Expenses:Groceries","Everyday Expenses","Groceries",,$15.00,$0.00,R,$2176.75
"Us Bank",,,09/24/2013,"Download from usbank.com. SUDACHI SAN FRANCISCCA","Everyday Expenses:Spending Money","Everyday Expenses","Spending Money",,$17.81,$0.00,R,$2158.94
"Us Bank",,,09/24/2013,"Download from usbank.com. WALGREENS 500 GESAN FRANCISCCA","Everyday Expenses:Household Goods","Everyday Expenses","Household Goods",,$21.84,$0.00,R,$2137.10
"Us Bank",,,09/24/2013,"Download from usbank.com. TRADER JOE'S #20SAN FRANCISCCA","Everyday Expenses:Spending Money","Everyday Expenses","Spending Money",,$27.39,$0.00,R,$2109.71
"Us Bank",,,09/24/2013,"Download from usbank.com. WHOLE FOODS MARKSan FranciscCA","Everyday Expenses:Groceries","Everyday Expenses","Groceries",,$29.90,$0.00,R,$2079.81
"Us Bank",,,09/24/2013,"Download from usbank.com. SF PARTY SAN FRANCISCCA","Everyday Expenses:Spending Money","Everyday Expenses","Spending Money",,$32.61,$0.00,R,$2047.20
"Us Bank",,,09/24/2013,"Download from usbank.com. WHOLE FOODS MARKSan FranciscCA","Everyday Expenses:Groceries","Everyday Expenses","Groceries",,$173.51,$0.00,R,$1873.69
"Us Bank",,,09/25/2013,"Download from usbank.com. CUP A JOES COFFESAN FRANCISCCA","Everyday Expenses:Spending Money","Everyday Expenses","Spending Money",,$6.50,$0.00,R,$1867.19
"Us Bank",,,09/25/2013,"Download from usbank.com. HLU*HuluPlus 541HULU.COM/BILCA","Monthly Bills:Web Stuff","Monthly Bills","Web Stuff",,$7.99,$0.00,R,$1859.20
"Us Bank",,,09/25/2013,"Download from usbank.com. MINT STUDIOS SAN FRANCISCCA","Everyday Expenses:Spending Money","Everyday Expenses","Spending Money",,$50.00,$0.00,R,$1809.20
"Us Bank",,,09/26/2013,"Download from usbank.com. AMAZON MKTPLACE AMZN.COM/BILWA","Everyday Expenses:Household Goods","Everyday Expenses","Household Goods",,$0.00,$7.81,R,$1817.01
"Us Bank",,,09/26/2013,"Download from usbank.com. VENMO 646-863-9557NY","Everyday Expenses:Spending Money","Everyday Expenses","Spending Money",,$10.00,$0.00,R,$1807.01
"Us Bank",,,09/27/2013,"Download from usbank.com. MODCLOTH INC","Income:Available next month","Income","Available next month",,$0.00,$1451.21,R,$3258.22
"Us Bank",,,09/27/2013,"Download from usbank.com.","Income:Available next month","Income","Available next month",,$0.00,$129.04,R,$3387.26
"Us Bank",,,09/27/2013,"Download from usbank.com.","Income:Available next month","Income","Available next month",,$0.50,$0.00,R,$3386.76
"Us Bank",,,09/27/2013,"Download from usbank.com. EPICENTER CAFE SAN FRANCISCCA","Everyday Expenses:Spending Money","Everyday Expenses","Spending Money",,$4.08,$0.00,R,$3382.68
"Us Bank",,,09/27/2013,"Download from usbank.com. CVS 10080 10080-SAN FRANCISCCA","Everyday Expenses:Household Goods","Everyday Expenses","Household Goods",,$14.84,$0.00,R,$3367.84
"Us Bank",,,09/27/2013,"Download from usbank.com. TRADER JOE'S #20SAN FRANCISCCA","Everyday Expenses:Groceries","Everyday Expenses","Groceries",,$33.40,$0.00,R,$3334.44
"Us Bank",,,09/27/2013,"Download from usbank.com. SQ *BEAUTIFIED SSan FranciscCA","Everyday Expenses:Spending Money","Everyday Expenses","Spending Money",,$60.00,$0.00,R,$3274.44
"Us Bank",,,09/30/2013,"Download from usbank.com. SQWIGGLE INC","Income:Available next month","Income","Available next month",,$0.00,$1783.36,R,$5057.80
"Us Bank",,,09/30/2013,"Download from usbank.com. SF PARTY SAN FRANCISCCA","Everyday Expenses:Spending Money","Everyday Expenses","Spending Money",,$0.00,$32.61,R,$5090.41
"Us Bank",,,09/30/2013,"Download from usbank.com. DENNIS DECOTA SAN ANSELMO CA","Everyday Expenses:Spending Money","Everyday Expenses","Spending Money",,$4.40,$0.00,R,$5086.01
"Us Bank",,,09/30/2013,"Download from usbank.com. TRADER JOE'S #20SAN FRANCISCCA","Everyday Expenses:Groceries","Everyday Expenses","Groceries",,$4.49,$0.00,R,$5081.52
"Us Bank",,,09/30/2013,"Download from usbank.com. TRADER JOE'S #20SAN FRANCISCCA","Everyday Expenses:Groceries","Everyday Expenses","Groceries",,$7.70,$0.00,R,$5073.82
"Us Bank",,,09/30/2013,"Download from usbank.com. CUP A JOES COFFESAN FRANCISCCA","Everyday Expenses:Spending Money","Everyday Expenses","Spending Money",,$9.25,$0.00,R,$5064.57
"Us Bank",,,09/30/2013,"Download from usbank.com. THE CREAMERY SAN FRANCISCCA","Everyday Expenses:Spending Money","Everyday Expenses","Spending Money",,$11.47,$0.00,R,$5053.10
"Us Bank",,,09/30/2013,"Download from usbank.com. WALGREENS 1300 BSAN FRANCISCCA","Everyday Expenses:Household Goods","Everyday Expenses","Household Goods",,$15.21,$0.00,R,$5037.89
"Us Bank",,,09/30/2013,"Download from usbank.com. SUTTER FINE FOODSAN FRANCISCCA","Everyday Expenses:Groceries","Everyday Expenses","Groceries",,$19.01,$0.00,R,$5018.88
"Us Bank",,,09/30/2013,"Download from usbank.com. BITE SAN FRANCISCCA","Everyday Expenses:Spending Money","Everyday Expenses","Spending Money",,$20.72,$0.00,R,$4998.16
"Us Bank",,,09/30/2013,"Download from usbank.com. TRADER JOE'S #20SAN FRANCISCCA","Everyday Expenses:Groceries","Everyday Expenses","Groceries",,$36.65,$0.00,R,$4961.51
"Us Bank",,,09/30/2013,"Download from usbank.com. LIVINGSOCIAL* 202-695-8945DC","Everyday Expenses:Medical","Everyday Expenses","Medical",,$47.00,$0.00,R,$4914.51
"Us Bank",,,10/01/2013,"Download from usbank.com. AMC VAN NESS 04San FranciscCA","Everyday Expenses:Spending Money","Everyday Expenses","Spending Money",,$4.75,$0.00,R,$4909.76
"Us Bank",,,10/01/2013,"Download from usbank.com. AMC VAN NESS 04San FranciscCA","Everyday Expenses:Spending Money","Everyday Expenses","Spending Money",,$20.50,$0.00,R,$4889.26
"Us Bank",,,10/01/2013,"Download from usbank.com. MET CAS INS CO","Monthly Bills:Car Insurance","Monthly Bills","Car Insurance",,$46.00,$0.00,R,$4843.26
"Us Bank",,,10/02/2013,"Download from usbank.com. SUTTER FINE FOODSAN FRANCISCCA","Everyday Expenses:Groceries","Everyday Expenses","Groceries",,$3.49,$0.00,R,$4839.77
"Us Bank",,,10/02/2013,"Download from usbank.com. SUNDANCE KAB 818-889-8562CA","Everyday Expenses:Spending Money","Everyday Expenses","Spending Money",,$13.50,$0.00,R,$4826.27
"Us Bank",,,10/03/2013,"Download from usbank.com. SQ *SHOWPLACE CASan FranciscCA","Everyday Expenses:Spending Money","Everyday Expenses","Spending Money",,$4.00,$0.00,R,$4822.27
"Us Bank",,,10/03/2013,"Download from usbank.com. SQ *SHOWPLACE CASan FranciscCA","Everyday Expenses:Spending Money","Everyday Expenses","Spending Money",,$5.00,$0.00,R,$4817.27
"Us Bank",,,10/03/2013,"Download from usbank.com. WHOLE FOODS MARKSan FranciscCA","Everyday Expenses:Groceries","Everyday Expenses","Groceries",,$7.98,$0.00,R,$4809.29
"Us Bank",,,10/03/2013,"Download from usbank.com. WALGREENS 1300 BSAN FRANCISCCA","Everyday Expenses:Household Goods","Everyday Expenses","Household Goods",,$16.07,$0.00,R,$4793.22
"Us Bank",,,10/04/2013,"Download from usbank.com. THE CELLAR SAN FRANCISCCA","Everyday Expenses:Spending Money","Everyday Expenses","Spending Money",,$4.00,$0.00,R,$4789.22
"Us Bank",,,10/04/2013,"Download from usbank.com. WOK SHOP CAFE INSAN FRANCISCCA","Everyday Expenses:Spending Money","Everyday Expenses","Spending Money",,$9.85,$0.00,R,$4779.37
"Us Bank",,,10/04/2013,"Download from usbank.com. THE CELLAR SAN FRANCISCCA","Everyday Expenses:Spending Money","Everyday Expenses","Spending Money",,$10.88,$0.00,R,$4768.49
"Us Bank",,,10/04/2013,"Download from usbank.com. BEVERAGES & MORESAN FRANCISCCA","Everyday Expenses:Spending Money","Everyday Expenses","Spending Money",,$10.92,$0.00,R,$4757.57
"Us Bank",,,10/04/2013,"Download from usbank.com. WALGREENS 670 4TSAN FRANCISCCA","Everyday Expenses:Household Goods","Everyday Expenses","Household Goods",,$21.70,$0.00,R,$4735.87
"Us Bank",,,10/04/2013,"Download from usbank.com. PAYPAL","Everyday Expenses:Spending Money","Everyday Expenses","Spending Money",,$35.82,$0.00,R,$4700.05
"Us Bank",,,10/07/2013,"Download from usbank.com. EyeExam 30SAN FRANCISCCA","Everyday Expenses:Medical","Everyday Expenses","Medical",,$0.00,$79.95,R,$4780.00
"Us Bank",,,10/07/2013,"Download from usbank.com. CUP A JOES COFFESAN FRANCISCCA","Everyday Expenses:Spending Money","Everyday Expenses","Spending Money",,$3.75,$0.00,R,$4776.25
"Us Bank",,,10/07/2013,"Download from usbank.com. CUP A JOES COFFESAN FRANCISCCA","Everyday Expenses:Spending Money","Everyday Expenses","Spending Money",,$3.75,$0.00,R,$4772.50
"Us Bank",,,10/07/2013,"Download from usbank.com. CCSF MTA IPS PRKSAN FRANCISCCA","Everyday Expenses:Transportation","Everyday Expenses","Transportation",,$5.25,$0.00,R,$4767.25
"Us Bank",,,10/07/2013,"Download from usbank.com. GOOGLE*ADWS","Monthly Bills:Web Stuff","Monthly Bills","Web Stuff",,$6.20,$0.00,R,$4761.05
"Us Bank",,,10/07/2013,"Download from usbank.com. GAMESCAPE SAN FRANCISCCA","Everyday Expenses:Spending Money","Everyday Expenses","Spending Money",,$6.53,$0.00,R,$4754.52
"Us Bank",,,10/07/2013,"Download from usbank.com. BI-RITE DIVIS SAN FRANCISCCA","Everyday Expenses:Spending Money","Everyday Expenses","Spending Money",,$7.00,$0.00,R,$4747.52
"Us Bank",,,10/07/2013,"Download from usbank.com. SNPFINGERONLINEF678-739-4669GA","Everyday Expenses:Spending Money","Everyday Expenses","Spending Money",,$11.52,$0.00,R,$4736.00
"Us Bank",,,10/07/2013,"Download from usbank.com. TRADER JOE'S #20SAN FRANCISCCA","Everyday Expenses:Groceries","Everyday Expenses","Groceries",,$19.75,$0.00,R,$4716.25
"Us Bank",,,10/07/2013,"Download from usbank.com. FANDANGO.COM FANDANGO.COMCA","Everyday Expenses:Spending Money","Everyday Expenses","Spending Money",,$24.00,$0.00,R,$4692.25
"Us Bank",,,10/07/2013,"Download from usbank.com. WOK SHOP CAFE INSAN FRANCISCCA","Everyday Expenses:Spending Money","Everyday Expenses","Spending Money",,$24.10,$0.00,R,$4668.15
"Us Bank",,,10/07/2013,"Download from usbank.com. CVS 02852 02852-SAN FRANCISCCA","Everyday Expenses:Household Goods","Everyday Expenses","Household Goods",,$24.34,$0.00,R,$4643.81
"Us Bank",,,10/07/2013,"Download from usbank.com. EyeExam 30SAN FRANCISCCA","Everyday Expenses:Medical","Everyday Expenses","Medical",,$29.70,$0.00,R,$4614.11
"Us Bank",,,10/07/2013,"Download from usbank.com. SQ *UPCIDER San FranciscCA","Everyday Expenses:Spending Money","Everyday Expenses","Spending Money",,$41.60,$0.00,R,$4572.51
"Us Bank",,,10/07/2013,"Download from usbank.com. WASTELAND SAN FRSAN FRANCISCCA","Everyday Expenses:Spending Money","Everyday Expenses","Spending Money",,$120.71,$0.00,R,$4451.80
"Us Bank",,,10/07/2013,"Download from usbank.com. TRADER JOE'S #20SAN FRANCISCCA","Everyday Expenses:Groceries","Everyday Expenses","Groceries",,$130.36,$0.00,R,$4321.44
"Us Bank",,,10/07/2013,"Download from usbank.com. APL*APPLE ONLINE800-676-2775CA","Everyday Expenses:Spending Money","Everyday Expenses","Spending Money",,$255.79,$0.00,R,$4065.65
"Us Bank",,,10/07/2013,"Download from usbank.com.","Monthly Bills:Rent","Monthly Bills","Rent",,$1615.29,$0.00,R,$2450.36
"Us Bank",,,10/08/2013,"Reconciliation Balance Adjustment","Income:Available this month","Income","Available this month","Entered automatically by YNAB",$4.08,$0.00,R,$2446.28
"Us Bank",,,10/08/2013,"Download from usbank.com. GOODWILL SF - HASAN FRANCISCCA","Everyday Expenses:Spending Money","Everyday Expenses","Spending Money",,$4.98,$0.00,R,$2441.30
"Us Bank",,,10/08/2013,"Download from usbank.com. SQ *CAL SURPLUS San FranciscCA","Everyday Expenses:Spending Money","Everyday Expenses","Spending Money",,$17.36,$0.00,R,$2423.94
"Us Bank",,,10/08/2013,"Download from usbank.com. SPARROW BAR AND SAN FRANCISCCA","Everyday Expenses:Spending Money","Everyday Expenses","Spending Money",,$43.00,$0.00,R,$2380.94
"Us Bank",,,10/09/2013,"Download from usbank.com. VENMO","Monthly Bills:Rent","Monthly Bills","Rent",,$0.00,$414.13,R,$2795.07
"Us Bank",,,10/09/2013,"Download from usbank.com. WHOLE FOODS MARKSan FranciscCA","Everyday Expenses:Groceries","Everyday Expenses","Groceries",,$57.39,$0.00,R,$2737.68
"Us Bank",,,10/09/2013,"Download from usbank.com. Amazon.com AMZN.COM/BILWA","Everyday Expenses:Spending Money","Everyday Expenses","Spending Money",,$68.76,$0.00,R,$2668.92
"Us Bank",,,10/10/2013,"Download from usbank.com. SQ *QUALITY BEVESan FranciscCA","Everyday Expenses:Spending Money","Everyday Expenses","Spending Money",,$8.00,$0.00,R,$2660.92
"Us Bank",,,10/10/2013,"Download from usbank.com. SQ *QUALITY BEVESan FranciscCA","Everyday Expenses:Spending Money","Everyday Expenses","Spending Money",,$13.00,$0.00,R,$2647.92
"Us Bank",,,10/10/2013,"Download from usbank.com. CARDMEMBER SERV",,,,,$42.00,$0.00,R,$2605.92
"Us Bank",,,10/11/2013,"Download from usbank.com. MODCLOTH INC","Income:Available this month","Income","Available this month",,$0.00,$1451.21,R,$4057.13
"Us Bank",,,10/11/2013,"Download from usbank.com. WHOLE FOODS MARKSan FranciscCA","Everyday Expenses:Groceries","Everyday Expenses","Groceries",,$7.81,$0.00,R,$4049.32
"Us Bank",,,10/11/2013,"Download from usbank.com. ORDERAHEADAPP.CO6505033279 CA","Everyday Expenses:Spending Money","Everyday Expenses","Spending Money",,$10.82,$0.00,R,$4038.50
"Us Bank",,,10/11/2013,"Download from usbank.com. LYFT 855-865-9553CA","Everyday Expenses:Transportation","Everyday Expenses","Transportation",,$14.00,$0.00,R,$4024.50
"Us Bank",,,10/11/2013,"Download from usbank.com. WALGREENS 1300 BSAN FRANCISCCA","Everyday Expenses:Household Goods","Everyday Expenses","Household Goods",,$34.85,$0.00,R,$3989.65
"Us Bank",,,10/11/2013,"Download from usbank.com. OLSEN & PARTNERSSAN FRANCISCCA","Everyday Expenses:Misc","Everyday Expenses","Misc","One time charge for filing taxes",$550.00,$0.00,R,$3439.65
"Us Bank",,,10/15/2013,"Download from usbank.com. SQWIGGLE INC","Income:Available this month","Income","Available this month",,$0.00,$1783.37,R,$5223.02
"Us Bank",,,10/15/2013,"Download from usbank.com. GOOGLE *Offers GOOGLE.COM/CCA","Monthly Bills:Web Stuff","Monthly Bills","Web Stuff",,$0.00,$38.00,R,$5261.02
"Us Bank",,,10/15/2013,"Download from usbank.com. GOOGLE *Offers GOOGLE.COM/CCA","Monthly Bills:Web Stuff","Monthly Bills","Web Stuff",,$0.00,$5.00,R,$5266.02
"Us Bank",,,10/15/2013,"Download from usbank.com. 101413PLUSTERM1233 17th Stret San FranciscCAUS1","Everyday Expenses:Spending Money","Everyday Expenses","Spending Money",,$2.50,$0.00,R,$5263.52
"Us Bank",,,10/15/2013,"Download from usbank.com. EPICENTER CAFE SAN FRANCISCCA","Everyday Expenses:Spending Money","Everyday Expenses","Spending Money",,$2.75,$0.00,R,$5260.77
"Us Bank",,,10/15/2013,"Download from usbank.com. APL*APPLE ITUNES866-712-7753CA","Everyday Expenses:Spending Money","Everyday Expenses","Spending Money",,$2.99,$0.00,R,$5257.78
"Us Bank",,,10/15/2013,"Download from usbank.com. QUETZAL SAN FRANCISCCA","Everyday Expenses:Spending Money","Everyday Expenses","Spending Money",,$3.50,$0.00,R,$5254.28
"Us Bank",,,10/15/2013,"Download from usbank.com. NANOS YOGURT SHAHALF MOON BACA","Everyday Expenses:Spending Money","Everyday Expenses","Spending Money",,$5.50,$0.00,R,$5248.78
"Us Bank",,,10/15/2013,"Download from usbank.com. STARBUCKS #05405San FranciscCA","Everyday Expenses:Spending Money","Everyday Expenses","Spending Money",,$6.80,$0.00,R,$5241.98
"Us Bank",,,10/15/2013,"Download from usbank.com. CVS 10080 SAN FRANCISCCA","Everyday Expenses:Household Goods","Everyday Expenses","Household Goods",,$8.69,$0.00,R,$5233.29
"Us Bank",,,10/15/2013,"Download from usbank.com. ANGRAY FANTASTICSAN FRANCISCCA","Everyday Expenses:Spending Money","Everyday Expenses","Spending Money",,$9.24,$0.00,R,$5224.05
"Us Bank",,,10/15/2013,"Download from usbank.com. LYFT 855-865-9553CA","Everyday Expenses:Transportation","Everyday Expenses","Transportation",,$10.00,$0.00,R,$5214.05
"Us Bank",,,10/15/2013,"Download from usbank.com. VENMO 646-863-9557NY","Everyday Expenses:Spending Money","Everyday Expenses","Spending Money",,$10.00,$0.00,R,$5204.05
"Us Bank",,,10/15/2013,"Download from usbank.com. WHOLE FOODS MARKSan FranciscCA","Everyday Expenses:Groceries","Everyday Expenses","Groceries",,$11.64,$0.00,R,$5192.41
"Us Bank",,,10/15/2013,"Download from usbank.com. GROUPON INC 877-788-7858IL","Everyday Expenses:Spending Money","Everyday Expenses","Spending Money",,$12.00,$0.00,R,$5180.41
"Us Bank",,,10/15/2013,"Download from usbank.com. CUP A JOES COFFESAN FRANCISCCA","Everyday Expenses:Spending Money","Everyday Expenses","Spending Money",,$18.20,$0.00,R,$5162.21
"Us Bank",,,10/15/2013,"Download from usbank.com. SLIDERS DINER SAN FRANCISCCA","Everyday Expenses:Spending Money","Everyday Expenses","Spending Money",,$22.57,$0.00,R,$5139.64
"Us Bank",,,10/15/2013,"Download from usbank.com. SUDACHI SAN FRANCISCCA","Everyday Expenses:Spending Money","Everyday Expenses","Spending Money",,$22.64,$0.00,R,$5117.00
"Us Bank",,,10/15/2013,"Download from usbank.com. TACOLICIOUS II SAN FRANCISCCA","Everyday Expenses:Spending Money","Everyday Expenses","Spending Money",,$25.45,$0.00,R,$5091.55
"Us Bank",,,10/15/2013,"Download from usbank.com. Discount GrocersSan FranciscCA","Everyday Expenses:Groceries","Everyday Expenses","Groceries",,$29.91,$0.00,R,$5061.64
"Us Bank",,,10/15/2013,"Download from usbank.com. CHEZ SHEA HALF MOON BACA","Everyday Expenses:Spending Money","Everyday Expenses","Spending Money",,$45.41,$0.00,R,$5016.23
"Us Bank",,,10/15/2013,"Download from usbank.com. 1233 17th Stret San FranciscCAUS1","Everyday Expenses:Spending Money","Everyday Expenses","Spending Money",,$62.95,$0.00,R,$4953.28
"Us Bank",,,10/15/2013,"Download from usbank.com. TRADER JOE'S #20SAN FRANCISCCA","Everyday Expenses:Groceries","Everyday Expenses","Groceries",,$132.77,$0.00,R,$4820.51
"Us Bank",,,10/16/2013,"Download from usbank.com. EPICENTER CAFE SAN FRANCISCCA","Everyday Expenses:Spending Money","Everyday Expenses","Spending Money",,$2.99,$0.00,R,$4817.52
"Us Bank",,,10/17/2013,"Download from usbank.com. CAPITAL ONE 360 SAN FRANCISCCA","Everyday Expenses:Spending Money","Everyday Expenses","Spending Money",,$2.00,$0.00,R,$4815.52
"Us Bank",,,10/17/2013,"Download from usbank.com. AMAZON MKTPLACE AMZN.COM/BILWA","Everyday Expenses:Spending Money","Everyday Expenses","Spending Money",,$3.17,$0.00,R,$4812.35
"Us Bank",,,10/17/2013,"Download from usbank.com. CHIPOTLE 1857 SAN FRANCISCCA","Everyday Expenses:Spending Money","Everyday Expenses","Spending Money",,$7.56,$0.00,R,$4804.79
"Us Bank",,,10/17/2013,"Download from usbank.com. VENMO 646-863-9557NY","Everyday Expenses:Spending Money","Everyday Expenses","Spending Money",,$9.00,$0.00,R,$4795.79
"Us Bank",,,10/17/2013,"Download from usbank.com. Spotify USA 877-778-1161NY","Monthly Bills:Web Stuff","Monthly Bills","Web Stuff",,$9.99,$0.00,R,$4785.80
"Us Bank",,,10/17/2013,"Download from usbank.com. AMAZON MKTPLACE AMZN.COM/BILWA","Everyday Expenses:Spending Money","Everyday Expenses","Spending Money",,$15.15,$0.00,R,$4770.65
"Us Bank",,,10/17/2013,"Download from usbank.com. AMAZON MKTPLACE AMZN.COM/BILWA","Everyday Expenses:Spending Money","Everyday Expenses","Spending Money",,$20.97,$0.00,R,$4749.68
"Us Bank",,,10/17/2013,"Download from usbank.com. AMAZON MKTPLACE AMZN.COM/BILWA","Everyday Expenses:Spending Money","Everyday Expenses","Spending Money",,$29.98,$0.00,R,$4719.70
"Us Bank",,,10/17/2013,"Download from usbank.com. AMAZON MKTPLACE AMZN.COM/BILWA","Everyday Expenses:Spending Money","Everyday Expenses","Spending Money",,$30.34,$0.00,R,$4689.36
"Us Bank",,,10/18/2013,"Download from usbank.com. WOK SHOP CAFE INSAN FRANCISCCA","Everyday Expenses:Spending Money","Everyday Expenses","Spending Money",,$25.40,$0.00,R,$4663.96
"Us Bank",,,10/18/2013,"Download from usbank.com. MODCLOTH INC. 888-4959699 CA","Everyday Expenses:Spending Money","Everyday Expenses","Spending Money",,$119.06,$0.00,R,$4544.90
"Us Bank",,,10/20/2013,"Reconciliation Balance Adjustment","Everyday Expenses:Spending Money","Everyday Expenses","Spending Money","9.33",$9.33,$0.00,R,$4535.57
"Us Bank",,,10/21/2013,"Download from usbank.com. CUP A JOES COFFESAN FRANCISCCA","Everyday Expenses:Spending Money","Everyday Expenses","Spending Money",,$4.50,$0.00,R,$4531.07
"Us Bank",,,10/21/2013,"Download from usbank.com. THE CELLAR SAN FRANCISCCA","Everyday Expenses:Spending Money","Everyday Expenses","Spending Money",,$4.50,$0.00,R,$4526.57
"Us Bank",,,10/21/2013,"Download from usbank.com. SUTTER FINE FOODSAN FRANCISCCA","Everyday Expenses:Groceries","Everyday Expenses","Groceries",,$6.51,$0.00,R,$4520.06
"Us Bank",,,10/21/2013,"Download from usbank.com. HLU*HuluPlus 541HULU.COM/BILCA","Monthly Bills:Web Stuff","Monthly Bills","Web Stuff",,$7.99,$0.00,R,$4512.07
"Us Bank",,,10/21/2013,"Download from usbank.com. SUTTER FINE FOODSAN FRANCISCCA","Everyday Expenses:Groceries","Everyday Expenses","Groceries",,$10.86,$0.00,R,$4501.21
"Us Bank",,,10/21/2013,"Download from usbank.com. LYFT 855-865-9553CA","Everyday Expenses:Transportation","Everyday Expenses","Transportation",,$11.00,$0.00,R,$4490.21
"Us Bank",,,10/21/2013,"Download from usbank.com. THE CELLAR SAN FRANCISCCA","Everyday Expenses:Spending Money","Everyday Expenses","Spending Money",,$13.00,$0.00,R,$4477.21
"Us Bank",,,10/21/2013,"Download from usbank.com. EPICENTER CAFE SAN FRANCISCCA","Everyday Expenses:Spending Money","Everyday Expenses","Spending Money",,$18.22,$0.00,R,$4458.99
"Us Bank",,,10/21/2013,"Download from usbank.com. BITE SAN FRANCISCCA","Everyday Expenses:Spending Money","Everyday Expenses","Spending Money",,$18.64,$0.00,R,$4440.35
"Us Bank",,,10/21/2013,"Download from usbank.com. PAYPAL","Everyday Expenses:Spending Money","Everyday Expenses","Spending Money",,$27.00,$0.00,R,$4413.35
"Us Bank",,,10/21/2013,"Download from usbank.com. MYMY COFFEE SHOPSAN FRANCISCCA","Everyday Expenses:Spending Money","Everyday Expenses","Spending Money",,$28.82,$0.00,R,$4384.53
"Us Bank",,,10/21/2013,"Download from usbank.com. JASPERS CORNER TSAN FRANCISCCA","Everyday Expenses:Spending Money","Everyday Expenses","Spending Money",,$50.37,$0.00,R,$4334.16
"Us Bank",,,10/21/2013,"Download from usbank.com. WALGREENS 1300 BSAN FRANCISCCA","Everyday Expenses:Household Goods","Everyday Expenses","Household Goods",,$62.35,$0.00,R,$4271.81
"Us Bank",,,10/21/2013,"Download from usbank.com. 647 Valencia St San FranciscCAUS1","Everyday Expenses:Spending Money","Everyday Expenses","Spending Money",,$62.50,$0.00,R,$4209.31
"Us Bank",,,10/21/2013,"Download from usbank.com. GE Capital",,,,,$116.00,$0.00,R,$4093.31
"Us Bank",,,10/21/2013,"Download from usbank.com. ATT","Monthly Bills:Cell Phone","Monthly Bills","Cell Phone",,$326.21,$0.00,R,$3767.10
"Us Bank",,,10/21/2013,"Download from usbank.com. 7246","Debt:Eric's Credit Card","Debt","Eric's Credit Card",,$750.00,$0.00,R,$3017.10
"Us Bank",,,10/22/2013,"Download from usbank.com. THE CELLAR SAN FRANCISCCA","Everyday Expenses:Spending Money","Everyday Expenses","Spending Money",,$4.00,$0.00,R,$3013.10
"Us Bank",,,10/22/2013,"Download from usbank.com. CAPITAL ONE 360 SAN FRANCISCCA","Everyday Expenses:Spending Money","Everyday Expenses","Spending Money",,$11.00,$0.00,R,$3002.10
"Us Bank",,,10/22/2013,"Download from usbank.com. THE CELLAR SAN FRANCISCCA","Everyday Expenses:Spending Money","Everyday Expenses","Spending Money",,$11.00,$0.00,R,$2991.10
"Us Bank",,,10/22/2013,"Download from usbank.com. CVS 10080 SAN FRANCISCCA","Everyday Expenses:Household Goods","Everyday Expenses","Household Goods",,$15.65,$0.00,R,$2975.45
"Us Bank",,,10/22/2013,"Download from usbank.com. FLY SAN FRANCISCCA","Everyday Expenses:Spending Money","Everyday Expenses","Spending Money",,$62.65,$0.00,R,$2912.80
"Us Bank",,,10/22/2013,"Download from usbank.com. TRADER JOE'S #20SAN FRANCISCCA","Everyday Expenses:Groceries","Everyday Expenses","Groceries",,$93.87,$0.00,R,$2818.93
"Us Bank",,,10/23/2013,"Download from usbank.com. THE IRON CACTUS SAN FRANCISCCA","Everyday Expenses:Spending Money","Everyday Expenses","Spending Money",,$5.00,$0.00,R,$2813.93
"Us Bank",,,10/23/2013,"Download from usbank.com. THE IRON CACTUS SAN FRANCISCCA","Everyday Expenses:Spending Money","Everyday Expenses","Spending Money",,$7.18,$0.00,R,$2806.75
"Us Bank",,,10/23/2013,"Download from usbank.com. DAVID HOLT SAN FRANCISCCA","Everyday Expenses:Spending Money","Everyday Expenses","Spending Money",,$60.00,$0.00,R,$2746.75
"Us Bank",,,10/24/2013,"Download from usbank.com. USPS 0568320009 SAN FRANCISCCA","Everyday Expenses:Spending Money","Everyday Expenses","Spending Money",,$1.12,$0.00,R,$2745.63
"Us Bank",,,10/24/2013,"Download from usbank.com. ADY*Uber Technol866-5761039 CA","Everyday Expenses:Spending Money","Everyday Expenses","Spending Money",,$8.25,$0.00,R,$2737.38
"Us Bank",,,10/24/2013,"Download from usbank.com. PAYPAL","Everyday Expenses:Spending Money","Everyday Expenses","Spending Money",,$54.00,$0.00,R,$2683.38
"Us Bank",,,10/25/2013,"Download from usbank.com. MODCLOTH INC","Income:Available this month","Income","Available this month",,$0.00,$1451.20,R,$4134.58
"Us Bank",,,10/25/2013,"Download from usbank.com. HLU*HuluPlus 111HULU.COM/BILCA","Monthly Bills:Web Stuff","Monthly Bills","Web Stuff",,$7.99,$0.00,R,$4126.59
"Us Bank",,,10/28/2013,"Download from usbank.com. STARBUCKS #14393San FranciscCA","Everyday Expenses:Spending Money","Everyday Expenses","Spending Money",,$3.65,$0.00,R,$4122.94
"Us Bank",,,10/28/2013,"Download from usbank.com. THE CELLAR SAN FRANCISCCA","Everyday Expenses:Spending Money","Everyday Expenses","Spending Money",,$4.00,$0.00,R,$4118.94
"Us Bank",,,10/28/2013,"Download from usbank.com. AMC VAN NESS 14 SAN FRANCISCCA","Everyday Expenses:Spending Money","Everyday Expenses","Spending Money",,$4.75,$0.00,R,$4114.19
"Us Bank",,,10/28/2013,"Download from usbank.com. APL*APPLE ITUNES866-712-7753CA","Everyday Expenses:Spending Money","Everyday Expenses","Spending Money",,$4.99,$0.00,R,$4109.20
"Us Bank",,,10/28/2013,"Download from usbank.com. STARBUCKS #05517San FranciscCA","Everyday Expenses:Spending Money","Everyday Expenses","Spending Money",,$5.60,$0.00,R,$4103.60
"Us Bank",,,10/28/2013,"Download from usbank.com. CUP A JOES COFFESAN FRANCISCCA","Everyday Expenses:Spending Money","Everyday Expenses","Spending Money",,$9.00,$0.00,R,$4094.60
"Us Bank",,,10/28/2013,"Download from usbank.com. VENMO 646-863-9557NY","Everyday Expenses:Spending Money","Everyday Expenses","Spending Money",,$10.00,$0.00,R,$4084.60
"Us Bank",,,10/28/2013,"Download from usbank.com. THE CELLAR SAN FRANCISCCA","Everyday Expenses:Spending Money","Everyday Expenses","Spending Money",,$10.88,$0.00,R,$4073.72
"Us Bank",,,10/28/2013,"Download from usbank.com. BROWNIES ACE HARSAN FRANCISCCA","Everyday Expenses:Spending Money","Everyday Expenses","Spending Money",,$11.07,$0.00,R,$4062.65
"Us Bank",,,10/28/2013,"Download from usbank.com. GEORGE MARKET/22SAN FRANCISCCA","Everyday Expenses:Spending Money","Everyday Expenses","Spending Money",,$13.99,$0.00,R,$4048.66
"Us Bank",,,10/28/2013,"Download from usbank.com. AMC VAN NESS 14 SAN FRANCISCCA","Everyday Expenses:Spending Money","Everyday Expenses","Spending Money",,$14.00,$0.00,R,$4034.66
"Us Bank",,,10/28/2013,"Download from usbank.com. CHIPOTLE 1857 SAN FRANCISCCA","Everyday Expenses:Spending Money","Everyday Expenses","Spending Money",,$15.12,$0.00,R,$4019.54
"Us Bank",,,10/28/2013,"Download from usbank.com. WALGREENS 1300 BSAN FRANCISCCA","Everyday Expenses:Household Goods","Everyday Expenses","Household Goods",,$15.86,$0.00,R,$4003.68
"Us Bank",,,10/28/2013,"Download from usbank.com. AMERICAN APPARELSAN FRANCISCCA","Everyday Expenses:Clothing","Everyday Expenses","Clothing",,$17.40,$0.00,R,$3986.28
"Us Bank",,,10/28/2013,"Download from usbank.com. WOK SHOP CAFE INSAN FRANCISCCA","Everyday Expenses:Spending Money","Everyday Expenses","Spending Money",,$23.10,$0.00,R,$3963.18
"Us Bank",,,10/28/2013,"Download from usbank.com. SQ *JAMES L CHENSan FranciscCA","Everyday Expenses:Medical","Everyday Expenses","Medical",,$25.00,$0.00,R,$3938.18
"Us Bank",,,10/28/2013,"Download from usbank.com. WALGREENS 1300 BSAN FRANCISCCA","Everyday Expenses:Household Goods","Everyday Expenses","Household Goods",,$25.43,$0.00,R,$3912.75
"Us Bank",,,10/28/2013,"Download from usbank.com. WALGREENS 1300 BSAN FRANCISCCA","Everyday Expenses:Household Goods","Everyday Expenses","Household Goods",,$28.41,$0.00,R,$3884.34
"Us Bank",,,10/28/2013,"Download from usbank.com. WALGREENS 1300 BSAN FRANCISCCA","Everyday Expenses:Household Goods","Everyday Expenses","Household Goods",,$37.73,$0.00,R,$3846.61
"Us Bank",,,10/28/2013,"Download from usbank.com. SY8 COLE HARDWARSAN FRANCISCCA","Everyday Expenses:Spending Money","Everyday Expenses","Spending Money",,$44.59,$0.00,R,$3802.02
"Us Bank",,,10/28/2013,"Download from usbank.com. MODCLOTH INC. 888-4959699 CA","Everyday Expenses:Spending Money","Everyday Expenses","Spending Money",,$59.54,$0.00,R,$3742.48
"Us Bank",,,10/28/2013,"Download from usbank.com. SQ *BEAUTIFIED SSan FranciscCA","Everyday Expenses:Spending Money","Everyday Expenses","Spending Money",,$60.00,$0.00,R,$3682.48
"Us Bank",,,10/28/2013,"Download from usbank.com. INSTACART 206-953-2159CA","Everyday Expenses:Groceries","Everyday Expenses","Groceries",,$104.11,$0.00,R,$3578.37
"Us Bank",,,10/29/2013,"Download from usbank.com. SQ *ONENINETYSEVSan FranciscCA","Everyday Expenses:Spending Money","Everyday Expenses","Spending Money",,$3.50,$0.00,R,$3574.87
"Us Bank",,,10/29/2013,"Download from usbank.com. BITE SAN FRANCISCCA","Everyday Expenses:Spending Money","Everyday Expenses","Spending Money",,$11.06,$0.00,R,$3563.81
"Us Bank",,,10/29/2013,"Download from usbank.com. WALGREENS 500 GESAN FRANCISCCA","Everyday Expenses:Household Goods","Everyday Expenses","Household Goods",,$15.16,$0.00,R,$3548.65
"Us Bank",,,10/29/2013,"Download from usbank.com. TRADER JOE'S #20SAN FRANCISCCA","Everyday Expenses:Groceries","Everyday Expenses","Groceries",,$15.54,$0.00,R,$3533.11
"Us Bank",,,10/29/2013,"Download from usbank.com. BROWNIES ACE HARSAN FRANCISCCA","Everyday Expenses:Spending Money","Everyday Expenses","Spending Money",,$41.98,$0.00,R,$3491.13
"Us Bank",,,10/29/2013,"Download from usbank.com. EB *CRAWLOWEEN AEVENTBRITE.CCA","Everyday Expenses:Spending Money","Everyday Expenses","Spending Money",,$68.25,$0.00,R,$3422.88
"Us Bank",,,10/30/2013,"Download from usbank.com. INSTACART 2069532159 CA","Everyday Expenses:Groceries","Everyday Expenses","Groceries",,$0.00,$1.97,R,$3424.85
"Us Bank",,,10/30/2013,"Download from usbank.com. INSTACART 206-953-2159CA","Everyday Expenses:Groceries","Everyday Expenses","Groceries",,$5.00,$0.00,R,$3419.85
"Us Bank",,,10/31/2013,"Download from usbank.com. SQWIGGLE INC","Income:Available this month","Income","Available this month",,$0.00,$1783.36,R,$5203.21
"Us Bank",,,10/31/2013,"Download from usbank.com. ADY*Uber Technol866-5761039 CA","Everyday Expenses:Spending Money","Everyday Expenses","Spending Money",,$1.00,$0.00,R,$5202.21
"Us Bank",,,10/31/2013,"Download from usbank.com. SF PARTY SAN FRANCISCCA","Everyday Expenses:Spending Money","Everyday Expenses","Spending Money",,$5.43,$0.00,R,$5196.78
"Us Bank",,,10/31/2013,"Download from usbank.com. SQ *MIGHTY San FranciscCA","Everyday Expenses:Spending Money","Everyday Expenses","Spending Money",,$7.00,$0.00,R,$5189.78
"Us Bank",,,10/31/2013,"Download from usbank.com. SQ *MIGHTY      San FranciscCA","Everyday Expenses:Spending Money","Everyday Expenses","Spending Money",,$7.00,$0.00,R,$5182.78
"Us Bank",,,10/31/2013,"Download from usbank.com. LYFT            855-865-9553CA","Everyday Expenses:Transportation","Everyday Expenses","Transportation",,$12.00,$0.00,R,$5170.78
"Us Bank",,,10/31/2013,"Download from usbank.com. SQ *MIGHTY San FranciscCA","Everyday Expenses:Spending Money","Everyday Expenses","Spending Money",,$23.00,$0.00,R,$5147.78
"Us Bank",,,11/01/2013,"Download from usbank.com. ADY*Uber Technol866-5761039 CA","Everyday Expenses:Spending Money","Everyday Expenses","Spending Money",,$5.75,$0.00,R,$5142.03
"Us Bank",,,11/01/2013,"Download from usbank.com. CHIPOTLE 1857 SAN FRANCISCCA","Everyday Expenses:Spending Money","Everyday Expenses","Spending Money",,$7.56,$0.00,R,$5134.47
"Us Bank",,,11/01/2013,"Download from usbank.com. SQ *ONENINETYSEVSan FranciscCA","Everyday Expenses:Spending Money","Everyday Expenses","Spending Money",,$10.00,$0.00,R,$5124.47
"Us Bank",,,11/01/2013,"Download from usbank.com. LYFT 855-865-9553CA","Everyday Expenses:Transportation","Everyday Expenses","Transportation",,$11.00,$0.00,R,$5113.47
"Us Bank",,,11/01/2013,"Download from usbank.com. AMERICAN APPARELSAN FRANCISCCA","Everyday Expenses:Clothing","Everyday Expenses","Clothing",,$17.40,$0.00,R,$5096.07
"Us Bank",,,11/01/2013,"Download from usbank.com. WALGREENS 1300 BSAN FRANCISCCA","Everyday Expenses:Household Goods","Everyday Expenses","Household Goods",,$25.43,$0.00,R,$5070.64
"Us Bank",,,11/01/2013,"Download from usbank.com. MET CAS INS CO","Monthly Bills:Car Insurance","Monthly Bills","Car Insurance",,$46.00,$0.00,R,$5024.64
"Us Bank",,,11/04/2013,"Download from usbank.com. 110213PLUSTERM1000 Van Ness AvSan FranciscCAUS1","Everyday Expenses:Spending Money","Everyday Expenses","Spending Money",,$2.50,$0.00,R,$5022.14
"Us Bank",,,11/04/2013,"Download from usbank.com. BEVERAGES & MORESAN FRANCISCCA","Everyday Expenses:Spending Money","Everyday Expenses","Spending Money",,$6.51,$0.00,R,$5015.63
"Us Bank",,,11/04/2013,"Download from usbank.com. BELLISSIMO PIZZASAN FRANCISCCA","Everyday Expenses:Spending Money","Everyday Expenses","Spending Money",,$8.75,$0.00,R,$5006.88
"Us Bank",,,11/04/2013,"Download from usbank.com. LYFT 855-865-9553CA","Everyday Expenses:Transportation","Everyday Expenses","Transportation",,$12.00,$0.00,R,$4994.88
"Us Bank",,,11/04/2013,"Download from usbank.com. CUP A JOES COFFESAN FRANCISCCA","Everyday Expenses:Spending Money","Everyday Expenses","Spending Money",,$12.50,$0.00,R,$4982.38
"Us Bank",,,11/04/2013,"Download from usbank.com. LYFT 855-865-9553CA","Everyday Expenses:Transportation","Everyday Expenses","Transportation",,$15.00,$0.00,R,$4967.38
"Us Bank",,,11/04/2013,"Reconciliation Balance Adjustment","Income:Available this month","Income","Available this month","Entered automatically by YNAB",$18.23,$0.00,R,$4949.15
"Us Bank",,,11/04/2013,"Download from usbank.com. CAFE DIVIS SAN FRANCISCCA","Everyday Expenses:Spending Money","Everyday Expenses","Spending Money",,$20.39,$0.00,R,$4928.76
"Us Bank",,,11/04/2013,"Download from usbank.com. LYFT 855-865-9553CA","Everyday Expenses:Transportation","Everyday Expenses","Transportation",,$21.00,$0.00,R,$4907.76
"Us Bank",,,11/04/2013,"Download from usbank.com. BEVERAGES & MORESAN FRANCISCCA","Everyday Expenses:Spending Money","Everyday Expenses","Spending Money",,$26.09,$0.00,R,$4881.67
"Us Bank",,,11/04/2013,"Download from usbank.com. TACOLICIOUS II SAN FRANCISCCA","Everyday Expenses:Spending Money","Everyday Expenses","Spending Money",,$29.23,$0.00,R,$4852.44
"Us Bank",,,11/04/2013,"Download from usbank.com. CVS 10080 SAN FRANCISCCA","Everyday Expenses:Household Goods","Everyday Expenses","Household Goods",,$29.62,$0.00,R,$4822.82
"Us Bank",,,11/04/2013,"Download from usbank.com. US BANK CASTRO SAN FRANCISCCAUS1","Everyday Expenses:Spending Money","Everyday Expenses","Spending Money",,$40.00,$0.00,R,$4782.82
"Us Bank",,,11/04/2013,"Download from usbank.com. GOOGLE*ADWS","Monthly Bills:Web Stuff","Monthly Bills","Web Stuff",,$53.16,$0.00,R,$4729.66
"Us Bank",,,11/04/2013,"Download from usbank.com. TRADER JOE'S #20SAN FRANCISCCA","Everyday Expenses:Groceries","Everyday Expenses","Groceries",,$83.27,$0.00,R,$4646.39
"Us Bank",,,11/04/2013,"Download from usbank.com. 1000 Van Ness AvSan FranciscCAUS1","Everyday Expenses:Spending Money","Everyday Expenses","Spending Money",,$122.75,$0.00,R,$4523.64
"Us Bank",,,11/06/2013,"Download from usbank.com. PGANDE","Monthly Bills:Utilities","Monthly Bills","Utilities",,$47.81,$0.00,R,$4475.83
"Us Bank",,,11/06/2013,"Download from usbank.com. COMCAST CALIFORN800-COMCAST CA","Monthly Bills:Internet","Monthly Bills","Internet",,$145.12,$0.00,R,$4330.71
"Us Bank",,,11/07/2013,"Download from usbank.com. WALGREENS 500 GESAN FRANCISCCA","Everyday Expenses:Household Goods","Everyday Expenses","Household Goods",,$11.90,$0.00,R,$4318.81
"Us Bank",,,11/08/2013,"Download from usbank.com. MODCLOTH INC","Income:Available this month","Income","Available this month",,$0.00,$1451.21,R,$5770.02
"Us Bank",,,11/08/2013,"Download from usbank.com. WALGREENS 1300 BSAN FRANCISCCA","Everyday Expenses:Household Goods","Everyday Expenses","Household Goods",,$27.49,$0.00,R,$5742.53
"Us Bank",,,11/09/2013,"Reconciliation Balance Adjustment","Income:Available this month","Income","Available this month","Entered automatically by YNAB",$89.00,$0.00,R,$5653.53
"Us Bank",,,11/12/2013,"Download from usbank.com. MODCLOTH INC. 888-4959699 CA","Everyday Expenses:Spending Money","Everyday Expenses","Spending Money",,$0.00,$9.93,R,$5663.46
"Us Bank",,,11/12/2013,"Download from usbank.com. STARBUCKS #05752San FranciscCA","Everyday Expenses:Spending Money","Everyday Expenses","Spending Money",,$2.15,$0.00,R,$5661.31
"Us Bank",,,11/12/2013,"Download from usbank.com. APL*APPLE ITUNES866-712-7753CA","Everyday Expenses:Spending Money","Everyday Expenses","Spending Money",,$3.99,$0.00,R,$5657.32
"Us Bank",,,11/12/2013,"Download from usbank.com. THE POSH BAGEL SAN FRANCISCCA","Everyday Expenses:Spending Money","Everyday Expenses","Spending Money",,$5.49,$0.00,R,$5651.83
"Us Bank",,,11/12/2013,"Download from usbank.com. APL*APPLE ITUNES866-712-7753CA","Everyday Expenses:Spending Money","Everyday Expenses","Spending Money",,$5.98,$0.00,R,$5645.85
"Us Bank",,,11/12/2013,"Download from usbank.com. BAR BASIC SAN FRANCISCCA","Everyday Expenses:Spending Money","Everyday Expenses","Spending Money",,$9.00,$0.00,R,$5636.85
"Us Bank",,,11/12/2013,"Download from usbank.com. LYFT 855-865-9553CA","Everyday Expenses:Transportation","Everyday Expenses","Transportation",,$10.00,$0.00,R,$5626.85
"Us Bank",,,11/12/2013,"Download from usbank.com. STARBUCKS #10347San FranciscCA","Everyday Expenses:Spending Money","Everyday Expenses","Spending Money",,$12.05,$0.00,R,$5614.80
"Us Bank",,,11/12/2013,"Download from usbank.com. MEXICO AU PARC SAN FRANCISCCA","Everyday Expenses:Spending Money","Everyday Expenses","Spending Money",,$17.94,$0.00,R,$5596.86
"Us Bank",,,11/12/2013,"Download from usbank.com. WALGREENS 670 4TSAN FRANCISCCA","Everyday Expenses:Household Goods","Everyday Expenses","Household Goods",,$21.99,$0.00,R,$5574.87
"Us Bank",,,11/12/2013,"Download from usbank.com. YOGA TREE - VALE000-0000000 CA","Everyday Expenses:Spending Money","Everyday Expenses","Spending Money",,$25.00,$0.00,R,$5549.87
"Us Bank",,,11/12/2013,"Download from usbank.com. CVS 10080 SAN FRANCISCCA","Everyday Expenses:Household Goods","Everyday Expenses","Household Goods",,$28.93,$0.00,R,$5520.94
"Us Bank",,,11/12/2013,"Download from usbank.com. WALGREENS 1300 BSAN FRANCISCCA","Everyday Expenses:Household Goods","Everyday Expenses","Household Goods",,$31.46,$0.00,R,$5489.48
"Us Bank",,,11/12/2013,"Download from usbank.com. THE CELLAR SAN FRANCISCCA","Everyday Expenses:Spending Money","Everyday Expenses","Spending Money",,$39.00,$0.00,R,$5450.48
"Us Bank",,,11/12/2013,"Download from usbank.com. OLEA RESTURANT SAN FRANCISCCA","Everyday Expenses:Spending Money","Everyday Expenses","Spending Money",,$41.79,$0.00,R,$5408.69
"Us Bank",,,11/12/2013,"Download from usbank.com. CARDMEMBER SERV",,,,,$42.00,$0.00,R,$5366.69
"Us Bank",,,11/12/2013,"Download from usbank.com. TRADER JOE'S #20SAN FRANCISCCA","Everyday Expenses:Groceries","Everyday Expenses","Groceries",,$91.90,$0.00,R,$5274.79
"Us Bank",,,11/12/2013,"Download from usbank.com. GROUPON INC 877-788-7858IL","Everyday Expenses:Spending Money","Everyday Expenses","Spending Money",,$98.00,$0.00,R,$5176.79
"Us Bank",,,11/12/2013,"Download from usbank.com. 7246","Debt:Eric's Credit Card","Debt","Eric's Credit Card",,$698.90,$0.00,R,$4477.89
"Us Bank",,,11/13/2013,"Download from usbank.com. STARBUCKS #05757San FranciscCA","Everyday Expenses:Spending Money","Everyday Expenses","Spending Money",,$2.65,$0.00,R,$4475.24
"Us Bank",,,11/13/2013,"Download from usbank.com. APL*APPLE ITUNES866-712-7753CA","Everyday Expenses:Spending Money","Everyday Expenses","Spending Money",,$3.99,$0.00,R,$4471.25
"Us Bank",,,11/14/2013,"Download from usbank.com. APL*APPLE ITUNES866-712-7753CA","Everyday Expenses:Spending Money","Everyday Expenses","Spending Money",,$6.99,$0.00,R,$4464.26
"Us Bank",,,11/14/2013,"Download from usbank.com. TACQUERIA DOS AMSAN FRANCISCCA","Everyday Expenses:Spending Money","Everyday Expenses","Spending Money",,$7.88,$0.00,R,$4456.38
"Us Bank",,,11/14/2013,"Download from usbank.com. BITE SAN FRANCISCCA","Everyday Expenses:Spending Money","Everyday Expenses","Spending Money",,$19.28,$0.00,R,$4437.10
"Us Bank",,,11/14/2013,"Download from usbank.com. WHOLE FOODS MARKSan FranciscCA","Everyday Expenses:Groceries","Everyday Expenses","Groceries",,$32.84,$0.00,R,$4404.26
"Us Bank",,,11/15/2013,"Download from usbank.com. SQWIGGLE INC","Income:Available this month","Income","Available this month",,$0.00,$1783.37,R,$6187.63
"Us Bank",,,11/15/2013,"Download from usbank.com. CAPITAL ONE 360 SAN FRANCISCCA","Everyday Expenses:Spending Money","Everyday Expenses","Spending Money",,$1.50,$0.00,R,$6186.13
"Us Bank",,,11/15/2013,"Download from usbank.com. 111513PLUSTERM2124 MARKET ST. SAN FRANCISCCAUS1","Everyday Expenses:Spending Money","Everyday Expenses","Spending Money",,$2.50,$0.00,R,$6183.63
"Us Bank",,,11/15/2013,"Download from usbank.com. STARBUCKS #14393San FranciscCA","Everyday Expenses:Spending Money","Everyday Expenses","Spending Money",,$3.15,$0.00,R,$6180.48
"Us Bank",,,11/15/2013,"Download from usbank.com. CHIPOTLE 1857 SAN FRANCISCCA","Everyday Expenses:Spending Money","Everyday Expenses","Spending Money",,$7.56,$0.00,R,$6172.92
"Us Bank",,,11/15/2013,"Download from usbank.com. LOCAL MOTION PHYSAN FRANCISCCA","Everyday Expenses:Spending Money","Everyday Expenses","Spending Money",,$25.00,$0.00,C,$6147.92
"Us Bank",,,11/15/2013,"Download from usbank.com. 2124 MARKET ST. SAN FRANCISCCAUS1","Everyday Expenses:Spending Money","Everyday Expenses","Spending Money",,$62.50,$0.00,R,$6085.42
"Us Bank",,,11/15/2013,"Download from usbank.com.","Monthly Bills:Rent","Monthly Bills","Rent",,$1604.59,$0.00,R,$4480.83
"Us Bank",,,11/16/2013,"Reconciliation Balance Adjustment","Income:Available this month","Income","Available this month","Entered automatically by YNAB",$6.51,$0.00,R,$4474.32
"Us Bank",,,11/18/2013,"Download from usbank.com. CUP A JOES COFFESAN FRANCISCCA","Everyday Expenses:Spending Money","Everyday Expenses","Spending Money",,$2.75,$0.00,C,$4471.57
"Us Bank",,,11/18/2013,"Download from usbank.com. SUTTER FINE FOODSAN FRANCISCCA","Everyday Expenses:Groceries","Everyday Expenses","Groceries",,$4.78,$0.00,C,$4466.79
"Us Bank",,,11/18/2013,"Download from usbank.com. APL*APPLE ITUNES866-712-7753CA","Everyday Expenses:Spending Money","Everyday Expenses","Spending Money",,$4.99,$0.00,C,$4461.80
"Us Bank",,,11/18/2013,"Download from usbank.com. APL*APPLE ITUNES866-712-7753CA","Everyday Expenses:Spending Money","Everyday Expenses","Spending Money",,$4.99,$0.00,C,$4456.81
"Us Bank",,,11/18/2013,"Download from usbank.com. Spotify USA 877-778-1161NY","Monthly Bills:Web Stuff","Monthly Bills","Web Stuff",,$9.99,$0.00,C,$4446.82
"Us Bank",,,11/18/2013,"Download from usbank.com. BITE SAN FRANCISCCA","Everyday Expenses:Spending Money","Everyday Expenses","Spending Money",,$10.95,$0.00,C,$4435.87
"Us Bank",,,11/18/2013,"Download from usbank.com. SUTTER FINE FOODSAN FRANCISCCA","Everyday Expenses:Groceries","Everyday Expenses","Groceries",,$17.24,$0.00,C,$4418.63
"Us Bank",,,11/18/2013,"Download from usbank.com. TRADER JOE'S #20SAN FRANCISCCA","Everyday Expenses:Groceries","Everyday Expenses","Groceries",,$38.89,$0.00,C,$4379.74
"Us Bank",,,11/18/2013,"Download from usbank.com. TRADER JOE'S #20SAN FRANCISCCA","Everyday Expenses:Groceries","Everyday Expenses","Groceries",,$50.30,$0.00,C,$4329.44
"Us Bank",,,11/18/2013,"Download from usbank.com. WALGREENS 1300 BSAN FRANCISCCA","Everyday Expenses:Household Goods","Everyday Expenses","Household Goods",,$54.51,$0.00,C,$4274.93
"Us Bank",,,11/18/2013,"Download from usbank.com. MODCLOTH INC. 888-4959699 CA","Everyday Expenses:Spending Money","Everyday Expenses","Spending Money",,$145.65,$0.00,C,$4129.28
"Us Bank",,,11/19/2013,"Download from usbank.com. Amazon Video On 866-216-1072WA","Everyday Expenses:Spending Money","Everyday Expenses","Spending Money",,$2.99,$0.00,C,$4126.29
"Us Bank",,,11/19/2013,"Download from usbank.com. HLU*Hulu 4502449HULU.COM/BILCA","Monthly Bills:Web Stuff","Monthly Bills","Web Stuff",,$7.99,$0.00,C,$4118.30
"Us Bank",,,11/19/2013,"Download from usbank.com. FLOUR & CO SAN FRANCISCCA","Everyday Expenses:Spending Money","Everyday Expenses","Spending Money",,$17.78,$0.00,C,$4100.52
"Us Bank",,,11/19/2013,"Download from usbank.com. ATT","Monthly Bills:Cell Phone","Monthly Bills","Cell Phone",,$226.56,$0.00,C,$3873.96
"Us Bank",,,11/20/2013,"Download from usbank.com. PAYPAL","Everyday Expenses:Spending Money","Everyday Expenses","Spending Money",,$1.30,$0.00,C,$3872.66
"Us Bank",,,11/20/2013,"Download from usbank.com. THE CREAMERY SAN FRANCISCCA","Everyday Expenses:Spending Money","Everyday Expenses","Spending Money",,$10.95,$0.00,C,$3861.71
"Us Bank",,,11/20/2013,"Download from usbank.com. VENMO 646-801-3023NY","Everyday Expenses:Spending Money","Everyday Expenses","Spending Money",,$15.00,$0.00,C,$3846.71
"Us Bank",,,11/20/2013,"Download from usbank.com. WOK SHOP CAFE INSAN FRANCISCCA","Everyday Expenses:Spending Money","Everyday Expenses","Spending Money",,$25.30,$0.00,C,$3821.41
"Us Bank",,,11/20/2013,"Download from usbank.com. APPLE VACATIONS WWW.APPLEVACPA","Savings Goals:Vacation & Travel","Savings Goals","Vacation & Travel",,$3018.96,$0.00,C,$802.45
"Us Bank",,,11/21/2013,"Download from usbank.com. PAYPAL","Everyday Expenses:Spending Money","Everyday Expenses","Spending Money",,$1.00,$0.00,C,$801.45
"Us Bank",,,11/21/2013,"Download from usbank.com. CAPITAL ONE 360 SAN FRANCISCCA","Everyday Expenses:Spending Money","Everyday Expenses","Spending Money",,$1.50,$0.00,C,$799.95
"Us Bank",,,11/21/2013,"Download from usbank.com. SQ *WORKSHOP CAFSan FranciscCA","Everyday Expenses:Spending Money","Everyday Expenses","Spending Money",,$12.00,$0.00,C,$787.95
"Us Bank",,,11/21/2013,"Download from usbank.com. LOCAL MOTION PHYSAN FRANCISCCA","Everyday Expenses:Medical","Everyday Expenses","Medical",,$25.00,$0.00,C,$762.95
"Us Bank",,,11/22/2013,"Download from usbank.com. MODCLOTH INC","Income:Available this month","Income","Available this month",,$0.00,$1451.20,C,$2214.15
"Us Bank",,,11/22/2013,"Download from usbank.com. APL*APPLE ITUNES866-712-7753CA","Everyday Expenses:Spending Money","Everyday Expenses","Spending Money",,$4.99,$0.00,C,$2209.16
"Us Bank",,,11/22/2013,"Download from usbank.com. STARBUCKS #05757San FranciscCA","Everyday Expenses:Spending Money","Everyday Expenses","Spending Money",,$5.80,$0.00,C,$2203.36
"Us Bank",,,11/22/2013,"Download from usbank.com. ORDERAHEADAPP.CO6505033279 CA","Everyday Expenses:Spending Money","Everyday Expenses","Spending Money",,$29.20,$0.00,C,$2174.16
"Us Bank",,,11/22/2013,"Download from usbank.com. WHOLE FOODS MARKSan FranciscCA","Everyday Expenses:Groceries","Everyday Expenses","Groceries",,$100.00,$0.00,C,$2074.16
"Us Bank",,,11/25/2013,"Download from usbank.com.","Monthly Bills:Rent","Monthly Bills","Rent",,$0.00,$6.95,C,$2081.11
"Us Bank",,,11/25/2013,"Download from usbank.com. PAYPAL","Everyday Expenses:Spending Money","Everyday Expenses","Spending Money",,$0.00,$0.13,C,$2081.24
"Us Bank",,,11/25/2013,"Download from usbank.com. PAYPAL","Everyday Expenses:Spending Money","Everyday Expenses","Spending Money",,$0.00,$0.13,C,$2081.37
"Us Bank",,,11/25/2013,"Download from usbank.com. PAYPAL","Everyday Expenses:Spending Money","Everyday Expenses","Spending Money",,$0.26,$0.00,C,$2081.11
"Us Bank",,,11/25/2013,"Download from usbank.com.","Monthly Bills:Rent","Monthly Bills","Rent",,$6.95,$0.00,C,$2074.16
"Us Bank",,,11/25/2013,"Download from usbank.com. HLU*Hulu 1114865HULU.COM/BILCA","Monthly Bills:Web Stuff","Monthly Bills","Web Stuff",,$7.99,$0.00,C,$2066.17
"Us Bank",,,11/25/2013,"Download from usbank.com. CUP A JOES COFFESAN FRANCISCCA","Everyday Expenses:Spending Money","Everyday Expenses","Spending Money",,$18.15,$0.00,C,$2048.02
"Us Bank",,,11/25/2013,"Download from usbank.com. ELEVEN O ONE SAN FRANCISCCA","Everyday Expenses:Spending Money","Everyday Expenses","Spending Money",,$19.52,$0.00,C,$2028.50
"Us Bank",,,11/25/2013,"Download from usbank.com. CUP A JOES COFFESAN FRANCISCCA","Everyday Expenses:Spending Money","Everyday Expenses","Spending Money",,$19.90,$0.00,C,$2008.60
"Us Bank",,,11/25/2013,"Download from usbank.com. PA'INA LOUNGE & SAN FRANCISCCA","Everyday Expenses:Spending Money","Everyday Expenses","Spending Money",,$24.97,$0.00,C,$1983.63
"Us Bank",,,11/25/2013,"Download from usbank.com. ONE MEDICAL GROUSAN FRANCISCCA","Everyday Expenses:Medical","Everyday Expenses","Medical",,$25.00,$0.00,C,$1958.63
"Us Bank",,,11/25/2013,"Download from usbank.com. SUNDANCE KBB SAN FRANCISCCA","Everyday Expenses:Spending Money","Everyday Expenses","Spending Money",,$33.46,$0.00,C,$1925.17
"Us Bank",,,11/25/2013,"Download from usbank.com. MYMY COFFEE SHOPSAN FRANCISCCA","Everyday Expenses:Spending Money","Everyday Expenses","Spending Money",,$35.58,$0.00,C,$1889.59
"Us Bank",,,11/25/2013,"Download from usbank.com. SUZU SAN FRANCISCCA","Everyday Expenses:Spending Money","Everyday Expenses","Spending Money",,$38.15,$0.00,C,$1851.44
"Us Bank",,,11/25/2013,"Download from usbank.com. LOCAL MOTION PHY415-9350868 CA","Everyday Expenses:Medical","Everyday Expenses","Medical",,$50.00,$0.00,C,$1801.44
"Us Bank",,,11/25/2013,"Download from usbank.com. TRADER JOE'S #20SAN FRANCISCCA","Everyday Expenses:Groceries","Everyday Expenses","Groceries",,$113.44,$0.00,C,$1688.00
"Us Bank",,,11/26/2013,"Download from usbank.com. STARBUCKS #05992San FranciscCA","Everyday Expenses:Spending Money","Everyday Expenses","Spending Money",,$6.10,$0.00,C,$1681.90
"Us Bank",,,11/26/2013,"Download from usbank.com. WALGREENS 1300 BSAN FRANCISCCA","Everyday Expenses:Household Goods","Everyday Expenses","Household Goods",,$15.86,$0.00,C,$1666.04
"Us Bank",,,11/26/2013,"Download from usbank.com. OLD NAVY USA San FranciscCA","Everyday Expenses:Clothing","Everyday Expenses","Clothing",,$54.68,$0.00,C,$1611.36
"Us Bank",,,11/26/2013,"Download from usbank.com. GUITAR CENTER #2SAN FRANCISCCA","Everyday Expenses:Spending Money","Everyday Expenses","Spending Money",,$106.31,$0.00,C,$1505.05
"Us Bank",,,11/27/2013,"Download from usbank.com. STARBUCKS #05405San FranciscCA","Everyday Expenses:Spending Money","Everyday Expenses","Spending Money",,$2.65,$0.00,C,$1502.40
"Us Bank",,,11/27/2013,"Download from usbank.com. GUITAR CENTER #2SAN FRANCISCCA","Everyday Expenses:Spending Money","Everyday Expenses","Spending Money",,$4.34,$0.00,C,$1498.06
"Us Bank",,,11/27/2013,"Download from usbank.com. PAYPAL *UBERTECH402-935-7733CA","Everyday Expenses:Transportation","Everyday Expenses","Transportation",,$13.00,$0.00,C,$1485.06
"Us Bank",,,11/27/2013,"Download from usbank.com. LOCAL MOTION PHY415-9350868 CA","Everyday Expenses:Medical","Everyday Expenses","Medical",,$25.00,$0.00,C,$1460.06
"Us Bank",,,11/29/2013,"Download from usbank.com. SQWIGGLE INC","Income:Available this month","Income","Available this month",,$0.00,$1783.36,C,$3243.42
"Us Bank",,,11/29/2013,"Download from usbank.com. SUTTER FINE FOODSAN FRANCISCCA","Everyday Expenses:Groceries","Everyday Expenses","Groceries",,$13.33,$0.00,C,$3230.09
"Us Bank",,,11/29/2013,"Download from usbank.com. FOCACCIA MARKET SAN FRANCISCCA","Everyday Expenses:Spending Money","Everyday Expenses","Spending Money",,$18.10,$0.00,C,$3211.99
"Us Bank",,,11/29/2013,"Download from usbank.com. BEVERAGES & MORESAN FRANCISCCA","Everyday Expenses:Spending Money","Everyday Expenses","Spending Money",,$24.28,$0.00,C,$3187.71
"Us Bank",,,11/29/2013,"Download from usbank.com. TRADER JOE'S #20SAN FRANCISCCA","Everyday Expenses:Groceries","Everyday Expenses","Groceries",,$30.91,$0.00,C,$3156.80
"Us Bank",,,12/02/2013,"Download from usbank.com. TARGET 00SAN FRANCISCCA","Everyday Expenses:Household Goods","Everyday Expenses","Household Goods",,$5.60,$0.00,C,$3151.20
"Us Bank",,,12/02/2013,"Download from usbank.com. APL*APPLE ITUNES866-712-7753CA","Everyday Expenses:Spending Money","Everyday Expenses","Spending Money",,$5.98,$0.00,C,$3145.22
"Us Bank",,,12/02/2013,"Download from usbank.com. BELLISSIMO PIZZASAN FRANCISCCA","Everyday Expenses:Spending Money","Everyday Expenses","Spending Money",,$6.75,$0.00,C,$3138.47
"Us Bank",,,12/02/2013,"Download from usbank.com. LYFT 855-865-9553CA","Everyday Expenses:Transportation","Everyday Expenses","Transportation",,$10.00,$0.00,C,$3128.47
"Us Bank",,,12/02/2013,"Download from usbank.com. SLIDERS DINER SAN FRANCISCCA","Everyday Expenses:Spending Money","Everyday Expenses","Spending Money",,$10.60,$0.00,C,$3117.87
"Us Bank",,,12/02/2013,"Download from usbank.com. OLD NAVY USA San FranciscCA","Everyday Expenses:Clothing","Everyday Expenses","Clothing",,$12.85,$0.00,C,$3105.02
"Us Bank",,,12/02/2013,"Download from usbank.com. CHIPOTLE 1230 SAN FRANCISCCA","Everyday Expenses:Spending Money","Everyday Expenses","Spending Money",,$13.15,$0.00,C,$3091.87
"Us Bank",,,12/02/2013,"Download from usbank.com. TARGET T2766 SAN FRANCISCCA","Everyday Expenses:Household Goods","Everyday Expenses","Household Goods",,$14.07,$0.00,C,$3077.80
"Us Bank",,,12/02/2013,"Download from usbank.com. BOUDIN MACYS 424SAN FRANCISCCA","Everyday Expenses:Spending Money","Everyday Expenses","Spending Money",,$16.94,$0.00,C,$3060.86
"Us Bank",,,12/02/2013,"Download from usbank.com. SAFEWAY STORE 2SAN FRANCISCCA","Everyday Expenses:Groceries","Everyday Expenses","Groceries",,$18.02,$0.00,C,$3042.84
"Us Bank",,,12/02/2013,"Download from usbank.com. TARGET T2766 SAN FRANCISCCA","Everyday Expenses:Groceries","Everyday Expenses","Groceries",,$21.74,$0.00,C,$3021.10
"Us Bank",,,12/02/2013,"Download from usbank.com. WALGREENS 1300 BSAN FRANCISCCA","Everyday Expenses:Household Goods","Everyday Expenses","Household Goods",,$26.00,$0.00,C,$2995.10
"Us Bank",,,12/02/2013,"Download from usbank.com. Amazon.com AMZN.COM/BILWA","Everyday Expenses:Spending Money","Everyday Expenses","Spending Money",,$28.90,$0.00,C,$2966.20
"Us Bank",,,12/02/2013,"Download from usbank.com. RADISH SAN FRANCISCCA","Everyday Expenses:Spending Money","Everyday Expenses","Spending Money",,$31.15,$0.00,C,$2935.05
"Us Bank",,,12/02/2013,"Download from usbank.com. H&M SAN FRANCISCCA","Everyday Expenses:Clothing","Everyday Expenses","Clothing",,$32.57,$0.00,C,$2902.48
"Us Bank",,,12/02/2013,"Download from usbank.com. TRADER JOE'S #20SAN FRANCISCCA","Everyday Expenses:Groceries","Everyday Expenses","Groceries",,$37.96,$0.00,C,$2864.52
"Us Bank",,,12/02/2013,"Download from usbank.com. MET CAS INS CO","Monthly Bills:Car Insurance","Monthly Bills","Car Insurance",,$46.00,$0.00,C,$2818.52
"Us Bank",,,12/02/2013,"Download from usbank.com. CHURCHILL SAN FRANCISCCA","Everyday Expenses:Spending Money","Everyday Expenses","Spending Money",,$60.00,$0.00,C,$2758.52
"Us Bank",,,12/02/2013,"Download from usbank.com. H&M SAN FRANCISCCA","Everyday Expenses:Clothing","Everyday Expenses","Clothing",,$218.25,$0.00,C,$2540.27
"Us Bank",,,12/03/2013,"Download from usbank.com. WALGREENS 1300 BSAN FRANCISCCA","Everyday Expenses:Household Goods","Everyday Expenses","Household Goods",,$4.46,$0.00,C,$2535.81
"Us Bank",,,12/03/2013,"Download from usbank.com. WALGREENS 1300 BSAN FRANCISCCA","Everyday Expenses:Household Goods","Everyday Expenses","Household Goods",,$7.44,$0.00,C,$2528.37
"Us Bank",,,12/03/2013,"Download from usbank.com. HOMEJOY 855-728-4569CA","Everyday Expenses:Spending Money","Everyday Expenses","Spending Money",,$65.00,$0.00,C,$2463.37
"Us Bank",,,12/04/2013,"Download from usbank.com. CUP A JOES COFFESAN FRANCISCCA","Everyday Expenses:Spending Money","Everyday Expenses","Spending Money",,$6.50,$0.00,C,$2456.87
"Us Bank",,,12/04/2013,"Download from usbank.com. BAY AREA BIKE SHPORTLAND OR","Everyday Expenses:Transportation","Everyday Expenses","Transportation",,$9.00,$0.00,C,$2447.87
"Us Bank",,,12/04/2013,"Download from usbank.com. LOCAL MOTION PHY415-9350868 CA","Everyday Expenses:Medical","Everyday Expenses","Medical",,$25.00,$0.00,C,$2422.87
"Us Bank",,,12/04/2013,"Download from usbank.com. TRADER JOE'S #20SAN FRANCISCCA","Everyday Expenses:Groceries","Everyday Expenses","Groceries",,$107.66,$0.00,C,$2315.21
"Us Bank",,,12/05/2013,"Download from usbank.com. CUP A JOES COFFESAN FRANCISCCA","Everyday Expenses:Spending Money","Everyday Expenses","Spending Money",,$2.75,$0.00,C,$2312.46
"Us Bank",,,12/05/2013,"Download from usbank.com. CUP A JOES COFFESAN FRANCISCCA","Everyday Expenses:Spending Money","Everyday Expenses","Spending Money",,$3.75,$0.00,C,$2308.71
"Us Bank",,,12/05/2013,"Download from usbank.com. THE CELLAR SAN FRANCISCCA","Everyday Expenses:Spending Money","Everyday Expenses","Spending Money",,$10.88,$0.00,C,$2297.83
"Us Bank",,,12/05/2013,"Download from usbank.com. SUTTER FINE FOODSAN FRANCISCCA","Everyday Expenses:Groceries","Everyday Expenses","Groceries",,$11.19,$0.00,C,$2286.64
"Us Bank",,,12/06/2013,"Download from usbank.com. MODCLOTH INC","Income:Available this month","Income","Available this month",,$0.00,$1451.21,C,$3737.85
"Us Bank",,,12/06/2013,"Download from usbank.com. ORDERAHEADAPP.CO650-503-3279CA","Everyday Expenses:Spending Money","Everyday Expenses","Spending Money",,$10.82,$0.00,C,$3727.03
"Us Bank",,,12/06/2013,"Download from usbank.com. LOCAL MOTION PHY415-9350868 CA","Everyday Expenses:Medical","Everyday Expenses","Medical",,$25.00,$0.00,C,$3702.03
"Us Bank",,,12/06/2013,"Download from usbank.com. PAYPAL","Everyday Expenses:Spending Money","Everyday Expenses","Spending Money",,$27.00,$0.00,C,$3675.03
"Us Bank",,,12/06/2013,"Download from usbank.com. FTD*WILL MILLER 000-0000000 MO","Rainy Day Funds:Gifts","Rainy Day Funds","Gifts",,$48.58,$0.00,C,$3626.45
"Us Bank",,,12/09/2013,"Download from usbank.com. STARBUCKS #05404San FranciscCA","Everyday Expenses:Spending Money","Everyday Expenses","Spending Money",,$3.65,$0.00,C,$3622.80
"Us Bank",,,12/09/2013,"Download from usbank.com. SQ *PHILZ COFFEESan FranciscCA","Everyday Expenses:Spending Money","Everyday Expenses","Spending Money",,$6.00,$0.00,C,$3616.80
"Us Bank",,,12/09/2013,"Download from usbank.com. STARBUCKS #05405San FranciscCA","Everyday Expenses:Spending Money","Everyday Expenses","Spending Money",,$6.70,$0.00,C,$3610.10
"Us Bank",,,12/09/2013,"Download from usbank.com. VENMO 646-801-3023NY","Everyday Expenses:Spending Money","Everyday Expenses","Spending Money",,$13.00,$0.00,C,$3597.10
"Us Bank",,,12/09/2013,"Download from usbank.com. SUTTER FINE FOODSAN FRANCISCCA","Everyday Expenses:Groceries","Everyday Expenses","Groceries",,$20.10,$0.00,C,$3577.00
"Us Bank",,,12/09/2013,"Download from usbank.com. LOCAL MOTION PHY415-9350868 CA","Everyday Expenses:Medical","Everyday Expenses","Medical",,$25.00,$0.00,C,$3552.00
"Us Bank",,,12/09/2013,"Download from usbank.com. ZAP*6PM.COM 888-676-2660NV","Rainy Day Funds:Gifts","Rainy Day Funds","Gifts",,$39.99,$0.00,C,$3512.01
"Us Bank",,,12/09/2013,"Download from usbank.com. MELA TANDOORI KISAN FRANCISCCA","Everyday Expenses:Spending Money","Everyday Expenses","Spending Money",,$49.39,$0.00,C,$3462.62
"Us Bank",,,12/09/2013,"Download from usbank.com. WALGREENS 1300 BSAN FRANCISCCA","Everyday Expenses:Household Goods","Everyday Expenses","Household Goods",,$78.16,$0.00,C,$3384.46
"Us Bank",,,12/09/2013,"Download from usbank.com. MODCLOTH INC. 888-4959699 CA","Everyday Expenses:Spending Money","Everyday Expenses","Spending Money",,$140.09,$0.00,C,$3244.37
"Us Bank",,,12/10/2013,"Download from usbank.com. INSTACART 910-817-2278CA","Everyday Expenses:Spending Money","Everyday Expenses","Spending Money",,$3.00,$0.00,C,$3241.37
"Us Bank",,,12/10/2013,"Download from usbank.com. PHILZ COFFEE INCSAN FRANCISCCA","Everyday Expenses:Spending Money","Everyday Expenses","Spending Money",,$3.00,$0.00,C,$3238.37
"Us Bank",,,12/10/2013,"Download from usbank.com. PANERA BREAD #45SAN FRANCISCCA","Everyday Expenses:Spending Money","Everyday Expenses","Spending Money",,$9.23,$0.00,C,$3229.14
"Us Bank",,,12/10/2013,"Download from usbank.com. YOGA TREE - VALE415-701-9642CA","Everyday Expenses:Spending Money","Everyday Expenses","Spending Money",,$18.00,$0.00,C,$3211.14
"Us Bank",,,12/10/2013,"Download from usbank.com. TRADER JOE'S #20SAN FRANCISCCA","Everyday Expenses:Groceries","Everyday Expenses","Groceries",,$20.63,$0.00,C,$3190.51
"Us Bank",,,12/10/2013,"Download from usbank.com. AMC VAN NESS 14 SAN FRANCISCCA","Everyday Expenses:Spending Money","Everyday Expenses","Spending Money",,$24.00,$0.00,C,$3166.51
"Us Bank",,,12/10/2013,"Download from usbank.com. INSTACART 910-817-2278CA","Everyday Expenses:Spending Money","Everyday Expenses","Spending Money",,$31.60,$0.00,C,$3134.91
"Us Bank",,,12/10/2013,"Download from usbank.com. CARDMEMBER SERV",,,,,$43.00,$0.00,C,$3091.91
"Us Bank",,,12/10/2013,"Download from usbank.com.","Monthly Bills:Rent","Monthly Bills","Rent",,$1565.09,$0.00,C,$1526.82
"Us Bank",,,12/11/2013,"Download from usbank.com. TRADER JOE'S #20SAN FRANCISCCA","Everyday Expenses:Groceries","Everyday Expenses","Groceries",,$5.49,$0.00,C,$1521.33
"Us Bank",,,12/11/2013,"Download from usbank.com. WHOLE FOODS MARKSan FranciscCA","Everyday Expenses:Groceries","Everyday Expenses","Groceries",,$33.26,$0.00,C,$1488.07
"Us Bank",,,12/12/2013,"Download from usbank.com. SQ *WORKSHOP CAFSan FranciscCA","Everyday Expenses:Spending Money","Everyday Expenses","Spending Money",,$4.00,$0.00,C,$1484.07
"Us Bank",,,12/12/2013,"Download from usbank.com. CUP A JOES COFFESAN FRANCISCCA","Everyday Expenses:Spending Money","Everyday Expenses","Spending Money",,$7.25,$0.00,C,$1476.82
"Us Bank",,,12/12/2013,"Download from usbank.com. CHIPOTLE 1857 SAN FRANCISCCA","Everyday Expenses:Spending Money","Everyday Expenses","Spending Money",,$7.56,$0.00,C,$1469.26
"Us Bank",,,12/13/2013,"Download from usbank.com. SQWIGGLE INC","Income:Available this month","Income","Available this month",,$0.00,$1783.37,C,$3252.63
"Us Bank",,,12/13/2013,"Download from usbank.com. THE POSH BAGEL SAN FRANCISCCA","Everyday Expenses:Spending Money","Everyday Expenses","Spending Money",,$11.29,$0.00,C,$3241.34
"Us Bank",,,12/13/2013,"Download from usbank.com. SQ *BEAUTIFIED SSan FranciscCA","Everyday Expenses:Spending Money","Everyday Expenses","Spending Money",,$60.00,$0.00,C,$3181.34
"Us Bank",,,12/16/2013,"Download from usbank.com. STARBUCKS #05464San FranciscCA","Everyday Expenses:Spending Money","Everyday Expenses","Spending Money",,$0.00,$3.15,C,$3184.49
"Us Bank",,,12/16/2013,"Download from usbank.com. 121413PLUSTERM1560 POWELL ST. SAN FRANCISCCAUS1","Everyday Expenses:Spending Money","Everyday Expenses","Spending Money",,$2.50,$0.00,C,$3181.99
"Us Bank",,,12/16/2013,"Download from usbank.com. STARBUCKS #05464San FranciscCA","Everyday Expenses:Spending Money","Everyday Expenses","Spending Money",,$3.15,$0.00,C,$3178.84
"Us Bank",,,12/16/2013,"Download from usbank.com. PIRAAT PIZZERIA SAN FRANCISCCA","Everyday Expenses:Spending Money","Everyday Expenses","Spending Money",,$4.42,$0.00,C,$3174.42
"Us Bank",,,12/16/2013,"Download from usbank.com. STARBUCKS #05464San FranciscCA","Everyday Expenses:Spending Money","Everyday Expenses","Spending Money",,$5.00,$0.00,C,$3169.42
"Us Bank",,,12/16/2013,"Download from usbank.com. CUP A JOES COFFESAN FRANCISCCA","Everyday Expenses:Spending Money","Everyday Expenses","Spending Money",,$5.95,$0.00,C,$3163.47
"Us Bank",,,12/16/2013,"Download from usbank.com. BEVERAGES & MORESAN FRANCISCCA","Everyday Expenses:Spending Money","Everyday Expenses","Spending Money",,$6.51,$0.00,C,$3156.96
"Us Bank",,,12/16/2013,"Download from usbank.com. PAYPAL","Everyday Expenses:Spending Money","Everyday Expenses","Spending Money",,$8.00,$0.00,C,$3148.96
"Us Bank",,,12/16/2013,"Download from usbank.com. CLAY THEATRE SAN FRANCISCCA","Everyday Expenses:Spending Money","Everyday Expenses","Spending Money",,$8.75,$0.00,C,$3140.21
"Us Bank",,,12/16/2013,"Download from usbank.com. BITE SAN FRANCISCCA","Everyday Expenses:Spending Money","Everyday Expenses","Spending Money",,$9.42,$0.00,C,$3130.79
"Us Bank",,,12/16/2013,"Download from usbank.com. GRUBHUB FOOD ORD877-585-7878IL","Everyday Expenses:Spending Money","Everyday Expenses","Spending Money",,$9.79,$0.00,C,$3121.00
"Us Bank",,,12/16/2013,"Download from usbank.com. VENMO 646-801-3023NY","Everyday Expenses:Spending Money","Everyday Expenses","Spending Money",,$10.00,$0.00,C,$3111.00
"Us Bank",,,12/16/2013,"Download from usbank.com. THE BELL TOWER SAN FRANCISCCA","Everyday Expenses:Spending Money","Everyday Expenses","Spending Money",,$12.00,$0.00,C,$3099.00
"Us Bank",,,12/16/2013,"Download from usbank.com. SUTTER FINE FOODSAN FRANCISCCA","Everyday Expenses:Groceries","Everyday Expenses","Groceries",,$14.13,$0.00,C,$3084.87
"Us Bank",,,12/16/2013,"Download from usbank.com. WICHCRAFT SAN FRSAN FRANCISCCA","Everyday Expenses:Spending Money","Everyday Expenses","Spending Money",,$21.77,$0.00,C,$3063.10
"Us Bank",,,12/16/2013,"Download from usbank.com. SPRIG 4158945191 CA","Everyday Expenses:Groceries","Everyday Expenses","Groceries",,$22.00,$0.00,C,$3041.10
"Us Bank",,,12/16/2013,"Download from usbank.com. AMBER SAN FRANCISCCA","Everyday Expenses:Spending Money","Everyday Expenses","Spending Money",,$22.11,$0.00,C,$3018.99
"Us Bank",,,12/16/2013,"Download from usbank.com. PAYPAL","Everyday Expenses:Spending Money","Everyday Expenses","Spending Money",,$24.00,$0.00,C,$2994.99
"Us Bank",,,12/16/2013,"Download from usbank.com. MYMY COFFEE SHOPSAN FRANCISCCA","Everyday Expenses:Spending Money","Everyday Expenses","Spending Money",,$37.02,$0.00,C,$2957.97
"Us Bank",,,12/16/2013,"Download from usbank.com. FIOR D' ITALIA SAN FRANCISCCA","Everyday Expenses:Spending Money","Everyday Expenses","Spending Money",,$44.26,$0.00,C,$2913.71
"Us Bank",,,12/16/2013,"Download from usbank.com. WALGREENS 1300 BSAN FRANCISCCA","Everyday Expenses:Household Goods","Everyday Expenses","Household Goods",,$55.33,$0.00,C,$2858.38
"Us Bank",,,12/16/2013,"Download from usbank.com. 1560 POWELL ST. SAN FRANCISCCAUS1","Everyday Expenses:Spending Money","Everyday Expenses","Spending Money",,$102.95,$0.00,C,$2755.43
"Us Bank",,,12/16/2013,"Download from usbank.com. 7246","Debt:Eric's Credit Card","Debt","Eric's Credit Card",,$1000.00,$0.00,C,$1755.43
"Us Bank",,,12/17/2013,"Download from usbank.com. Spotify USA 877-778-1161NY","Monthly Bills:Web Stuff","Monthly Bills","Web Stuff",,$9.99,$0.00,C,$1745.44
"Us Bank",,,12/17/2013,"Download from usbank.com. BART-CLIPPER CIVSAN FRANCISCCA","Everyday Expenses:Transportation","Everyday Expenses","Transportation",,$15.85,$0.00,C,$1729.59
"Us Bank",,,12/17/2013,"Download from usbank.com. BART-CIVIC CENTESAN FRANCISCCA","Everyday Expenses:Transportation","Everyday Expenses","Transportation",,$16.50,$0.00,C,$1713.09
"Us Bank",,,12/17/2013,"Download from usbank.com. WALGREENS 1300 BSAN FRANCISCCA","Everyday Expenses:Household Goods","Everyday Expenses","Household Goods",,$21.90,$0.00,C,$1691.19
"Us Bank",,,12/17/2013,"Download from usbank.com. THE CELLAR SAN FRANCISCCA","Everyday Expenses:Spending Money","Everyday Expenses","Spending Money",,$30.82,$0.00,C,$1660.37
"Us Bank",,,12/17/2013,"Download from usbank.com. H&M SAN FRANCISCCA","Everyday Expenses:Clothing","Everyday Expenses","Clothing",,$38.99,$0.00,C,$1621.38
"Us Bank",,,12/18/2013,"Download from usbank.com. SLIDERS DINER SAN FRANCISCCA","Everyday Expenses:Spending Money","Everyday Expenses","Spending Money",,$10.60,$0.00,C,$1610.78
"Us Bank",,,12/18/2013,"Download from usbank.com. TARTINE LP SAN FRANCISCCA","Everyday Expenses:Spending Money","Everyday Expenses","Spending Money",,$38.61,$0.00,C,$1572.17
"Us Bank",,,12/18/2013,"Download from usbank.com. PEOPLES BARBER SAN FRANCISCCA","Everyday Expenses:Spending Money","Everyday Expenses","Spending Money",,$48.00,$0.00,C,$1524.17
"Us Bank",,,12/19/2013,"Download from usbank.com. HLU*Hulu 4502449HULU.COM/BILCA","Monthly Bills:Web Stuff","Monthly Bills","Web Stuff",,$7.99,$0.00,C,$1516.18
"Us Bank",,,12/19/2013,"Download from usbank.com. RHODES 101 STOPSFARMINGTON MO","Everyday Expenses:Spending Money","Everyday Expenses","Spending Money",,$9.80,$0.00,C,$1506.38
"Us Bank",,,12/19/2013,"Download from usbank.com. HARDEE'S 1500950HOUSE SPRINGMO","Everyday Expenses:Spending Money","Everyday Expenses","Spending Money",,$14.66,$0.00,C,$1491.72
"Us Bank",,,12/19/2013,"Download from usbank.com. TERMINAL 1 STA32LOS ANGELES CA","Everyday Expenses:Spending Money","Everyday Expenses","Spending Money",,$20.00,$0.00,C,$1471.72
"Us Bank",,,12/19/2013,"Download from usbank.com. SPRIG 415-894-5191CA","Everyday Expenses:Groceries","Everyday Expenses","Groceries",,$22.00,$0.00,C,$1449.72
"Us Bank",,,12/19/2013,"Download from usbank.com. AMAZON MKTPLACE AMZN.COM/BILWA","Everyday Expenses:Spending Money","Everyday Expenses","Spending Money",,$27.10,$0.00,C,$1422.62
"Us Bank",,,12/19/2013,"Download from usbank.com. MAX S EATZ SFO30SAN FRANCISCCA","Everyday Expenses:Spending Money","Everyday Expenses","Spending Money",,$28.03,$0.00,C,$1394.59
"Us Bank",,,12/19/2013,"Download from usbank.com. COLTON'S #627 FARMINGTON MO","Rainy Day Funds:Gifts","Rainy Day Funds","Gifts",,$88.58,$0.00,C,$1306.01
"Us Bank",,,12/19/2013,"Download from usbank.com. ATT","Monthly Bills:Cell Phone","Monthly Bills","Cell Phone",,$226.94,$0.00,C,$1079.07
"Us Bank",,,12/20/2013,"Download from usbank.com. MODCLOTH INC","Income:Available this month","Income","Available this month",,$0.00,$1423.16,C,$2502.23
"Us Bank",,,12/20/2013,"Download from usbank.com. LYFT 855-865-9553CA","Everyday Expenses:Transportation","Everyday Expenses","Transportation",,$7.00,$0.00,C,$2495.23
"Us Bank",,,12/20/2013,"Download from usbank.com. PAYPAL","Everyday Expenses:Spending Money","Everyday Expenses","Spending Money",,$9.99,$0.00,C,$2485.24
"Us Bank",,,12/20/2013,"Download from usbank.com. LYFT 855-865-9553CA","Everyday Expenses:Transportation","Everyday Expenses","Transportation",,$12.00,$0.00,C,$2473.24
"Us Bank",,,12/20/2013,"Download from usbank.com. CASEYS 529 POTOSFARMINGTON MO","Everyday Expenses:Spending Money","Everyday Expenses","Spending Money",,$12.65,$0.00,C,$2460.59
"Us Bank",,,12/20/2013,"Download from usbank.com. PAPIN ROAD BP DE SOTO MO","Everyday Expenses:Spending Money","Everyday Expenses","Spending Money",,$34.62,$0.00,C,$2425.97
"Us Bank",,,12/20/2013,"Download from usbank.com. PAYPAL","Everyday Expenses:Spending Money","Everyday Expenses","Spending Money",,$150.00,$0.00,C,$2275.97
"Us Bank",,,12/23/2013,"Download from usbank.com.","Monthly Bills:Rent","Monthly Bills","Rent",,$0.00,$6.95,C,$2282.92
"Us Bank",,,12/23/2013,"Download from usbank.com. APL*APPLE ITUNES866-712-7753CA","Everyday Expenses:Spending Money","Everyday Expenses","Spending Money",,$0.99,$0.00,C,$2281.93
"Us Bank",,,12/23/2013,"Download from usbank.com. SHELL Service StARNOLD MO","Everyday Expenses:Spending Money","Everyday Expenses","Spending Money",,$4.40,$0.00,C,$2277.53
"Us Bank",,,12/23/2013,"Download from usbank.com. APL*APPLE ITUNES866-712-7753CA","Everyday Expenses:Spending Money","Everyday Expenses","Spending Money",,$4.99,$0.00,C,$2272.54
"Us Bank",,,12/23/2013,"Download from usbank.com.","Monthly Bills:Rent","Monthly Bills","Rent",,$6.95,$0.00,C,$2265.59
"Us Bank",,,12/23/2013,"Download from usbank.com. MOONCOINS COFFEEFARMINGTON MO","Everyday Expenses:Spending Money","Everyday Expenses","Spending Money",,$8.15,$0.00,C,$2257.44
"Us Bank",,,12/23/2013,"Download from usbank.com. QDOBA #855 FARMINGTON MO","Everyday Expenses:Spending Money","Everyday Expenses","Spending Money",,$8.94,$0.00,C,$2248.50
"Us Bank",,,12/23/2013,"Download from usbank.com. QDOBA #855 FARMINGTON MO","Everyday Expenses:Spending Money","Everyday Expenses","Spending Money",,$9.15,$0.00,C,$2239.35
"Us Bank",,,12/23/2013,"Download from usbank.com. COUNTRY CORNER DESOTO MO","Everyday Expenses:Spending Money","Everyday Expenses","Spending Money",,$14.84,$0.00,C,$2224.51
"Us Bank",,,12/23/2013,"Download from usbank.com. COYOL MEXICAN BADE SOTO MO","Everyday Expenses:Spending Money","Everyday Expenses","Spending Money",,$25.06,$0.00,C,$2199.45
"Us Bank",,,12/23/2013,"Download from usbank.com. PANERA BREAD #10FESTUS MO","Everyday Expenses:Spending Money","Everyday Expenses","Spending Money",,$30.45,$0.00,C,$2169.00
"Us Bank",,,12/23/2013,"Download from usbank.com. WAL Wal-Mart SupPOPLAR BLUFFMO","Everyday Expenses:Spending Money","Everyday Expenses","Spending Money",,$56.14,$0.00,C,$2112.86
"Us Bank",,,12/23/2013,"Download from usbank.com. Amazon.com AMZN.COM/BILWA","Everyday Expenses:Spending Money","Everyday Expenses","Spending Money",,$130.97,$0.00,C,$1981.89
"Us Bank",,,12/24/2013,"Download from usbank.com. THE BOTTLE SHOP POPLAR BLUFFMO","Everyday Expenses:Spending Money","Everyday Expenses","Spending Money",,$6.00,$0.00,C,$1975.89
"Us Bank",,,12/24/2013,"Download from usbank.com. Amazon.com AMZN.COM/BILWA","Everyday Expenses:Spending Money","Everyday Expenses","Spending Money",,$10.86,$0.00,C,$1965.03
"Us Bank",,,12/24/2013,"Download from usbank.com. FACTORY CONNECTIPOPLAR BLUFFMO","Everyday Expenses:Spending Money","Everyday Expenses","Spending Money",,$10.87,$0.00,C,$1954.16
"Us Bank",,,12/24/2013,"Download from usbank.com. THE WINE RACK JAPOPLAR BLUFFMO","Everyday Expenses:Spending Money","Everyday Expenses","Spending Money",,$18.84,$0.00,C,$1935.32
"Us Bank",,,12/24/2013,"Download from usbank.com. THE BOTTLE SHOP POPLAR BLUFFMO","Everyday Expenses:Spending Money","Everyday Expenses","Spending Money",,$36.90,$0.00,C,$1898.42
"Us Bank",,,12/24/2013,"Download from usbank.com. WAL Wal-Mart SupPOPLAR BLUFFMO","Everyday Expenses:Spending Money","Everyday Expenses","Spending Money",,$46.09,$0.00,C,$1852.33
"Us Bank",,,12/24/2013,"Download from usbank.com. WAL-MART #0019 POPLAR BLUFFMO","Rainy Day Funds:Gifts","Rainy Day Funds","Gifts",,$129.38,$0.00,C,$1722.95
"Us Bank",,,12/26/2013,"Download from usbank.com. HLU*Hulu 2274453HULU.COM/BILCA","Monthly Bills:Web Stuff","Monthly Bills","Web Stuff",,$7.99,$0.00,C,$1714.96
"Us Bank",,,12/26/2013,"Download from usbank.com. THE BREAD COMPANPOPLAR BLUFFMO","Everyday Expenses:Spending Money","Everyday Expenses","Spending Money",,$13.87,$0.00,C,$1701.09
"Us Bank",,,12/26/2013,"Download from usbank.com. STEAMPOWERED.COM425-952-2785WA","Rainy Day Funds:Gifts","Rainy Day Funds","Gifts",,$50.00,$0.00,C,$1651.09
"Us Bank",,,12/26/2013,"Download from usbank.com. GE Capital",,,,,$56.00,$0.00,C,$1595.09
"Us Bank",,,12/26/2013,"Download from usbank.com. PAYPAL","Everyday Expenses:Spending Money","Everyday Expenses","Spending Money",,$99.95,$0.00,C,$1495.14
"Us Bank",,,12/27/2013,"Download from usbank.com. VALVE SOFTWARE  425-8899642 WA","Rainy Day Funds:Gifts","Rainy Day Funds","Gifts",,$10.00,$0.00,C,$1485.14
"Us Bank",,,12/27/2013,"Download from usbank.com. THE BREAD COMPANPOPLAR BLUFFMO","Everyday Expenses:Spending Money","Everyday Expenses","Spending Money",,$23.01,$0.00,C,$1462.13
"Us Bank",,,12/27/2013,"Download from usbank.com. PROSPER MARKETPL","Debt:Eric's Credit Card","Debt","Eric's Credit Card",,$100.00,$0.00,C,$1362.13
"Us Bank",,,12/27/2013,"Download from usbank.com. PROSPER MARKETPL","Debt:Eric's Credit Card","Debt","Eric's Credit Card",,$100.00,$0.00,C,$1262.13
"Us Bank",,,12/30/2013,"Download from usbank.com. AMAZON DIG447192","Everyday Expenses:Spending Money","Everyday Expenses","Spending Money",,$0.00,$8.76,C,$1270.89
"Us Bank",,,12/30/2013,"Download from usbank.com. AMAZON DIG445977","Everyday Expenses:Spending Money","Everyday Expenses","Spending Money",,$0.00,$1.77,C,$1272.66
"Us Bank",,,12/30/2013,"Download from usbank.com. BLUFF BURGER ANDPOPLAR BLUFFMO","Everyday Expenses:Spending Money","Everyday Expenses","Spending Money",,$5.00,$0.00,C,$1267.66
"Us Bank",,,12/30/2013,"Download from usbank.com. COLTONS - POPLARPOPLAR BLUFFMO","Everyday Expenses:Spending Money","Everyday Expenses","Spending Money",,$19.04,$0.00,C,$1248.62
"Us Bank",,,12/31/2013,"Download from usbank.com. SQWIGGLE INC","Income:Available this month","Income","Available this month",,$0.00,$1783.36,C,$3031.98
"Us Bank",,,01/02/2014,"Download from usbank.com. JORDAN'S KWIK STBROOKLAND   AR","Everyday Expenses:Spending Money","Everyday Expenses","Spending Money",,$4.12,$0.00,C,$3027.86
"Us Bank",,,01/02/2014,"Download from usbank.com. TIOS MEXICAN BARPOPLAR BLUFFMO","Everyday Expenses:Spending Money","Everyday Expenses","Spending Money",,$5.85,$0.00,C,$3022.01
"Us Bank",,,01/02/2014,"Download from usbank.com. MET CAS INS CO","Monthly Bills:Car Insurance","Monthly Bills","Car Insurance",,$46.00,$0.00,C,$2976.01
"Us Bank",,,01/02/2014,"Download from usbank.com. BT *TASKRABBIT 888-661-8105CA","Everyday Expenses:Household Goods","Everyday Expenses","Household Goods",,$60.00,$0.00,C,$2916.01
"Us Bank",,,01/03/2014,"Download from usbank.com. MODCLOTH INC","Income:Available this month","Income","Available this month",,$0.00,$1453.74,C,$4369.75
"Us Bank",,,01/03/2014,"Download from usbank.com. GOOGLE*ADWS","Monthly Bills:Web Stuff","Monthly Bills","Web Stuff",,$9.99,$0.00,C,$4359.76
"Us Bank",,,01/03/2014,"Download from usbank.com. COUNTRY BUMPKINSPOPLAR BLUFFMO","Everyday Expenses:Spending Money","Everyday Expenses","Spending Money",,$15.78,$0.00,C,$4343.98
"Us Bank",,,01/03/2014,"Download from usbank.com. TIOS MEXICAN BARPOPLAR BLUFFMO","Everyday Expenses:Spending Money","Everyday Expenses","Spending Money",,$21.26,$0.00,C,$4322.72
"Us Bank",,,01/03/2014,"Download from usbank.com. PROSPER MARKETPL","Debt:Eric's Credit Card","Debt","Eric's Credit Card",,$100.00,$0.00,C,$4222.72
"Us Bank",,,01/06/2014,"Download from usbank.com. HIDDEN VALLEY GOEUREKA      MO","Everyday Expenses:Spending Money","Everyday Expenses","Spending Money",,$4.50,$0.00,C,$4218.22
"Us Bank",,,01/06/2014,"Download from usbank.com. WAL-MART #0037  FARMINGTON  MO","Everyday Expenses:Spending Money","Everyday Expenses","Spending Money",,$8.34,$0.00,C,$4209.88
"Us Bank",,,01/06/2014,"Download from usbank.com. HIDDEN VALLEY GOEUREKA      MO","Everyday Expenses:Spending Money","Everyday Expenses","Spending Money",,$11.50,$0.00,C,$4198.38
"Us Bank",,,01/06/2014,"Download from usbank.com. CHICK-FIL-A #030SUNSET HILLSMO","Everyday Expenses:Spending Money","Everyday Expenses","Spending Money",,$13.55,$0.00,C,$4184.83
"Us Bank",,,01/06/2014,"Download from usbank.com. HIDDEN VALLEY F WILDWOOD    MO","Everyday Expenses:Spending Money","Everyday Expenses","Spending Money",,$14.50,$0.00,C,$4170.33
"Us Bank",,,01/06/2014,"Download from usbank.com. PANERA BREAD #10FESTUS      MO","Everyday Expenses:Spending Money","Everyday Expenses","Spending Money",,$24.95,$0.00,C,$4145.38
"Us Bank",,,01/06/2014,"Download from usbank.com. ETSY.COM        866-294-3879NY","Everyday Expenses:Spending Money","Everyday Expenses","Spending Money",,$39.00,$0.00,C,$4106.38
"Us Bank",,,01/06/2014,"Download from usbank.com. WAL-MART #0037  FARMINGTON  MO","Everyday Expenses:Spending Money","Everyday Expenses","Spending Money",,$97.39,$0.00,C,$4008.99
"Us Bank",,,01/06/2014,"Download from usbank.com. DICK'S CLOTHING&SOUTH COUNTYMO","Everyday Expenses:Spending Money","Everyday Expenses","Spending Money",,$130.59,$0.00,C,$3878.40
"Us Bank",,,01/06/2014,"Download from usbank.com. HIDDEN VALLEY GOEUREKA      MO","Everyday Expenses:Spending Money","Everyday Expenses","Spending Money",,$170.00,$0.00,C,$3708.40
"Us Bank",,,01/07/2014,"Download from usbank.com.","Monthly Bills:Rent","Monthly Bills","Rent",,$1565.09,$0.00,C,$2143.31
"Us Bank",,,01/08/2014,"Download from usbank.com. APL*APPLE ITUNES866-712-7753CA","Everyday Expenses:Spending Money","Everyday Expenses","Spending Money",,$0.99,$0.00,C,$2142.32
"Us Bank",,,01/08/2014,"Download from usbank.com. SUTTER FINE FOODSAN FRANCISCCA","Everyday Expenses:Groceries","Everyday Expenses","Groceries",,$6.09,$0.00,C,$2136.23
"Us Bank",,,01/08/2014,"Download from usbank.com. CARIBOU COFFEE  DENVER      CO","Everyday Expenses:Spending Money","Everyday Expenses","Spending Money",,$8.91,$0.00,C,$2127.32
"Us Bank",,,01/09/2014,"Download from usbank.com. AIRBART         OAKLAND     CA","Everyday Expenses:Transportation","Everyday Expenses","Transportation",,$3.00,$0.00,C,$2124.32
"Us Bank",,,01/09/2014,"Download from usbank.com. AIRBART         OAKLAND     CA","Everyday Expenses:Transportation","Everyday Expenses","Transportation",,$6.00,$0.00,C,$2118.32
"Us Bank",,,01/09/2014,"Download from usbank.com. CROWNE PLAZA HOTDENVER      CO","Everyday Expenses:Spending Money","Everyday Expenses","Spending Money",,$8.13,$0.00,C,$2110.19
"Us Bank",,,01/09/2014,"Download from usbank.com. SOUTHWESTAIR*INFDALLAS      TX","Everyday Expenses:Spending Money","Everyday Expenses","Spending Money",,$10.00,$0.00,C,$2100.19
"Us Bank",,,01/09/2014,"Download from usbank.com. CAFFE ROMA      SAN FRANCISCCA","Everyday Expenses:Spending Money","Everyday Expenses","Spending Money",,$10.60,$0.00,C,$2089.59
"Us Bank",,,01/09/2014,"Download from usbank.com. AMAZON MKTPLACE AMZN.COM/BILWA","Everyday Expenses:Spending Money","Everyday Expenses","Spending Money",,$14.12,$0.00,C,$2075.47
"Us Bank",,,01/09/2014,"Download from usbank.com. WALGREENS 1300 BSAN FRANCISCCA","Everyday Expenses:Household Goods","Everyday Expenses","Household Goods",,$14.99,$0.00,C,$2060.48
"Us Bank",,,01/09/2014,"Download from usbank.com. Amazon.com      AMZN.COM/BILWA","Everyday Expenses:Spending Money","Everyday Expenses","Spending Money",,$15.21,$0.00,C,$2045.27
"Us Bank",,,01/09/2014,"Download from usbank.com. TRADER JOE'S #20SAN FRANCISCCA","Everyday Expenses:Groceries","Everyday Expenses","Groceries",,$31.70,$0.00,C,$2013.57
"Us Bank",,,01/09/2014,"Download from usbank.com. PGANDE","Monthly Bills:Utilities","Monthly Bills","Utilities",,$54.01,$0.00,C,$1959.56
"Us Bank",,,01/09/2014,"Download from usbank.com. TRADER JOE'S #20SAN FRANCISCCA","Everyday Expenses:Groceries","Everyday Expenses","Groceries",,$72.02,$0.00,C,$1887.54
"Us Bank",,,01/09/2014,"Download from usbank.com. 7246","Debt:Eric's Credit Card","Debt","Eric's Credit Card",,$300.00,$0.00,C,$1587.54
"Us Bank",,,01/10/2014,"Download from usbank.com. APL*APPLE ITUNES866-712-7753CA","Everyday Expenses:Spending Money","Everyday Expenses","Spending Money",,$0.95,$0.00,C,$1586.59
"Us Bank",,,01/10/2014,"Download from usbank.com. WALGREENS 1300 BSAN FRANCISCCA","Everyday Expenses:Household Goods","Everyday Expenses","Household Goods",,$1.09,$0.00,C,$1585.50
"Us Bank",,,01/10/2014,"Download from usbank.com. APL*APPLE ITUNES866-712-7753CA","Everyday Expenses:Spending Money","Everyday Expenses","Spending Money",,$9.99,$0.00,C,$1575.51
"Us Bank",,,01/10/2014,"Download from usbank.com. CARDMEMBER SERV",,,,,$41.00,$0.00,C,$1534.51
"Us Bank",,,01/10/2014,"Download from usbank.com. SQ *BEAUTIFIED SSan FranciscCA","Everyday Expenses:Spending Money","Everyday Expenses","Spending Money",,$60.00,$0.00,C,$1474.51
"Us Bank",,,01/10/2014,"Download from usbank.com. COMCAST","Monthly Bills:Utilities","Monthly Bills","Utilities",,$145.12,$0.00,C,$1329.39
"Us Bank",,,01/13/2014,"Download from usbank.com. GETAROUND       866-438-2760CA","Everyday Expenses:Transportation","Everyday Expenses","Transportation",,$6.00,$0.00,C,$1323.39
"Us Bank",,,01/13/2014,"Download from usbank.com. LYFT            855-865-9553CA","Everyday Expenses:Transportation","Everyday Expenses","Transportation",,$9.00,$0.00,C,$1314.39
"Us Bank",,,01/13/2014,"Download from usbank.com. PAYPAL","Everyday Expenses:Spending Money","Everyday Expenses","Spending Money",,$9.51,$0.00,C,$1304.88
"Us Bank",,,01/13/2014,"Download from usbank.com. SLIDERS DINER   SAN FRANCISCCA","Everyday Expenses:Spending Money","Everyday Expenses","Spending Money",,$11.15,$0.00,C,$1293.73
"Us Bank",,,01/13/2014,"Download from usbank.com. WALGREENS 1300 BSAN FRANCISCCA","Everyday Expenses:Household Goods","Everyday Expenses","Household Goods",,$11.30,$0.00,C,$1282.43
"Us Bank",,,01/13/2014,"Download from usbank.com. LIVINGSOCIAL*   202-695-8945DC","Everyday Expenses:Transportation","Everyday Expenses","Transportation",,$19.00,$0.00,C,$1263.43
"Us Bank",,,01/13/2014,"Download from usbank.com. CHEVRON 00090030SAN FRANCISCCA","Everyday Expenses:Transportation","Everyday Expenses","Transportation",,$19.22,$0.00,C,$1244.21
"Us Bank",,,01/13/2014,"Download from usbank.com. US BANK HESPERIAHAYWARD     CAUS1","Everyday Expenses:Spending Money","Everyday Expenses","Spending Money",,$20.00,$0.00,C,$1224.21
"Us Bank",,,01/13/2014,"Download from usbank.com. LOCAL MOTION PHY415-9350868 CA","Everyday Expenses:Medical","Everyday Expenses","Medical",,$25.00,$0.00,C,$1199.21
"Us Bank",,,01/13/2014,"Download from usbank.com. WALGREENS 500 GESAN FRANCISCCA","Everyday Expenses:Household Goods","Everyday Expenses","Household Goods",,$26.51,$0.00,C,$1172.70
"Us Bank",,,01/13/2014,"Download from usbank.com. SUDACHI         SAN FRANCISCCA","Everyday Expenses:Spending Money","Everyday Expenses","Spending Money",,$40.00,$0.00,C,$1132.70
"Us Bank",,,01/13/2014,"Download from usbank.com. GETAROUND       866-438-2760CA","Everyday Expenses:Transportation","Everyday Expenses","Transportation",,$49.00,$0.00,C,$1083.70
"Us Bank",,,01/13/2014,"Download from usbank.com. FGT*COACHELLA   888-512-7469TX","Everyday Expenses:Spending Money","Everyday Expenses","Spending Money",,$750.00,$0.00,C,$333.70
"Us Bank",,,01/14/2014,"Download from usbank.com. PIRAAT PIZZERIA SAN FRANCISCCA","Everyday Expenses:Spending Money","Everyday Expenses","Spending Money",,$5.20,$0.00,C,$328.50
"Us Bank",,,01/14/2014,"Download from usbank.com. CARFAX VEHICLE HWWW.CARFAX.CVA","Savings Goals:House Stuff","Savings Goals","House Stuff",,$39.99,$0.00,C,$288.51
"Us Bank",,,01/15/2014,"Download from usbank.com. SQWIGGLE INC","Income:Available this month","Income","Available this month",,$0.00,$1965.99,C,$2254.50
"Us Bank",,,01/15/2014,"Download from usbank.com. SAFEWAY STORE  2SAN FRANCISCCA","Everyday Expenses:Groceries","Everyday Expenses","Groceries",,$13.04,$0.00,C,$2241.46
"Us Bank",,,01/16/2014,"Download from usbank.com. ALLY BANK","Income:Available this month","Income","Available this month",,$0.00,$0.28,C,$2241.74
"Us Bank",,,01/16/2014,"Download from usbank.com. ALLY BANK","Income:Available this month","Income","Available this month",,$0.00,$0.25,C,$2241.99
"Us Bank",,,01/16/2014,"Download from usbank.com. ALLY BANK","Income:Available this month","Income","Available this month",,$0.53,$0.00,C,$2241.46
"Us Bank",,,01/16/2014,"Download from usbank.com. TRADER JOE'S #20SAN FRANCISCCA","Everyday Expenses:Groceries","Everyday Expenses","Groceries",,$20.62,$0.00,C,$2220.84
"Us Bank",,,01/17/2014,"Download from usbank.com. MODCLOTH INC","Income:Available this month","Income","Available this month",,$0.00,$1453.75,C,$3674.59
"Us Bank",,,01/17/2014,"Download from usbank.com. BARCLAYS BANK DE","Income:Available this month","Income","Available this month",,$0.00,$0.19,C,$3674.78
"Us Bank",,,01/17/2014,"Download from usbank.com. BARCLAYS BANK DE","Income:Available this month","Income","Available this month",,$0.00,$0.16,C,$3674.94
"Us Bank",,,01/17/2014,"Download from usbank.com. WHOLE FOODS MARKSan FranciscCA","Everyday Expenses:Groceries","Everyday Expenses","Groceries",,$25.81,$0.00,C,$3649.13
"Us Bank",,,01/17/2014,"Download from usbank.com. BARCLAYS BANK DE","Savings Goals:Savings","Savings Goals","Savings",,$100.00,$0.00,C,$3549.13
"Us Bank",,,01/21/2014,"Download from usbank.com. 011714PLUSTERM25 SUTTER STREETSAN FRANCISCCAUS1","Everyday Expenses:Spending Money","Everyday Expenses","Spending Money",,$2.50,$0.00,C,$3546.63
"Us Bank",,,01/21/2014,"Download from usbank.com. IT'S A GRIND #CASAN FRANCISCCA","Everyday Expenses:Spending Money","Everyday Expenses","Spending Money",,$4.10,$0.00,C,$3542.53
"Us Bank",,,01/21/2014,"Download from usbank.com. THE CELLAR      SAN FRANCISCCA","Everyday Expenses:Spending Money","Everyday Expenses","Spending Money",,$5.98,$0.00,C,$3536.55
"Us Bank",,,01/21/2014,"Download from usbank.com. HLU*Hulu 4502449HULU.COM/BILCA","Monthly Bills:Web Stuff","Monthly Bills","Web Stuff",,$7.99,$0.00,C,$3528.56
"Us Bank",,,01/21/2014,"Download from usbank.com. PAYPAL","Everyday Expenses:Spending Money","Everyday Expenses","Spending Money",,$8.30,$0.00,C,$3520.26
"Us Bank",,,01/21/2014,"Download from usbank.com. PAYPAL","Everyday Expenses:Spending Money","Everyday Expenses","Spending Money",,$9.99,$0.00,C,$3510.27
"Us Bank",,,01/21/2014,"Download from usbank.com. Spotify USA     877-778-1161NY","Monthly Bills:Web Stuff","Monthly Bills","Web Stuff",,$9.99,$0.00,C,$3500.28
"Us Bank",,,01/21/2014,"Download from usbank.com. URBAN-OUTFITTERS972-550-2751PA","Everyday Expenses:Clothing","Everyday Expenses","Clothing",,$15.23,$0.00,C,$3485.05
"Us Bank",,,01/21/2014,"Download from usbank.com. LOCAL MOTION PHY415-9350868 CA","Everyday Expenses:Medical","Everyday Expenses","Medical",,$25.00,$0.00,C,$3460.05
"Us Bank",,,01/21/2014,"Download from usbank.com. GRUBHUB FOOD ORD877-585-7878IL","Everyday Expenses:Spending Money","Everyday Expenses","Spending Money",,$25.84,$0.00,C,$3434.21
"Us Bank",,,01/21/2014,"Download from usbank.com. WALGREENS 1300 BSAN FRANCISCCA","Everyday Expenses:Household Goods","Everyday Expenses","Household Goods",,$32.91,$0.00,C,$3401.30
"Us Bank",,,01/21/2014,"Download from usbank.com. 25 SUTTER STREETSAN FRANCISCCAUS1","Everyday Expenses:Spending Money","Everyday Expenses","Spending Money",,$62.00,$0.00,C,$3339.30
"Us Bank",,,01/21/2014,"Download from usbank.com. PARAGON RESTAURASAN FRANCISCCA","Everyday Expenses:Spending Money","Everyday Expenses","Spending Money",,$80.00,$0.00,C,$3259.30
"Us Bank",,,01/21/2014,"Download from usbank.com. TRADER JOE'S #20SAN FRANCISCCA","Everyday Expenses:Groceries","Everyday Expenses","Groceries",,$111.32,$0.00,C,$3147.98
"Us Bank",,,01/21/2014,"Download from usbank.com. ATT","Monthly Bills:Cell Phone","Monthly Bills","Cell Phone",,$226.38,$0.00,C,$2921.60
"Us Bank",,,01/21/2014,"Download from usbank.com. US BANK CIVIC CESAN FRANCISCCAUS1","Everyday Expenses:Spending Money","Everyday Expenses","Spending Money",,$260.00,$0.00,C,$2661.60
"Us Bank",,,01/22/2014,"Download from usbank.com. TACQUERIA DOS AMSAN FRANCISCCA","Everyday Expenses:Spending Money","Everyday Expenses","Spending Money",,$8.32,$0.00,C,$2653.28
"Us Bank",,,01/22/2014,"Download from usbank.com. TRADER JOE'S #20SAN FRANCISCCA","Everyday Expenses:Groceries","Everyday Expenses","Groceries",,$14.06,$0.00,C,$2639.22
"Us Bank",,,01/22/2014,"Download from usbank.com. PAYPAL","Everyday Expenses:Spending Money","Everyday Expenses","Spending Money",,$39.99,$0.00,C,$2599.23
"Us Bank",,,01/23/2014,"Download from usbank.com. APL*APPLE ITUNES866-712-7753CA","Everyday Expenses:Spending Money","Everyday Expenses","Spending Money",,$0.99,$0.00,C,$2598.24
"Us Bank",,,01/23/2014,"Download from usbank.com. THE CELLAR      SAN FRANCISCCA","Everyday Expenses:Spending Money","Everyday Expenses","Spending Money",,$2.50,$0.00,C,$2595.74
"Us Bank",,,01/23/2014,"Download from usbank.com. 21ST AMENDMENT BSAN FRANCISCCA","Everyday Expenses:Spending Money","Everyday Expenses","Spending Money",,$6.50,$0.00,C,$2589.24
"Us Bank",,,01/23/2014,"Download from usbank.com. SQ *LITTLE RED RSan FranciscCA","Everyday Expenses:Spending Money","Everyday Expenses","Spending Money",,$10.25,$0.00,C,$2578.99
"Us Bank",,,01/23/2014,"Download from usbank.com. TARA RESTAURANT SAN FRANCISCCA","Everyday Expenses:Spending Money","Everyday Expenses","Spending Money",,$10.75,$0.00,C,$2568.24
"Us Bank",,,01/23/2014,"Download from usbank.com. USPS 0568320009 SAN FRANCISCCA","Everyday Expenses:Spending Money","Everyday Expenses","Spending Money",,$10.81,$0.00,C,$2557.43
"Us Bank",,,01/23/2014,"Download from usbank.com. SQ *SHOWPLACE CASan FranciscCA","Everyday Expenses:Spending Money","Everyday Expenses","Spending Money",,$14.20,$0.00,C,$2543.23
"Us Bank",,,01/24/2014,"Download from usbank.com.","Everyday Expenses:Spending Money","Everyday Expenses","Spending Money",,$0.00,$6.95,C,$2550.18
"Us Bank",,,01/24/2014,"Download from usbank.com. APL*APPLE ITUNES866-712-7753CA","Everyday Expenses:Spending Money","Everyday Expenses","Spending Money",,$3.99,$0.00,C,$2546.19
"Us Bank",,,01/24/2014,"Download from usbank.com. PANERA BREAD #45SAN FRANCISCCA","Everyday Expenses:Spending Money","Everyday Expenses","Spending Money",,$4.56,$0.00,C,$2541.63
"Us Bank",,,01/24/2014,"Download from usbank.com.","Everyday Expenses:Spending Money","Everyday Expenses","Spending Money",,$6.95,$0.00,C,$2534.68
"Us Bank",,,01/24/2014,"Download from usbank.com. CHIPOTLE 1230   SAN FRANCISCCA","Everyday Expenses:Spending Money","Everyday Expenses","Spending Money",,$7.56,$0.00,C,$2527.12
"Us Bank",,,01/24/2014,"Download from usbank.com. SPRIG           415-894-5191CA","Everyday Expenses:Spending Money","Everyday Expenses","Spending Money",,$22.00,$0.00,C,$2505.12
"Us Bank",,,01/27/2014,"Download from usbank.com. DARBAR CUISINE ISAN FRANCISCCA","Everyday Expenses:Spending Money","Everyday Expenses","Spending Money",,$3.00,$0.00,C,$2502.12
"Us Bank",,,01/27/2014,"Download from usbank.com. PIRAAT PIZZERIA SAN FRANCISCCA","Everyday Expenses:Spending Money","Everyday Expenses","Spending Money",,$4.30,$0.00,C,$2497.82
"Us Bank",,,01/27/2014,"Download from usbank.com. PAYPAL","Everyday Expenses:Spending Money","Everyday Expenses","Spending Money",,$4.95,$0.00,C,$2492.87
"Us Bank",,,01/27/2014,"Download from usbank.com. HLU*Hulu 2274453HULU.COM/BILCA","Monthly Bills:Web Stuff","Monthly Bills","Web Stuff",,$7.99,$0.00,C,$2484.88
"Us Bank",,,01/27/2014,"Download from usbank.com. THE CELLAR      SAN FRANCISCCA","Everyday Expenses:Spending Money","Everyday Expenses","Spending Money",,$9.00,$0.00,C,$2475.88
"Us Bank",,,01/27/2014,"Download from usbank.com. THE CREAMERY    SAN FRANCISCCA","Everyday Expenses:Spending Money","Everyday Expenses","Spending Money",,$10.95,$0.00,C,$2464.93
"Us Bank",,,01/27/2014,"Download from usbank.com. THE CELLAR      SAN FRANCISCCA","Everyday Expenses:Spending Money","Everyday Expenses","Spending Money",,$11.37,$0.00,C,$2453.56
"Us Bank",,,01/27/2014,"Download from usbank.com. GROUPON INC     877-788-7858IL","Everyday Expenses:Spending Money","Everyday Expenses","Spending Money",,$12.00,$0.00,C,$2441.56
"Us Bank",,,01/27/2014,"Download from usbank.com. THE MELT BEACON SAN FRANCISCCA","Everyday Expenses:Spending Money","Everyday Expenses","Spending Money",,$13.28,$0.00,C,$2428.28
"Us Bank",,,01/27/2014,"Download from usbank.com. PARC55 WYNDHAM SSAN FRANCISCCA","Everyday Expenses:Spending Money","Everyday Expenses","Spending Money",,$14.42,$0.00,C,$2413.86
"Us Bank",,,01/27/2014,"Download from usbank.com. TRADER JOE'S #20SAN FRANCISCCA","Everyday Expenses:Groceries","Everyday Expenses","Groceries",,$15.52,$0.00,C,$2398.34
"Us Bank",,,01/27/2014,"Download from usbank.com. SUTTER FINE FOODSAN FRANCISCCA","Everyday Expenses:Groceries","Everyday Expenses","Groceries",,$19.12,$0.00,C,$2379.22
"Us Bank",,,01/27/2014,"Download from usbank.com. FANDANGO.COM    FANDANGO.COMCA","Everyday Expenses:Spending Money","Everyday Expenses","Spending Money",,$20.50,$0.00,C,$2358.72
"Us Bank",,,01/27/2014,"Download from usbank.com. WALGREENS 1300 BSAN FRANCISCCA","Everyday Expenses:Household Goods","Everyday Expenses","Household Goods",,$24.18,$0.00,C,$2334.54
"Us Bank",,,01/27/2014,"Download from usbank.com. GE Capital",,,,,$25.00,$0.00,C,$2309.54
"Us Bank",,,01/27/2014,"Download from usbank.com. CHEVRON 00090030SAN FRANCISCCA","Everyday Expenses:Transportation","Everyday Expenses","Transportation",,$27.28,$0.00,C,$2282.26
"Us Bank",,,01/27/2014,"Download from usbank.com. SANTA CRUZ BEACHSANTA CRUZ  CA","Everyday Expenses:Spending Money","Everyday Expenses","Spending Money",,$32.00,$0.00,C,$2250.26
"Us Bank",,,01/27/2014,"Download from usbank.com. GETAROUND       866-438-2760CA","Everyday Expenses:Transportation","Everyday Expenses","Transportation",,$65.00,$0.00,C,$2185.26
"Us Bank",,,01/27/2014,"Download from usbank.com. TRADER JOE'S #20SAN FRANCISCCA","Everyday Expenses:Groceries","Everyday Expenses","Groceries",,$81.21,$0.00,C,$2104.05
"Us Bank",,,01/28/2014,"Download from usbank.com. SANTA CRUZ BEACHSANTA CRUZ  CA","Everyday Expenses:Spending Money","Everyday Expenses","Spending Money",,$4.00,$0.00,C,$2100.05
"Us Bank",,,01/28/2014,"Download from usbank.com. WALGREENS 500 GESAN FRANCISCCA","Everyday Expenses:Household Goods","Everyday Expenses","Household Goods",,$5.89,$0.00,C,$2094.16
"Us Bank",,,01/28/2014,"Download from usbank.com. CUP A JOES COFFESAN FRANCISCCA","Everyday Expenses:Spending Money","Everyday Expenses","Spending Money",,$6.00,$0.00,C,$2088.16
"Us Bank",,,01/28/2014,"Download from usbank.com. WHITINGS FOOD   SANTA CRUZ  CA","Everyday Expenses:Spending Money","Everyday Expenses","Spending Money",,$7.75,$0.00,C,$2080.41
"Us Bank",,,01/28/2014,"Download from usbank.com. SURF CITY GRILL SANTA CRUZ  CA","Everyday Expenses:Spending Money","Everyday Expenses","Spending Money",,$14.50,$0.00,C,$2065.91
"Us Bank",,,01/28/2014,"Download from usbank.com. SURF CITY GRILL SANTA CRUZ  CA","Everyday Expenses:Spending Money","Everyday Expenses","Spending Money",,$15.00,$0.00,C,$2050.91
"Us Bank",,,01/28/2014,"Download from usbank.com. BOARDWALK TOKEN SANTA CRUZ  CA","Everyday Expenses:Spending Money","Everyday Expenses","Spending Money",,$20.00,$0.00,C,$2030.91
"Us Bank",,,01/28/2014,"Download from usbank.com. WHOLE FOODS MARKSan FranciscCA","Everyday Expenses:Groceries","Everyday Expenses","Groceries",,$22.07,$0.00,C,$2008.84
"Us Bank",,,01/28/2014,"Download from usbank.com. SURF CITY GRILL SANTA CRUZ  CA","Everyday Expenses:Spending Money","Everyday Expenses","Spending Money",,$28.85,$0.00,C,$1979.99
"Us Bank",,,01/28/2014,"Download from usbank.com. 7246","Debt:Eric's Credit Card","Debt","Eric's Credit Card",,$400.00,$0.00,C,$1579.99
"Us Bank",,,01/29/2014,"Download from usbank.com. SANTA CRUZ PAY B831-420-5114CA","Everyday Expenses:Spending Money","Everyday Expenses","Spending Money",,$8.35,$0.00,C,$1571.64
"Us Bank",,,01/30/2014,"Download from usbank.com. AMAZON DIG454413","Everyday Expenses:Spending Money","Everyday Expenses","Spending Money",,$0.00,$1.78,C,$1573.42
"Us Bank",,,01/30/2014,"Download from usbank.com. WALGREENS 1300 BSAN FRANCISCCA","Everyday Expenses:Household Goods","Everyday Expenses","Household Goods",,$5.43,$0.00,C,$1567.99
"Us Bank",,,01/30/2014,"Download from usbank.com. FOLSOM STREET FOSAN FRANCISCCA","Everyday Expenses:Spending Money","Everyday Expenses","Spending Money",,$5.50,$0.00,C,$1562.49
"Us Bank",,,01/30/2014,"Download from usbank.com. APL*APPLE ONLINE800-676-2775CA","Everyday Expenses:Spending Money","Everyday Expenses","Spending Money",,$99.00,$0.00,C,$1463.49
"Us Bank",,,01/31/2014,"Download from usbank.com. SQWIGGLE INC","Income:Available this month","Income","Available this month",,$0.00,$1965.99,C,$3429.48
"Us Bank",,,01/31/2014,"Download from usbank.com. MODCLOTH INC","Income:Available this month","Income","Available this month",,$0.00,$1453.75,C,$4883.23
"Us Bank",,,01/31/2014,"Download from usbank.com. THE MELT BEACON SAN FRANCISCCA","Everyday Expenses:Spending Money","Everyday Expenses","Spending Money",,$7.51,$0.00,C,$4875.72
"Us Bank",,,01/31/2014,"Download from usbank.com. BARCLAYS BANK DE","Savings Goals:Savings","Savings Goals","Savings",,$100.00,$0.00,C,$4775.72
"Us Bank",,,02/03/2014,"Download from usbank.com. URBAN-OUTFITTERSPHILADELPHIAPA","Everyday Expenses:Clothing","Everyday Expenses","Clothing",,$0.00,$15.23,C,$4790.95
"Us Bank",,,02/03/2014,"Download from usbank.com. GOOGLE*ADWS","Monthly Bills:Web Stuff","Monthly Bills","Web Stuff",,$3.96,$0.00,C,$4786.99
"Us Bank",,,02/03/2014,"Download from usbank.com. CUP A JOES COFFESAN FRANCISCCA","Everyday Expenses:Spending Money","Everyday Expenses","Spending Money",,$5.95,$0.00,C,$4781.04
"Us Bank",,,02/03/2014,"Download from usbank.com. CHEVRON 00095533VALLEJO     CA","Everyday Expenses:Transportation","Everyday Expenses","Transportation",,$8.16,$0.00,C,$4772.88
"Us Bank",,,02/03/2014,"Download from usbank.com. TACQUERIA DOS AMSAN FRANCISCCA","Everyday Expenses:Spending Money","Everyday Expenses","Spending Money",,$8.42,$0.00,C,$4764.46
"Us Bank",,,02/03/2014,"Download from usbank.com. LYFT            855-865-9553CA","Everyday Expenses:Transportation","Everyday Expenses","Transportation",,$9.00,$0.00,C,$4755.46
"Us Bank",,,02/03/2014,"Download from usbank.com. BITE            SAN FRANCISCCA","Everyday Expenses:Spending Money","Everyday Expenses","Spending Money",,$9.42,$0.00,C,$4746.04
"Us Bank",,,02/03/2014,"Download from usbank.com. PAYPAL","Everyday Expenses:Spending Money","Everyday Expenses","Spending Money",,$11.39,$0.00,C,$4734.65
"Us Bank",,,02/03/2014,"Download from usbank.com. JULIES KITCHEN #SAN FRANCISCCA","Everyday Expenses:Spending Money","Everyday Expenses","Spending Money",,$14.44,$0.00,C,$4720.21
"Us Bank",,,02/03/2014,"Download from usbank.com. Mars Bar & RestaSan FranciscCA","Everyday Expenses:Spending Money","Everyday Expenses","Spending Money",,$17.00,$0.00,C,$4703.21
"Us Bank",,,02/03/2014,"Download from usbank.com. BAR BASIC       SAN FRANCISCCA","Everyday Expenses:Spending Money","Everyday Expenses","Spending Money",,$29.00,$0.00,C,$4674.21
"Us Bank",,,02/03/2014,"Download from usbank.com. AMAZON MKTPLACE AMZN.COM/BILWA","Everyday Expenses:Spending Money","Everyday Expenses","Spending Money",,$42.55,$0.00,C,$4631.66
"Us Bank",,,02/03/2014,"Download from usbank.com. GETAROUND       866-438-2760CA","Everyday Expenses:Transportation","Everyday Expenses","Transportation",,$43.00,$0.00,C,$4588.66
"Us Bank",,,02/03/2014,"Download from usbank.com. MET CAS INS CO","Monthly Bills:Car Insurance","Monthly Bills","Car Insurance",,$46.00,$0.00,C,$4542.66
"Us Bank",,,02/03/2014,"Download from usbank.com. INSTACART       INSTACART.COCA","Everyday Expenses:Groceries","Everyday Expenses","Groceries",,$72.73,$0.00,C,$4469.93
"Us Bank",,,02/03/2014,"Download from usbank.com. BARCLAYS BANK DE","Savings Goals:Savings","Savings Goals","Savings",,$100.00,$0.00,C,$4369.93
"Us Bank",,,02/04/2014,"Download from usbank.com. TRADER JOE'S #20SAN FRANCISCCA","Everyday Expenses:Groceries","Everyday Expenses","Groceries",,$92.76,$0.00,C,$4277.17
"Us Bank",,,02/04/2014,"Download from usbank.com.","Monthly Bills:Rent","Monthly Bills","Rent",,$1565.09,$0.00,C,$2712.08
"Us Bank",,,02/05/2014,"Download from usbank.com. WHOLE FOODS MARKSan FranciscCA","Everyday Expenses:Groceries","Everyday Expenses","Groceries",,$8.74,$0.00,C,$2703.34
"Us Bank",,,02/05/2014,"Download from usbank.com. THE CELLAR      SAN FRANCISCCA","Everyday Expenses:Spending Money","Everyday Expenses","Spending Money",,$13.00,$0.00,C,$2690.34
"Us Bank",,,02/05/2014,"Download from usbank.com. NORDSTROM 473 55SAN FRANCISCCA","Everyday Expenses:Clothing","Everyday Expenses","Clothing",,$34.73,$0.00,C,$2655.61
"Us Bank",,,02/06/2014,"Download from usbank.com. PAYPAL","Everyday Expenses:Spending Money","Everyday Expenses","Spending Money",,$8.55,$0.00,C,$2647.06
"Us Bank",,,02/06/2014,"Download from usbank.com. PAYPAL","Everyday Expenses:Spending Money","Everyday Expenses","Spending Money",,$12.68,$0.00,C,$2634.38
"Us Bank",,,02/06/2014,"Download from usbank.com. WALGREENS 1300 BSAN FRANCISCCA","Everyday Expenses:Household Goods","Everyday Expenses","Household Goods",,$16.61,$0.00,C,$2617.77
"Us Bank",,,02/06/2014,"Download from usbank.com. WALGREENS 670 4TSAN FRANCISCCA","Everyday Expenses:Household Goods","Everyday Expenses","Household Goods",,$17.60,$0.00,C,$2600.17
"Us Bank",,,02/06/2014,"Download from usbank.com. YOGA TREE - VALE415-701-9642CA","Everyday Expenses:Spending Money","Everyday Expenses","Spending Money",,$18.00,$0.00,C,$2582.17
"Us Bank",,,02/06/2014,"Download from usbank.com. LOCAL MOTION PHYSAN FRANCISCCA","Everyday Expenses:Medical","Everyday Expenses","Medical",,$25.00,$0.00,C,$2557.17
"Us Bank",,,02/07/2014,"Download from usbank.com. PAYPAL","Everyday Expenses:Spending Money","Everyday Expenses","Spending Money",,$10.02,$0.00,C,$2547.15
"Us Bank",,,02/07/2014,"Download from usbank.com. LYFT            855-865-9553CA","Everyday Expenses:Transportation","Everyday Expenses","Transportation",,$11.00,$0.00,C,$2536.15
"Us Bank",,,02/07/2014,"Download from usbank.com. YOGA TREE - VALE415-701-9642CA","Everyday Expenses:Spending Money","Everyday Expenses","Spending Money",,$18.00,$0.00,C,$2518.15
"Us Bank",,,02/10/2014,"Download from usbank.com. GROUPON INC     877-788-7858IL","Everyday Expenses:Spending Money","Everyday Expenses","Spending Money",,$0.00,$35.00,C,$2553.15
"Us Bank",,,02/10/2014,"Download from usbank.com. SQ *WORKSHOP CAFSan FranciscCA","Everyday Expenses:Spending Money","Everyday Expenses","Spending Money",,$0.00,$4.25,C,$2557.40
"Us Bank",,,02/10/2014,"Download from usbank.com. SUGAR CAFE      SAN FRANCISCCA","Everyday Expenses:Spending Money","Everyday Expenses","Spending Money",,$2.45,$0.00,C,$2554.95
"Us Bank",,,02/10/2014,"Download from usbank.com. SQ *WORKSHOP CAFSan FranciscCA","Everyday Expenses:Spending Money","Everyday Expenses","Spending Money",,$2.50,$0.00,C,$2552.45
"Us Bank",,,02/10/2014,"Download from usbank.com. SUGAR CAFE      SAN FRANCISCCA","Everyday Expenses:Spending Money","Everyday Expenses","Spending Money",,$2.50,$0.00,C,$2549.95
"Us Bank",,,02/10/2014,"Download from usbank.com. SQ *WORKSHOP CAFSan FranciscCA","Everyday Expenses:Spending Money","Everyday Expenses","Spending Money",,$4.00,$0.00,C,$2545.95
"Us Bank",,,02/10/2014,"Download from usbank.com. SQ *WORKSHOP CAFSan FranciscCA","Everyday Expenses:Spending Money","Everyday Expenses","Spending Money",,$4.25,$0.00,C,$2541.70
"Us Bank",,,02/10/2014,"Download from usbank.com. CUP A JOES COFFESAN FRANCISCCA","Everyday Expenses:Spending Money","Everyday Expenses","Spending Money",,$5.95,$0.00,C,$2535.75
"Us Bank",,,02/10/2014,"Download from usbank.com. WALGREENS 459 POSAN FRANCISCCA","Everyday Expenses:Household Goods","Everyday Expenses","Household Goods",,$5.97,$0.00,C,$2529.78
"Us Bank",,,02/10/2014,"Download from usbank.com. SQ *MASHUP LLC  San FranciscCA","Everyday Expenses:Spending Money","Everyday Expenses","Spending Money",,$6.50,$0.00,C,$2523.28
"Us Bank",,,02/10/2014,"Download from usbank.com. THE MELT BEACON SAN FRANCISCCA","Everyday Expenses:Spending Money","Everyday Expenses","Spending Money",,$7.79,$0.00,C,$2515.49
"Us Bank",,,02/10/2014,"Download from usbank.com. Amazon Services-866-216-1072WA","Everyday Expenses:Spending Money","Everyday Expenses","Spending Money",,$12.11,$0.00,C,$2503.38
"Us Bank",,,02/10/2014,"Download from usbank.com. TRADER JOE'S #20SAN FRANCISCCA","Everyday Expenses:Groceries","Everyday Expenses","Groceries",,$12.99,$0.00,C,$2490.39
"Us Bank",,,02/10/2014,"Download from usbank.com. SUTTER FINE FOODSAN FRANCISCCA","Everyday Expenses:Groceries","Everyday Expenses","Groceries",,$13.69,$0.00,C,$2476.70
"Us Bank",,,02/10/2014,"Download from usbank.com. CHIPOTLE 1857   SAN FRANCISCCA","Everyday Expenses:Spending Money","Everyday Expenses","Spending Money",,$14.68,$0.00,C,$2462.02
"Us Bank",,,02/10/2014,"Download from usbank.com. WALGREENS 1300 BSAN FRANCISCCA","Everyday Expenses:Household Goods","Everyday Expenses","Household Goods",,$20.89,$0.00,C,$2441.13
"Us Bank",,,02/10/2014,"Download from usbank.com. FANDANGO.COM    FANDANGO.COMCA","Everyday Expenses:Spending Money","Everyday Expenses","Spending Money",,$24.00,$0.00,C,$2417.13
"Us Bank",,,02/10/2014,"Download from usbank.com. GROUPON INC     877-788-7858IL","Everyday Expenses:Spending Money","Everyday Expenses","Spending Money",,$25.00,$0.00,C,$2392.13
"Us Bank",,,02/10/2014,"Download from usbank.com. SUDACHI         SAN FRANCISCCA","Everyday Expenses:Spending Money","Everyday Expenses","Spending Money",,$30.57,$0.00,C,$2361.56
"Us Bank",,,02/10/2014,"Download from usbank.com. GROUPON INC     877-788-7858IL","Everyday Expenses:Spending Money","Everyday Expenses","Spending Money",,$35.00,$0.00,C,$2326.56
"Us Bank",,,02/10/2014,"Download from usbank.com. CARDMEMBER SERV",,,,,$42.00,$0.00,C,$2284.56
"Us Bank",,,02/10/2014,"Download from usbank.com. WALGREENS 1300 BSAN FRANCISCCA","Everyday Expenses:Household Goods","Everyday Expenses","Household Goods",,$64.02,$0.00,C,$2220.54
"Us Bank",,,02/10/2014,"Download from usbank.com. PAYPAL","Everyday Expenses:Spending Money","Everyday Expenses","Spending Money",,$322.50,$0.00,C,$1898.04
"Us Bank",,,02/10/2014,"Download from usbank.com. 7246","Debt:Eric's Credit Card","Debt","Eric's Credit Card",,$500.00,$0.00,C,$1398.04
"Us Bank",,,02/11/2014,"Download from usbank.com. CHIPOTLE 1857   SAN FRANCISCCA","Everyday Expenses:Spending Money","Everyday Expenses","Spending Money",,$7.12,$0.00,C,$1390.92
"Us Bank",,,02/11/2014,"Download from usbank.com. TACQUERIA DOS AMSAN FRANCISCCA","Everyday Expenses:Spending Money","Everyday Expenses","Spending Money",,$9.14,$0.00,C,$1381.78
"Us Bank",,,02/11/2014,"Download from usbank.com. TRADER JOE'S #20SAN FRANCISCCA","Everyday Expenses:Groceries","Everyday Expenses","Groceries",,$12.76,$0.00,C,$1369.02
"Us Bank",,,02/12/2014,"Download from usbank.com. THE GROVE-HAYES SAN FRANCISCCA","Everyday Expenses:Spending Money","Everyday Expenses","Spending Money",,$17.25,$0.00,C,$1351.77
"Us Bank",,,02/13/2014,"Download from usbank.com. SUTTER FINE FOODSAN FRANCISCCA","Everyday Expenses:Groceries","Everyday Expenses","Groceries",,$4.08,$0.00,C,$1347.69
"Us Bank",,,02/13/2014,"Download from usbank.com. CUP A JOES COFFESAN FRANCISCCA","Everyday Expenses:Spending Money","Everyday Expenses","Spending Money",,$6.50,$0.00,C,$1341.19
"Us Bank",,,02/13/2014,"Download from usbank.com. LYFT            855-865-9553CA","Everyday Expenses:Transportation","Everyday Expenses","Transportation",,$8.00,$0.00,C,$1333.19
"Us Bank",,,02/13/2014,"Download from usbank.com. STARBUCKS #14393San FranciscCA","Everyday Expenses:Spending Money","Everyday Expenses","Spending Money",,$10.00,$0.00,C,$1323.19
"Us Bank",,,02/13/2014,"Download from usbank.com. JULIES KITCHEN #SAN FRANCISCCA","Everyday Expenses:Spending Money","Everyday Expenses","Spending Money",,$13.83,$0.00,C,$1309.36
"Us Bank",,,02/13/2014,"Download from usbank.com. SPRIG           4158945191  CA","Everyday Expenses:Spending Money","Everyday Expenses","Spending Money",,$22.00,$0.00,C,$1287.36
"Us Bank",,,02/13/2014,"Download from usbank.com. AMAZON MKTPLACE AMZN.COM/BILWA","Everyday Expenses:Spending Money","Everyday Expenses","Spending Money",,$24.90,$0.00,C,$1262.46
"Us Bank",,,02/13/2014,"Download from usbank.com. Amazon.com      AMZN.COM/BILWA","Everyday Expenses:Spending Money","Everyday Expenses","Spending Money",,$91.78,$0.00,C,$1170.68
"Us Bank",,,02/13/2014,"Download from usbank.com. VAIL RESORTS ESTVAIL        CO","Everyday Expenses:Spending Money","Everyday Expenses","Spending Money",,$199.00,$0.00,C,$971.68
"Us Bank",,,02/14/2014,"Download from usbank.com. SQWIGGLE INC","Income:Available this month","Income","Available this month",,$0.00,$1965.99,C,$2937.67
"Us Bank",,,02/14/2014,"Download from usbank.com. MODCLOTH INC","Income:Available this month","Income","Available this month",,$0.00,$1453.75,C,$4391.42
"Us Bank",,,02/14/2014,"Download from usbank.com. 021414PLUSTERM1020 JOHNSON LN LAKE TAHOE  CAUS1","Everyday Expenses:Spending Money","Everyday Expenses","Spending Money",,$2.50,$0.00,C,$4388.92
"Us Bank",,,02/14/2014,"Download from usbank.com. APL*APPLE ITUNES866-712-7753CA","Everyday Expenses:Spending Money","Everyday Expenses","Spending Money",,$2.99,$0.00,C,$4385.93
"Us Bank",,,02/14/2014,"Download from usbank.com. WALGREENS 1300 BSAN FRANCISCCA","Everyday Expenses:Household Goods","Everyday Expenses","Household Goods",,$7.93,$0.00,C,$4378.00
"Us Bank",,,02/14/2014,"Download from usbank.com. SUTTER FINE FOODSAN FRANCISCCA","Everyday Expenses:Groceries","Everyday Expenses","Groceries",,$25.52,$0.00,C,$4352.48
"Us Bank",,,02/14/2014,"Download from usbank.com. PAYPAL","Everyday Expenses:Spending Money","Everyday Expenses","Spending Money",,$39.99,$0.00,C,$4312.49
"Us Bank",,,02/14/2014,"Download from usbank.com. SQ *BEAUTIFIED SSan FranciscCA","Everyday Expenses:Spending Money","Everyday Expenses","Spending Money",,$66.00,$0.00,C,$4246.49
"Us Bank",,,02/14/2014,"Download from usbank.com. TRADER JOE'S #20SAN FRANCISCCA","Everyday Expenses:Groceries","Everyday Expenses","Groceries",,$66.04,$0.00,C,$4180.45
"Us Bank",,,02/14/2014,"Download from usbank.com. BARCLAYS BANK DE","Savings Goals:Savings","Savings Goals","Savings",,$100.00,$0.00,C,$4080.45
"Us Bank",,,02/14/2014,"Download from usbank.com. 1020 JOHNSON LN LAKE TAHOE  CAUS1","Everyday Expenses:Spending Money","Everyday Expenses","Spending Money",,$203.00,$0.00,C,$3877.45
"Us Bank",,,02/18/2014,"Download from usbank.com. FRESH POND GAS  POLLOCK PINECA","Everyday Expenses:Spending Money","Everyday Expenses","Spending Money",,$8.42,$0.00,C,$3869.03
"Us Bank",,,02/18/2014,"Download from usbank.com. BITE            SAN FRANCISCCA","Everyday Expenses:Spending Money","Everyday Expenses","Spending Money",,$9.32,$0.00,C,$3859.71
"Us Bank",,,02/18/2014,"Download from usbank.com. CUP A JOES COFFESAN FRANCISCCA","Everyday Expenses:Spending Money","Everyday Expenses","Spending Money",,$9.70,$0.00,C,$3850.01
"Us Bank",,,02/18/2014,"Download from usbank.com. ORDERAHEADAPP.CO650-503-3279CA","Everyday Expenses:Spending Money","Everyday Expenses","Spending Money",,$11.64,$0.00,C,$3838.37
"Us Bank",,,02/18/2014,"Download from usbank.com. SAFFRON LOUNGE  SAN FRANCISCCA","Everyday Expenses:Spending Money","Everyday Expenses","Spending Money",,$11.69,$0.00,C,$3826.68
"Us Bank",,,02/18/2014,"Download from usbank.com. MODCLOTH INC.   888-4959699 CA","Everyday Expenses:Spending Money","Everyday Expenses","Spending Money",,$14.59,$0.00,C,$3812.09
"Us Bank",,,02/18/2014,"Download from usbank.com. EL POLLO LOCO 35FAIRFIELD   CA","Everyday Expenses:Spending Money","Everyday Expenses","Spending Money",,$16.05,$0.00,C,$3796.04
"Us Bank",,,02/18/2014,"Download from usbank.com. SUTTER PUB      SAN FRANCISCCA","Everyday Expenses:Spending Money","Everyday Expenses","Spending Money",,$25.39,$0.00,C,$3770.65
"Us Bank",,,02/18/2014,"Download from usbank.com. PICNIC          SAN FRANCISCCA","Everyday Expenses:Spending Money","Everyday Expenses","Spending Money",,$33.81,$0.00,C,$3736.84
"Us Bank",,,02/18/2014,"Download from usbank.com. STAGECOACH-SLICESTATELINE   NV","Everyday Expenses:Spending Money","Everyday Expenses","Spending Money",,$35.55,$0.00,C,$3701.29
"Us Bank",,,02/18/2014,"Download from usbank.com. LOMBARDI`S SPORTSAN FRANCISCCA","Everyday Expenses:Spending Money","Everyday Expenses","Spending Money",,$59.81,$0.00,C,$3641.48
"Us Bank",,,02/18/2014,"Download from usbank.com. HEAVENLY SPORT-SSTATELINE   NV","Everyday Expenses:Spending Money","Everyday Expenses","Spending Money",,$67.78,$0.00,C,$3573.70
"Us Bank",,,02/18/2014,"Download from usbank.com. BARCLAYS BANK DE","Savings Goals:Savings","Savings Goals","Savings",,$100.00,$0.00,C,$3473.70
"Us Bank",,,02/18/2014,"Download from usbank.com.","Everyday Expenses:Spending Money","Everyday Expenses","Spending Money",,$200.00,$0.00,C,$3273.70
"Us Bank",,,02/19/2014,"Download from usbank.com. WHOLE FOODS MARKSan FranciscCA","Everyday Expenses:Groceries","Everyday Expenses","Groceries",,$4.83,$0.00,C,$3268.87
"Us Bank",,,02/19/2014,"Download from usbank.com. HLU*Hulu 4502449HULU.COM/BILCA","Monthly Bills:Web Stuff","Monthly Bills","Web Stuff",,$7.99,$0.00,C,$3260.88
"Us Bank",,,02/19/2014,"Download from usbank.com. SUBWAY # 6625   SAN FRANCISCCA","Everyday Expenses:Spending Money","Everyday Expenses","Spending Money",,$8.97,$0.00,C,$3251.91
"Us Bank",,,02/19/2014,"Download from usbank.com. BAR BASIC       SAN FRANCISCCA","Everyday Expenses:Spending Money","Everyday Expenses","Spending Money",,$14.00,$0.00,C,$3237.91
"Us Bank",,,02/19/2014,"Download from usbank.com. YELPINC*EAT24 DA415-908-3801CA","Everyday Expenses:Spending Money","Everyday Expenses","Spending Money",,$30.28,$0.00,C,$3207.63
"Us Bank",,,02/19/2014,"Download from usbank.com. ATT","Monthly Bills:Cell Phone","Monthly Bills","Cell Phone",,$226.64,$0.00,C,$2980.99
"Us Bank",,,02/20/2014,"Download from usbank.com. SEAMLESS        800-905-9322NY","Everyday Expenses:Spending Money","Everyday Expenses","Spending Money",,$7.50,$0.00,C,$2973.49
"Us Bank",,,02/20/2014,"Download from usbank.com. YELPINC*EAT24 KI415-908-3801CA","Everyday Expenses:Spending Money","Everyday Expenses","Spending Money",,$9.34,$0.00,C,$2964.15
"Us Bank",,,02/20/2014,"Download from usbank.com. PAYPAL","Everyday Expenses:Spending Money","Everyday Expenses","Spending Money",,$9.99,$0.00,C,$2954.16
"Us Bank",,,02/20/2014,"Download from usbank.com. LOMBARDI`S SPORTSAN FRANCISCCA","Everyday Expenses:Spending Money","Everyday Expenses","Spending Money",,$10.88,$0.00,C,$2943.28
"Us Bank",,,02/20/2014,"Download from usbank.com. LYFT            855-865-9553CA","Everyday Expenses:Transportation","Everyday Expenses","Transportation",,$16.00,$0.00,C,$2927.28
"Us Bank",,,02/20/2014,"Download from usbank.com. SPRIG           4158945191  CA","Everyday Expenses:Spending Money","Everyday Expenses","Spending Money",,$22.00,$0.00,C,$2905.28
"Us Bank",,,02/20/2014,"Download from usbank.com. WALGREENS 1300 BSAN FRANCISCCA","Everyday Expenses:Household Goods","Everyday Expenses","Household Goods",,$25.63,$0.00,C,$2879.65
"Us Bank",,,02/21/2014,"Download from usbank.com. SQ *STARBUCKS #0San FranciscCA","Everyday Expenses:Spending Money","Everyday Expenses","Spending Money",,$6.20,$0.00,C,$2873.45
"Us Bank",,,02/21/2014,"Download from usbank.com. SPOONROCKET.COM 5109219929  CA","Everyday Expenses:Spending Money","Everyday Expenses","Spending Money",,$6.52,$0.00,C,$2866.93
"Us Bank",,,02/21/2014,"Download from usbank.com. TACQUERIA DOS AMSAN FRANCISCCA","Everyday Expenses:Spending Money","Everyday Expenses","Spending Money",,$7.88,$0.00,C,$2859.05
"Us Bank",,,02/21/2014,"Download from usbank.com. LYFT            855-865-9553CA","Everyday Expenses:Transportation","Everyday Expenses","Transportation",,$10.00,$0.00,C,$2849.05
"Us Bank",,,02/21/2014,"Download from usbank.com. Amazon.com      AMZN.COM/BILWA","Everyday Expenses:Spending Money","Everyday Expenses","Spending Money",,$50.57,$0.00,C,$2798.48
"Us Bank",,,02/24/2014,"Download from usbank.com. CUP A JOES COFFESAN FRANCISCCA","Everyday Expenses:Spending Money","Everyday Expenses","Spending Money",,$4.50,$0.00,C,$2793.98
"Us Bank",,,02/24/2014,"Download from usbank.com. PAYPAL","Everyday Expenses:Spending Money","Everyday Expenses","Spending Money",,$5.00,$0.00,C,$2788.98
"Us Bank",,,02/24/2014,"Download from usbank.com. PAYPAL","Everyday Expenses:Spending Money","Everyday Expenses","Spending Money",,$7.15,$0.00,C,$2781.83
"Us Bank",,,02/24/2014,"Download from usbank.com. Discount GrocersSan FranciscCA","Everyday Expenses:Groceries","Everyday Expenses","Groceries",,$10.67,$0.00,C,$2771.16
"Us Bank",,,02/24/2014,"Download from usbank.com. PAYPAL","Everyday Expenses:Spending Money","Everyday Expenses","Spending Money",,$12.42,$0.00,C,$2758.74
"Us Bank",,,02/24/2014,"Download from usbank.com. YOGA TREE - POTR415-701-9642CA","Everyday Expenses:Spending Money","Everyday Expenses","Spending Money",,$19.00,$0.00,C,$2739.74
"Us Bank",,,02/24/2014,"Download from usbank.com. SUDACHI         SAN FRANCISCCA","Everyday Expenses:Spending Money","Everyday Expenses","Spending Money",,$20.34,$0.00,C,$2719.40
"Us Bank",,,02/24/2014,"Download from usbank.com. SLIDERS DINER   SAN FRANCISCCA","Everyday Expenses:Spending Money","Everyday Expenses","Spending Money",,$23.11,$0.00,C,$2696.29
"Us Bank",,,02/24/2014,"Download from usbank.com. FOREVER 21 INC  SAN FRANCISCCA","Everyday Expenses:Clothing","Everyday Expenses","Clothing",,$23.49,$0.00,C,$2672.80
"Us Bank",,,02/24/2014,"Download from usbank.com. PAYPAL","Everyday Expenses:Spending Money","Everyday Expenses","Spending Money",,$25.50,$0.00,C,$2647.30
"Us Bank",,,02/24/2014,"Download from usbank.com. PAYPAL","Everyday Expenses:Spending Money","Everyday Expenses","Spending Money",,$43.56,$0.00,C,$2603.74
"Us Bank",,,02/25/2014,"Download from usbank.com.","Everyday Expenses:Spending Money","Everyday Expenses","Spending Money",,$0.00,$6.95,C,$2610.69
"Us Bank",,,02/25/2014,"Download from usbank.com. SQ *SAVOURIE STRSan FranciscCA","Everyday Expenses:Spending Money","Everyday Expenses","Spending Money",,$5.75,$0.00,C,$2604.94
"Us Bank",,,02/25/2014,"Download from usbank.com.","Everyday Expenses:Spending Money","Everyday Expenses","Spending Money",,$6.95,$0.00,C,$2597.99
"Us Bank",,,02/25/2014,"Download from usbank.com. HLU*Hulu 2274453HULU.COM/BILCA","Monthly Bills:Web Stuff","Monthly Bills","Web Stuff",,$7.99,$0.00,C,$2590.00
"Us Bank",,,02/25/2014,"Download from usbank.com. AMC VAN NESS 14 SAN FRANCISCCA","Everyday Expenses:Spending Money","Everyday Expenses","Spending Money",,$24.00,$0.00,C,$2566.00
"Us Bank",,,02/25/2014,"Download from usbank.com. TRADER JOE'S #20SAN FRANCISCCA","Everyday Expenses:Groceries","Everyday Expenses","Groceries",,$25.64,$0.00,C,$2540.36
"Us Bank",,,02/25/2014,"Download from usbank.com. SPRIG           415-894-5191CA","Everyday Expenses:Spending Money","Everyday Expenses","Spending Money",,$32.00,$0.00,C,$2508.36
"Us Bank",,,02/25/2014,"Download from usbank.com. MARRIOTT THE VIESAN FRANCISCCA","Everyday Expenses:Spending Money","Everyday Expenses","Spending Money",,$32.62,$0.00,C,$2475.74
"Us Bank",,,02/25/2014,"Download from usbank.com. HOMEJOY         855-728-4569CA","Everyday Expenses:Spending Money","Everyday Expenses","Spending Money",,$65.00,$0.00,C,$2410.74
"Us Bank",,,02/26/2014,"Download from usbank.com. WALGREENS 1300 BSAN FRANCISCCA","Everyday Expenses:Household Goods","Everyday Expenses","Household Goods",,$6.49,$0.00,C,$2404.25
"Us Bank",,,02/26/2014,"Download from usbank.com. CUP A JOES COFFESAN FRANCISCCA","Everyday Expenses:Spending Money","Everyday Expenses","Spending Money",,$7.25,$0.00,C,$2397.00
"Us Bank",,,02/26/2014,"Download from usbank.com. GE Capital",,,,,$25.00,$0.00,C,$2372.00
"Us Bank",,,02/26/2014,"Download from usbank.com. SUTTER PUB      SAN FRANCISCCA","Everyday Expenses:Spending Money","Everyday Expenses","Spending Money",,$27.92,$0.00,C,$2344.08
"Us Bank",,,02/26/2014,"Download from usbank.com. TRADER JOE'S #20SAN FRANCISCCA","Everyday Expenses:Groceries","Everyday Expenses","Groceries",,$58.98,$0.00,C,$2285.10
"Us Bank",,,02/27/2014,"Download from usbank.com. SQ *WORKSHOP CAFSan FranciscCA","Everyday Expenses:Spending Money","Everyday Expenses","Spending Money",,$4.00,$0.00,C,$2281.10
"Us Bank",,,02/27/2014,"Download from usbank.com. CUP A JOES COFFESAN FRANCISCCA","Everyday Expenses:Spending Money","Everyday Expenses","Spending Money",,$6.95,$0.00,C,$2274.15
"Us Bank",,,02/28/2014,"Download from usbank.com. SQWIGGLE INC","Income:Available this month","Income","Available this month",,$0.00,$1965.99,C,$4240.14
"Us Bank",,,02/28/2014,"Download from usbank.com. MODCLOTH INC","Income:Available this month","Income","Available this month",,$0.00,$1453.74,C,$5693.88
"Us Bank",,,02/28/2014,"Download from usbank.com. AMAZON DIG464603","Everyday Expenses:Spending Money","Everyday Expenses","Spending Money",,$0.00,$0.66,C,$5694.54
"Us Bank",,,02/28/2014,"Download from usbank.com. SAFEWAY STORE  1SOUTH LAKE TCA","Everyday Expenses:Spending Money","Everyday Expenses","Spending Money",,$3.50,$0.00,C,$5691.04
"Us Bank",,,02/28/2014,"Download from usbank.com. CHIPOTLE 1857   SAN FRANCISCCA","Everyday Expenses:Spending Money","Everyday Expenses","Spending Money",,$7.56,$0.00,C,$5683.48
"Us Bank",,,02/28/2014,"Download from usbank.com. CUP A JOES COFFESAN FRANCISCCA","Everyday Expenses:Spending Money","Everyday Expenses","Spending Money",,$8.20,$0.00,C,$5675.28
"Us Bank",,,02/28/2014,"Download from usbank.com. VENMO           646-801-3023NY","Everyday Expenses:Spending Money","Everyday Expenses","Spending Money",,$10.00,$0.00,C,$5665.28
"Us Bank",,,02/28/2014,"Download from usbank.com. Amazon.com      AMZN.COM/BILWA","Everyday Expenses:Spending Money","Everyday Expenses","Spending Money",,$18.28,$0.00,C,$5647.00
"Us Bank",,,02/28/2014,"Download from usbank.com. WALGREENS 500 GESAN FRANCISCCA","Everyday Expenses:Household Goods","Everyday Expenses","Household Goods",,$40.28,$0.00,C,$5606.72
"Us Bank",,,02/28/2014,"Download from usbank.com. BARCLAYS BANK DE","Savings Goals:Savings","Savings Goals","Savings",,$100.00,$0.00,C,$5506.72
"Us Bank",,,03/03/2014,"Download from usbank.com. ARAMARK DIXIE ZEZEPHYR COVE NV","Everyday Expenses:Spending Money","Everyday Expenses","Spending Money",,$5.00,$0.00,C,$5501.72
"Us Bank",,,03/03/2014,"Download from usbank.com. CUP A JOES COFFESAN FRANCISCCA","Everyday Expenses:Spending Money","Everyday Expenses","Spending Money",,$7.20,$0.00,C,$5494.52
"Us Bank",,,03/03/2014,"Download from usbank.com. CHICK-FIL-A #017SACRAMENTO  CA","Everyday Expenses:Spending Money","Everyday Expenses","Spending Money",,$7.55,$0.00,C,$5486.97
"Us Bank",,,03/03/2014,"Download from usbank.com. TACQUERIA DOS AMSAN FRANCISCCA","Everyday Expenses:Spending Money","Everyday Expenses","Spending Money",,$8.05,$0.00,C,$5478.92
"Us Bank",,,03/03/2014,"Download from usbank.com. NEPHELE'S RESTAUSOUTH LAKE TCA","Everyday Expenses:Spending Money","Everyday Expenses","Spending Money",,$8.75,$0.00,C,$5470.17
"Us Bank",,,03/03/2014,"Download from usbank.com. STARBUCKS #05404San FranciscCA","Everyday Expenses:Spending Money","Everyday Expenses","Spending Money",,$10.00,$0.00,C,$5460.17
"Us Bank",,,03/03/2014,"Download from usbank.com. KYBURZ SILVERFORKYBURZ      CA","Everyday Expenses:Spending Money","Everyday Expenses","Spending Money",,$12.07,$0.00,C,$5448.10
"Us Bank",,,03/03/2014,"Download from usbank.com. VENMO           646-801-3023NY","Everyday Expenses:Spending Money","Everyday Expenses","Spending Money",,$13.00,$0.00,C,$5435.10
"Us Bank",,,03/03/2014,"Download from usbank.com. YOGA TREE - POTR415-701-9642CA","Everyday Expenses:Spending Money","Everyday Expenses","Spending Money",,$19.00,$0.00,C,$5416.10
"Us Bank",,,03/03/2014,"Download from usbank.com. VICTORIA'S SECRESAN FRANCISCCA","Everyday Expenses:Clothing","Everyday Expenses","Clothing",,$45.78,$0.00,C,$5370.32
"Us Bank",,,03/03/2014,"Download from usbank.com. MET CAS INS CO","Monthly Bills:Car Insurance","Monthly Bills","Car Insurance",,$49.00,$0.00,C,$5321.32
"Us Bank",,,03/03/2014,"Download from usbank.com. MODCLOTH INC.   888-4959699 CA","Everyday Expenses:Clothing","Everyday Expenses","Clothing",,$54.01,$0.00,C,$5267.31
"Us Bank",,,03/03/2014,"Download from usbank.com. WHOLE FOODS MARKSan FranciscCA","Everyday Expenses:Groceries","Everyday Expenses","Groceries",,$63.65,$0.00,C,$5203.66
"Us Bank",,,03/03/2014,"Download from usbank.com. BARCLAYS BANK DE","Savings Goals:Savings","Savings Goals","Savings",,$100.00,$0.00,C,$5103.66
"Us Bank",,,03/03/2014,"Download from usbank.com. H&M             SAN FRANCISCCA","Everyday Expenses:Clothing","Everyday Expenses","Clothing",,$134.57,$0.00,C,$4969.09
"Us Bank",,,03/04/2014,"Download from usbank.com. SQ *WORKSHOP CAFSan FranciscCA","Everyday Expenses:Spending Money","Everyday Expenses","Spending Money",,$4.00,$0.00,C,$4965.09
"Us Bank",,,03/04/2014,"Download from usbank.com. SPRIG           415-894-5191CA","Everyday Expenses:Spending Money","Everyday Expenses","Spending Money",,$32.00,$0.00,C,$4933.09
"Us Bank",,,03/05/2014,"Download from usbank.com. SQ *WORKSHOP CAFSan FranciscCA","Everyday Expenses:Spending Money","Everyday Expenses","Spending Money",,$4.00,$0.00,C,$4929.09
"Us Bank",,,03/05/2014,"Download from usbank.com. CHAAT CAFE EXPRESAN FRANCISCCA","Everyday Expenses:Spending Money","Everyday Expenses","Spending Money",,$8.69,$0.00,C,$4920.40
"Us Bank",,,03/05/2014,"Download from usbank.com. PAYPAL","Everyday Expenses:Spending Money","Everyday Expenses","Spending Money",,$8.69,$0.00,C,$4911.71
"Us Bank",,,03/05/2014,"Download from usbank.com. WALGREENS 1300 BSAN FRANCISCCA","Everyday Expenses:Household Goods","Everyday Expenses","Household Goods",,$11.94,$0.00,C,$4899.77
"Us Bank",,,03/05/2014,"Download from usbank.com. DARWIN CAFE     SAN FRANCISCCA","Everyday Expenses:Spending Money","Everyday Expenses","Spending Money",,$12.00,$0.00,C,$4887.77
"Us Bank",,,03/05/2014,"Download from usbank.com. TRADER JOE'S #20SAN FRANCISCCA","Everyday Expenses:Groceries","Everyday Expenses","Groceries",,$37.12,$0.00,C,$4850.65
"Us Bank",,,03/06/2014,"Download from usbank.com. CHIPOTLE 1857   SAN FRANCISCCA","Everyday Expenses:Spending Money","Everyday Expenses","Spending Money",,$7.56,$0.00,C,$4843.09
"Us Bank",,,03/06/2014,"Download from usbank.com. BART-POWELL     SAN FRANCISCCA","Everyday Expenses:Transportation","Everyday Expenses","Transportation",,$8.65,$0.00,C,$4834.44
"Us Bank",,,03/06/2014,"Download from usbank.com. PAYPAL","Everyday Expenses:Spending Money","Everyday Expenses","Spending Money",,$10.39,$0.00,C,$4824.05
"Us Bank",,,03/06/2014,"Download from usbank.com. TRADER JOE'S #20SAN FRANCISCCA","Everyday Expenses:Groceries","Everyday Expenses","Groceries",,$11.49,$0.00,C,$4812.56
"Us Bank",,,03/06/2014,"Download from usbank.com. BART-POWELL     SAN FRANCISCCA","Everyday Expenses:Transportation","Everyday Expenses","Transportation",,$17.30,$0.00,C,$4795.26
"Us Bank",,,03/06/2014,"Download from usbank.com. SOUTHWES    5262800-435-9792TX","Everyday Expenses:Spending Money","Everyday Expenses","Spending Money",,$22.00,$0.00,C,$4773.26
"Us Bank",,,03/06/2014,"Download from usbank.com. TEDS SPORTS BAR SAN FRANCISCCA","Everyday Expenses:Spending Money","Everyday Expenses","Spending Money",,$31.05,$0.00,C,$4742.21
"Us Bank",,,03/06/2014,"Download from usbank.com. SOUTHWES    5262800-435-9792TX","Everyday Expenses:Spending Money","Everyday Expenses","Spending Money",,$66.00,$0.00,C,$4676.21
"Us Bank",,,03/06/2014,"Download from usbank.com. AIRBNB INC      415-800-5959CA","Everyday Expenses:Spending Money","Everyday Expenses","Spending Money",,$246.00,$0.00,C,$4430.21
"Us Bank",,,03/07/2014,"Download from usbank.com. PAYPAL","Everyday Expenses:Spending Money","Everyday Expenses","Spending Money",,$8.32,$0.00,C,$4421.89
"Us Bank",,,03/07/2014,"Download from usbank.com. SPRIG           415-894-5191CA","Everyday Expenses:Spending Money","Everyday Expenses","Spending Money",,$12.00,$0.00,C,$4409.89
"Us Bank",,,03/07/2014,"Download from usbank.com. D URSOS ITALIAN SAN FRANCISCCA","Everyday Expenses:Spending Money","Everyday Expenses","Spending Money",,$14.45,$0.00,C,$4395.44
"Us Bank",,,03/10/2014,"Download from usbank.com. 030914PLUSTERM201 BRAZOS      AUSTIN      TXUS1","Everyday Expenses:Spending Money","Everyday Expenses","Spending Money",,$2.50,$0.00,C,$4392.94
"Us Bank",,,03/10/2014,"Download from usbank.com. ROYAL BLUE GROCEAUSTIN      TX","Everyday Expenses:Spending Money","Everyday Expenses","Spending Money",,$2.95,$0.00,C,$4389.99
"Us Bank",,,03/10/2014,"Download from usbank.com. CUP A JOES COFFESAN FRANCISCCA","Everyday Expenses:Spending Money","Everyday Expenses","Spending Money",,$5.95,$0.00,C,$4384.04
"Us Bank",,,03/10/2014,"Download from usbank.com. THE HANGAR LOUNGLOCATION    TX","Everyday Expenses:Spending Money","Everyday Expenses","Spending Money",,$9.00,$0.00,C,$4375.04
"Us Bank",,,03/10/2014,"Download from usbank.com. SQ *KABABEQUE   Austin      TX","Everyday Expenses:Spending Money","Everyday Expenses","Spending Money",,$9.65,$0.00,C,$4365.39
"Us Bank",,,03/10/2014,"Download from usbank.com. NNT AUSTIN JUICYAUSTIN      TX","Everyday Expenses:Spending Money","Everyday Expenses","Spending Money",,$9.69,$0.00,C,$4355.70
"Us Bank",,,03/10/2014,"Download from usbank.com. MARKET & RYE    SAN FRANCISCCA","Everyday Expenses:Spending Money","Everyday Expenses","Spending Money",,$9.70,$0.00,C,$4346.00
"Us Bank",,,03/10/2014,"Download from usbank.com. MAX S EATZ SFO30SAN FRANCISCCA","Everyday Expenses:Spending Money","Everyday Expenses","Spending Money",,$11.00,$0.00,C,$4335.00
"Us Bank",,,03/10/2014,"Download from usbank.com. PAYPAL","Everyday Expenses:Spending Money","Everyday Expenses","Spending Money",,$13.45,$0.00,C,$4321.55
"Us Bank",,,03/10/2014,"Download from usbank.com. Mars Bar & RestaSan FranciscCA","Everyday Expenses:Spending Money","Everyday Expenses","Spending Money",,$15.00,$0.00,C,$4306.55
"Us Bank",,,03/10/2014,"Download from usbank.com. PAYPAL","Everyday Expenses:Spending Money","Everyday Expenses","Spending Money",,$15.73,$0.00,C,$4290.82
"Us Bank",,,03/10/2014,"Download from usbank.com. RECESS ARCADE BA512-6989852 TX","Everyday Expenses:Spending Money","Everyday Expenses","Spending Money",,$16.00,$0.00,C,$4274.82
"Us Bank",,,03/10/2014,"Download from usbank.com. YOGA TREE - POTR415-701-9642CA","Everyday Expenses:Spending Money","Everyday Expenses","Spending Money",,$19.00,$0.00,C,$4255.82
"Us Bank",,,03/10/2014,"Download from usbank.com. NORTH BY NORTHWEAUSTIN      TX","Everyday Expenses:Spending Money","Everyday Expenses","Spending Money",,$24.84,$0.00,C,$4230.98
"Us Bank",,,03/10/2014,"Download from usbank.com. SOHO LOUNGE     AUSTIN      TX","Everyday Expenses:Spending Money","Everyday Expenses","Spending Money",,$25.00,$0.00,C,$4205.98
"Us Bank",,,03/10/2014,"Download from usbank.com. CARDMEMBER SERV",,,,,$42.00,$0.00,C,$4163.98
"Us Bank",,,03/10/2014,"Download from usbank.com. TRADER JOE'S #20SAN FRANCISCCA","Everyday Expenses:Groceries","Everyday Expenses","Groceries",,$50.02,$0.00,C,$4113.96
"Us Bank",,,03/10/2014,"Download from usbank.com. MODCLOTH INC.   888-4959699 CA","Everyday Expenses:Clothing","Everyday Expenses","Clothing",,$92.88,$0.00,C,$4021.08
"Us Bank",,,03/10/2014,"Download from usbank.com. US BANK CASTRO  SAN FRANCISCCAUS1","Everyday Expenses:Spending Money","Everyday Expenses","Spending Money",,$100.00,$0.00,C,$3921.08
"Us Bank",,,03/10/2014,"Download from usbank.com. 201 BRAZOS      AUSTIN      TXUS1","Everyday Expenses:Spending Money","Everyday Expenses","Spending Money",,$103.99,$0.00,C,$3817.09
"Us Bank",,,03/10/2014,"Download from usbank.com. YOGA TREE - POTR415-701-9642CA","Everyday Expenses:Spending Money","Everyday Expenses","Spending Money",,$108.00,$0.00,C,$3709.09
"Us Bank",,,03/11/2014,"Download from usbank.com. PAYPAL","Everyday Expenses:Spending Money","Everyday Expenses","Spending Money",,$8.76,$0.00,C,$3700.33
"Us Bank",,,03/11/2014,"Download from usbank.com. SUTTER FINE FOODSAN FRANCISCCA","Everyday Expenses:Groceries","Everyday Expenses","Groceries",,$12.27,$0.00,C,$3688.06
"Us Bank",,,03/11/2014,"Download from usbank.com. Delia's         888-533-5427NY","Everyday Expenses:Spending Money","Everyday Expenses","Spending Money",,$38.28,$0.00,C,$3649.78
"Us Bank",,,03/11/2014,"Download from usbank.com.","Everyday Expenses:Spending Money","Everyday Expenses","Spending Money",,$1565.00,$0.00,C,$2084.78
"Us Bank",,,03/12/2014,"Download from usbank.com. DNC TRAVEL - AUSAUSTIN      TX","Everyday Expenses:Spending Money","Everyday Expenses","Spending Money",,$3.40,$0.00,C,$2081.38
"Us Bank",,,03/12/2014,"Download from usbank.com. DNC TRAVEL - AUSAUSTIN      TX","Everyday Expenses:Spending Money","Everyday Expenses","Spending Money",,$9.72,$0.00,C,$2071.66
"Us Bank",,,03/12/2014,"Download from usbank.com. CAFFE CENTRO    SAN FRANCISCCA","Everyday Expenses:Spending Money","Everyday Expenses","Spending Money",,$12.78,$0.00,C,$2058.88
"Us Bank",,,03/13/2014,"Download from usbank.com. DARWIN CAFE     SAN FRANCISCCA","Everyday Expenses:Spending Money","Everyday Expenses","Spending Money",,$11.00,$0.00,C,$2047.88
"Us Bank",,,03/13/2014,"Download from usbank.com. 7246","Debt:Eric's Credit Card","Debt","Eric's Credit Card",,$500.00,$0.00,C,$1547.88
"Us Bank",,,03/14/2014,"Download from usbank.com. SQWIGGLE INC","Income:Available this month","Income","Available this month",,$0.00,$1965.99,C,$3513.87
"Us Bank",,,03/14/2014,"Download from usbank.com. MODCLOTH INC","Income:Available this month","Income","Available this month",,$0.00,$1453.74,C,$4967.61
"Us Bank",,,03/14/2014,"Download from usbank.com. SUDACHI         SAN FRANCISCCA","Everyday Expenses:Spending Money","Everyday Expenses","Spending Money",,$37.33,$0.00,C,$4930.28
"Us Bank",,,03/14/2014,"Download from usbank.com. BARCLAYS BANK DE","Savings Goals:Savings","Savings Goals","Savings",,$100.00,$0.00,C,$4830.28
"Us Bank",,,03/17/2014,"Download from usbank.com. PAYPAL","Everyday Expenses:Spending Money","Everyday Expenses","Spending Money",,$1.79,$0.00,C,$4828.49
"Us Bank",,,03/17/2014,"Download from usbank.com. BELLISSIMO PIZZASAN FRANCISCCA","Everyday Expenses:Spending Money","Everyday Expenses","Spending Money",,$7.00,$0.00,C,$4821.49
"Us Bank",,,03/17/2014,"Download from usbank.com. LYFT            855-865-9553CA","Everyday Expenses:Transportation","Everyday Expenses","Transportation",,$8.00,$0.00,C,$4813.49
"Us Bank",,,03/17/2014,"Download from usbank.com. PAYPAL","Everyday Expenses:Spending Money","Everyday Expenses","Spending Money",,$9.24,$0.00,C,$4804.25
"Us Bank",,,03/17/2014,"Download from usbank.com. CUP A JOES COFFESAN FRANCISCCA","Everyday Expenses:Spending Money","Everyday Expenses","Spending Money",,$11.90,$0.00,C,$4792.35
"Us Bank",,,03/17/2014,"Download from usbank.com. WALGREENS 1300 BSAN FRANCISCCA","Everyday Expenses:Household Goods","Everyday Expenses","Household Goods",,$11.94,$0.00,C,$4780.41
"Us Bank",,,03/17/2014,"Download from usbank.com. LYFT            8558659553  CA","Everyday Expenses:Transportation","Everyday Expenses","Transportation",,$18.00,$0.00,C,$4762.41
"Us Bank",,,03/17/2014,"Download from usbank.com. SQ *ACADEMY CAFESan FranciscCA","Everyday Expenses:Spending Money","Everyday Expenses","Spending Money",,$18.56,$0.00,C,$4743.85
"Us Bank",,,03/17/2014,"Download from usbank.com. AMC VAN NESS 14 SAN FRANCISCCA","Everyday Expenses:Spending Money","Everyday Expenses","Spending Money",,$20.50,$0.00,C,$4723.35
"Us Bank",,,03/17/2014,"Download from usbank.com. SQ *BBC BARS AT San FranciscCA","Everyday Expenses:Spending Money","Everyday Expenses","Spending Money",,$21.00,$0.00,C,$4702.35
"Us Bank",,,03/17/2014,"Download from usbank.com. SQ *BBC BARS AT San FranciscCA","Everyday Expenses:Spending Money","Everyday Expenses","Spending Money",,$21.00,$0.00,C,$4681.35
"Us Bank",,,03/17/2014,"Download from usbank.com. SQ *BBC BARS AT San FranciscCA","Everyday Expenses:Spending Money","Everyday Expenses","Spending Money",,$21.00,$0.00,C,$4660.35
"Us Bank",,,03/17/2014,"Download from usbank.com. LYFT            855-865-9553CA","Everyday Expenses:Transportation","Everyday Expenses","Transportation",,$22.00,$0.00,C,$4638.35
"Us Bank",,,03/17/2014,"Download from usbank.com. WALGREENS 1300 BSAN FRANCISCCA","Everyday Expenses:Household Goods","Everyday Expenses","Household Goods",,$30.85,$0.00,C,$4607.50
"Us Bank",,,03/17/2014,"Download from usbank.com. CALIFORNIA ACADE415-379-8000CA","Everyday Expenses:Spending Money","Everyday Expenses","Spending Money",,$36.00,$0.00,C,$4571.50
"Us Bank",,,03/17/2014,"Download from usbank.com. CHA CHA CHA (MISSAN FRANCISCCA","Everyday Expenses:Spending Money","Everyday Expenses","Spending Money",,$42.00,$0.00,C,$4529.50
"Us Bank",,,03/17/2014,"Download from usbank.com. FLY             SAN FRANCISCCA","Everyday Expenses:Spending Money","Everyday Expenses","Spending Money",,$50.00,$0.00,C,$4479.50
"Us Bank",,,03/17/2014,"Download from usbank.com. TRADER JOE'S #20SAN FRANCISCCA","Everyday Expenses:Groceries","Everyday Expenses","Groceries",,$52.72,$0.00,C,$4426.78
"Us Bank",,,03/17/2014,"Download from usbank.com. PGANDE","Monthly Bills:Utilities","Monthly Bills","Utilities",,$66.76,$0.00,C,$4360.02
"Us Bank",,,03/17/2014,"Download from usbank.com. BARCLAYS BANK DE","Savings Goals:Savings","Savings Goals","Savings",,$100.00,$0.00,C,$4260.02
"Us Bank",,,03/17/2014,"Download from usbank.com. WHOLE FOODS MARKSan FranciscCA","Everyday Expenses:Groceries","Everyday Expenses","Groceries",,$150.56,$0.00,C,$4109.46
"Us Bank",,,03/17/2014,"Download from usbank.com. COMCAST","Monthly Bills:Utilities","Monthly Bills","Utilities",,$151.30,$0.00,C,$3958.16
"Us Bank",,,03/18/2014,"Download from usbank.com. SUGAR CAFE      SAN FRANCISCCA","Everyday Expenses:Spending Money","Everyday Expenses","Spending Money",,$10.33,$0.00,C,$3947.83
"Us Bank",,,03/18/2014,"Download from usbank.com. SUGAR CAFE      SAN FRANCISCCA","Everyday Expenses:Spending Money","Everyday Expenses","Spending Money",,$25.01,$0.00,C,$3922.82
"Us Bank",,,03/18/2014,"Download from usbank.com. SUTTER FINE FOODSAN FRANCISCCA","Everyday Expenses:Groceries","Everyday Expenses","Groceries",,$25.56,$0.00,C,$3897.26
"Us Bank",,,03/18/2014,"Download from usbank.com. LIVINGSOCIAL*   202-695-8945DC","Everyday Expenses:Transportation","Everyday Expenses","Transportation",,$42.00,$0.00,C,$3855.26
"Us Bank",,,03/19/2014,"Download from usbank.com. TACQUERIA DOS AMSAN FRANCISCCA","Everyday Expenses:Spending Money","Everyday Expenses","Spending Money",,$7.17,$0.00,C,$3848.09
"Us Bank",,,03/19/2014,"Download from usbank.com. HLU*Hulu 4502449HULU.COM/BILCA","Monthly Bills:Web Stuff","Monthly Bills","Web Stuff",,$7.99,$0.00,C,$3840.10
"Us Bank",,,03/19/2014,"Download from usbank.com. ATT","Monthly Bills:Cell Phone","Monthly Bills","Cell Phone",,$225.95,$0.00,C,$3614.15
"Us Bank",,,03/20/2014,"Download from usbank.com. LIVINGSOCIAL*   202-695-8945DC","Everyday Expenses:Transportation","Everyday Expenses","Transportation",,$0.00,$42.00,C,$3656.15
"Us Bank",,,03/20/2014,"Download from usbank.com. PAYPAL","Everyday Expenses:Spending Money","Everyday Expenses","Spending Money",,$9.03,$0.00,C,$3647.12
"Us Bank",,,03/20/2014,"Download from usbank.com. PAYPAL","Everyday Expenses:Spending Money","Everyday Expenses","Spending Money",,$9.99,$0.00,C,$3637.13
"Us Bank",,,03/20/2014,"Download from usbank.com. WALGREENS 500 GESAN FRANCISCCA","Everyday Expenses:Household Goods","Everyday Expenses","Household Goods",,$29.78,$0.00,C,$3607.35
"Us Bank",,,03/20/2014,"Download from usbank.com. FOREVER 21 INC  SAN FRANCISCCA","Everyday Expenses:Clothing","Everyday Expenses","Clothing",,$40.67,$0.00,C,$3566.68
"Us Bank",,,03/20/2014,"Download from usbank.com. JAMBER          SAN FRANCISCCA","Everyday Expenses:Spending Money","Everyday Expenses","Spending Money",,$53.04,$0.00,C,$3513.64
"Us Bank",,,03/21/2014,"Download from usbank.com. SUGAR CAFE      SAN FRANCISCCA","Everyday Expenses:Spending Money","Everyday Expenses","Spending Money",,$4.00,$0.00,C,$3509.64
"Us Bank",,,03/21/2014,"Download from usbank.com. BART SFIA       SAN FRANCISCCA","Everyday Expenses:Transportation","Everyday Expenses","Transportation",,$5.00,$0.00,C,$3504.64
"Us Bank",,,03/21/2014,"Download from usbank.com. SUBWAY        00SAN FRANCISCCA","Everyday Expenses:Spending Money","Everyday Expenses","Spending Money",,$5.43,$0.00,C,$3499.21
"Us Bank",,,03/21/2014,"Download from usbank.com. LYFT            855-865-9553CA","Everyday Expenses:Transportation","Everyday Expenses","Transportation",,$7.00,$0.00,C,$3492.21
"Us Bank",,,03/21/2014,"Download from usbank.com. WALGREENS 1300 BSAN FRANCISCCA","Everyday Expenses:Household Goods","Everyday Expenses","Household Goods",,$7.86,$0.00,C,$3484.35
"Us Bank",,,03/21/2014,"Download from usbank.com. BART-CIVIC CENTESAN FRANCISCCA","Everyday Expenses:Transportation","Everyday Expenses","Transportation",,$8.65,$0.00,C,$3475.70
"Us Bank",,,03/21/2014,"Download from usbank.com. VENMO           646-801-3023NY","Everyday Expenses:Spending Money","Everyday Expenses","Spending Money",,$10.00,$0.00,C,$3465.70
"Us Bank",,,03/21/2014,"Download from usbank.com. SPRIG           415-894-5191CA","Everyday Expenses:Spending Money","Everyday Expenses","Spending Money",,$12.00,$0.00,C,$3453.70
"Us Bank",,,03/21/2014,"Download from usbank.com. PAYPAL","Everyday Expenses:Spending Money","Everyday Expenses","Spending Money",,$15.05,$0.00,C,$3438.65
"Us Bank",,,03/21/2014,"Download from usbank.com. WALGREENS 1300 BSAN FRANCISCCA","Everyday Expenses:Household Goods","Everyday Expenses","Household Goods",,$17.64,$0.00,C,$3421.01
"Us Bank",,,03/24/2014,"Download from usbank.com.","Everyday Expenses:Spending Money","Everyday Expenses","Spending Money",,$0.00,$6.95,C,$3427.96
"Us Bank",,,03/24/2014,"Download from usbank.com.","Everyday Expenses:Spending Money","Everyday Expenses","Spending Money",,$6.95,$0.00,C,$3421.01
"Us Bank",,,03/24/2014,"Download from usbank.com. COLDSTONE #273  ORANGE      CA","Everyday Expenses:Spending Money","Everyday Expenses","Spending Money",,$9.58,$0.00,C,$3411.43
"Us Bank",,,03/24/2014,"Download from usbank.com. PAYPAL","Everyday Expenses:Spending Money","Everyday Expenses","Spending Money",,$9.99,$0.00,C,$3401.44
"Us Bank",,,03/24/2014,"Download from usbank.com. ANAHEIM CNVNT CNANAHEIM     CA","Everyday Expenses:Spending Money","Everyday Expenses","Spending Money",,$10.00,$0.00,C,$3391.44
"Us Bank",,,03/24/2014,"Download from usbank.com. STARBUCKS TERM30SANTA ANA   CA","Everyday Expenses:Spending Money","Everyday Expenses","Spending Money",,$10.00,$0.00,C,$3381.44
"Us Bank",,,03/24/2014,"Download from usbank.com. CHICK-FIL-A #018ORANGE      CA","Everyday Expenses:Spending Money","Everyday Expenses","Spending Money",,$14.95,$0.00,C,$3366.49
"Us Bank",,,03/24/2014,"Download from usbank.com. NAPLES PIZZA    ORANGE      CA","Everyday Expenses:Spending Money","Everyday Expenses","Spending Money",,$24.22,$0.00,C,$3342.27
"Us Bank",,,03/24/2014,"Download from usbank.com. GRACIAS MADRE-SASAN FRANCISCCA","Everyday Expenses:Spending Money","Everyday Expenses","Spending Money",,$39.71,$0.00,C,$3302.56
"Us Bank",,,03/24/2014,"Download from usbank.com. H&M             ORANGE      CA","Everyday Expenses:Clothing","Everyday Expenses","Clothing",,$53.89,$0.00,C,$3248.67
"Us Bank",,,03/24/2014,"Download from usbank.com. ANAHEIM DUCKS 30SANTA ANA   CA","Everyday Expenses:Spending Money","Everyday Expenses","Spending Money",,$70.10,$0.00,C,$3178.57
"Us Bank",,,03/24/2014,"Download from usbank.com. WALGREENS 128 S ANAHEIM     CA","Everyday Expenses:Spending Money","Everyday Expenses","Spending Money",,$85.84,$0.00,C,$3092.73
"Us Bank",,,03/24/2014,"Download from usbank.com. WORLDPASS TRAVELCHARLOTTESVIVA","Everyday Expenses:Spending Money","Everyday Expenses","Spending Money",,$350.00,$0.00,C,$2742.73
"Us Bank",,,03/25/2014,"Download from usbank.com. HLU*Hulu 2274453HULU.COM/BILCA","Monthly Bills:Web Stuff","Monthly Bills","Web Stuff",,$7.99,$0.00,C,$2734.74
"Us Bank",,,03/25/2014,"Download from usbank.com. ICE CREAM CARTS ANAHEIM     CA","Everyday Expenses:Spending Money","Everyday Expenses","Spending Money",,$9.25,$0.00,C,$2725.49
"Us Bank",,,03/25/2014,"Download from usbank.com. HUNGRY BEAR - DLANAHEIM     CA","Everyday Expenses:Spending Money","Everyday Expenses","Spending Money",,$9.71,$0.00,C,$2715.78
"Us Bank",,,03/25/2014,"Download from usbank.com. TOONTOWN - DL   ANAHEIM     CA","Everyday Expenses:Spending Money","Everyday Expenses","Spending Money",,$16.60,$0.00,C,$2699.18
"Us Bank",,,03/26/2014,"Download from usbank.com. STADIUM VENDING ANAHEIM     CA","Everyday Expenses:Spending Money","Everyday Expenses","Spending Money",,$7.00,$0.00,C,$2692.18
"Us Bank",,,03/26/2014,"Download from usbank.com. BART SFIA       SAN FRANCISCCA","Everyday Expenses:Transportation","Everyday Expenses","Transportation",,$8.65,$0.00,C,$2683.53
"Us Bank",,,03/26/2014,"Download from usbank.com. BART-CLIPPER SFOSAN FRANCISCCA","Everyday Expenses:Transportation","Everyday Expenses","Transportation",,$12.45,$0.00,C,$2671.08
"Us Bank",,,03/26/2014,"Download from usbank.com. SAFEWAY STORE  2SAN FRANCISCCA","Everyday Expenses:Groceries","Everyday Expenses","Groceries",,$12.99,$0.00,C,$2658.09
"Us Bank",,,03/26/2014,"Download from usbank.com. BEER TRUCK - DCAANAHEIM     CA","Everyday Expenses:Spending Money","Everyday Expenses","Spending Money",,$15.66,$0.00,C,$2642.43
"Us Bank",,,03/26/2014,"Download from usbank.com. BEER TRUCK - DCAANAHEIM     CA","Everyday Expenses:Spending Money","Everyday Expenses","Spending Money",,$15.66,$0.00,C,$2626.77
"Us Bank",,,03/26/2014,"Download from usbank.com. BAYSIDE BREWS - ANAHEIM     CA","Everyday Expenses:Spending Money","Everyday Expenses","Spending Money",,$16.41,$0.00,C,$2610.36
"Us Bank",,,03/26/2014,"Download from usbank.com. DARBAR CUISINE ISAN FRANCISCCA","Everyday Expenses:Spending Money","Everyday Expenses","Spending Money",,$21.14,$0.00,C,$2589.22
"Us Bank",,,03/26/2014,"Download from usbank.com. LUCKY FORTUNE COANAHEIM     CA","Everyday Expenses:Spending Money","Everyday Expenses","Spending Money",,$22.66,$0.00,C,$2566.56
"Us Bank",,,03/26/2014,"Download from usbank.com. GE Capital",,,,,$25.00,$0.00,C,$2541.56
"Us Bank",,,03/26/2014,"Download from usbank.com. ELIAS & CO - DCAANAHEIM     CA","Everyday Expenses:Spending Money","Everyday Expenses","Spending Money",,$28.51,$0.00,C,$2513.05
"Us Bank",,,03/26/2014,"Download from usbank.com. SHELL OIL 574441ANAHEIM     CA","Everyday Expenses:Transportation","Everyday Expenses","Transportation",,$29.25,$0.00,C,$2483.80
"Us Bank",,,03/26/2014,"Download from usbank.com. AK LUXURY TRANSPANAHEIM     CA","Everyday Expenses:Spending Money","Everyday Expenses","Spending Money",,$50.00,$0.00,C,$2433.80
"Us Bank",,,03/26/2014,"Download from usbank.com. RUBY'S DINER    ANAHEIM     CA","Everyday Expenses:Spending Money","Everyday Expenses","Spending Money",,$64.61,$0.00,C,$2369.19
"Us Bank",,,03/27/2014,"Download from usbank.com. STARBUCKS TERM30SANTA ANA   CA","Everyday Expenses:Spending Money","Everyday Expenses","Spending Money",,$4.69,$0.00,C,$2364.50
"Us Bank",,,03/27/2014,"Download from usbank.com. SLIDERS DINER   SAN FRANCISCCA","Everyday Expenses:Spending Money","Everyday Expenses","Spending Money",,$11.42,$0.00,C,$2353.08
"Us Bank",,,03/27/2014,"Download from usbank.com. SQ *ANOTHER CAFESan FranciscCA","Everyday Expenses:Spending Money","Everyday Expenses","Spending Money",,$12.50,$0.00,C,$2340.58
"Us Bank",,,03/27/2014,"Download from usbank.com. BISTRO 3100     ANAHEIM     CA","Everyday Expenses:Spending Money","Everyday Expenses","Spending Money",,$29.75,$0.00,C,$2310.83
"Us Bank",,,03/27/2014,"Download from usbank.com. PANERA BREAD #45SAN FRANCISCCA","Everyday Expenses:Spending Money","Everyday Expenses","Spending Money",,$31.07,$0.00,C,$2279.76
"Us Bank",,,03/27/2014,"Download from usbank.com. TRADER JOE'S #20SAN FRANCISCCA","Everyday Expenses:Groceries","Everyday Expenses","Groceries",,$51.25,$0.00,C,$2228.51
"Us Bank",,,03/28/2014,"Download from usbank.com. MODCLOTH INC","Income:Available this month","Income","Available this month",,$0.00,$1442.45,C,$3670.96
"Us Bank",,,03/28/2014,"Download from usbank.com. AMAZON DIG474958","Everyday Expenses:Spending Money","Everyday Expenses","Spending Money",,$0.00,$28.66,C,$3699.62
"Us Bank",,,03/28/2014,"Download from usbank.com. CUP A JOES COFFESAN FRANCISCCA","Everyday Expenses:Spending Money","Everyday Expenses","Spending Money",,$5.95,$0.00,C,$3693.67
"Us Bank",,,03/28/2014,"Download from usbank.com. WICHCRAFT SAN FRSAN FRANCISCCA","Everyday Expenses:Spending Money","Everyday Expenses","Spending Money",,$9.50,$0.00,C,$3684.17
"Us Bank",,,03/28/2014,"Download from usbank.com. WALGREENS 1300 BSAN FRANCISCCA","Everyday Expenses:Household Goods","Everyday Expenses","Household Goods",,$28.35,$0.00,C,$3655.82
"Us Bank",,,03/28/2014,"Download from usbank.com. FGT*COACHELLA   888-512-7469TX","Everyday Expenses:Spending Money","Everyday Expenses","Spending Money",,$30.00,$0.00,C,$3625.82
"Us Bank",,,03/28/2014,"Download from usbank.com. SQ *CHOMP N' SWISan FranciscCA","Everyday Expenses:Spending Money","Everyday Expenses","Spending Money",,$56.40,$0.00,C,$3569.42
"Us Bank",,,03/28/2014,"Download from usbank.com. BARCLAYS BANK DE","Savings Goals:Savings","Savings Goals","Savings",,$100.00,$0.00,C,$3469.42
"Us Bank",,,03/28/2014,"Download from usbank.com. HERTZ RENT-A-CARSANTA ANA   CA","Everyday Expenses:Spending Money","Everyday Expenses","Spending Money",,$152.94,$0.00,C,$3316.48
"Us Bank",,,03/31/2014,"Download from usbank.com. SQWIGGLE INC","Income:Available this month","Income","Available this month",,$0.00,$1965.99,C,$5282.47
"Us Bank",,,03/31/2014,"Download from usbank.com. BART-POWELL     SAN FRANCISCCA","Everyday Expenses:Transportation","Everyday Expenses","Transportation",,$3.50,$0.00,C,$5278.97
"Us Bank",,,03/31/2014,"Download from usbank.com. CUP A JOES COFFESAN FRANCISCCA","Everyday Expenses:Spending Money","Everyday Expenses","Spending Money",,$7.95,$0.00,C,$5271.02
"Us Bank",,,03/31/2014,"Download from usbank.com. WHOLE FOODS MARKSan FranciscCA","Everyday Expenses:Groceries","Everyday Expenses","Groceries",,$14.72,$0.00,C,$5256.30
"Us Bank",,,03/31/2014,"Download from usbank.com. GOODWILL SF - GESAN FRANCISCCA","Everyday Expenses:Spending Money","Everyday Expenses","Spending Money",,$17.50,$0.00,C,$5238.80
"Us Bank",,,03/31/2014,"Download from usbank.com. SUTTER FINE FOODSAN FRANCISCCA","Everyday Expenses:Groceries","Everyday Expenses","Groceries",,$18.95,$0.00,C,$5219.85
"Us Bank",,,03/31/2014,"Download from usbank.com. CHEVRON 00090030SAN FRANCISCCA","Everyday Expenses:Transportation","Everyday Expenses","Transportation",,$20.82,$0.00,C,$5199.03
"Us Bank",,,03/31/2014,"Download from usbank.com. SQ *ANOTHER CAFESan FranciscCA","Everyday Expenses:Spending Money","Everyday Expenses","Spending Money",,$23.86,$0.00,C,$5175.17
"Us Bank",,,03/31/2014,"Download from usbank.com. GROUPON INC     877-788-7858IL","Everyday Expenses:Spending Money","Everyday Expenses","Spending Money",,$26.00,$0.00,C,$5149.17
"Us Bank",,,03/31/2014,"Download from usbank.com. GROUPON INC     877-788-7858IL","Everyday Expenses:Spending Money","Everyday Expenses","Spending Money",,$28.00,$0.00,C,$5121.17
"Us Bank",,,03/31/2014,"Download from usbank.com. URBAN-OUTFITTERS972-550-2751PA","Everyday Expenses:Clothing","Everyday Expenses","Clothing",,$36.98,$0.00,C,$5084.19
"Us Bank",,,03/31/2014,"Download from usbank.com. OLEA RESTURANT  SAN FRANCISCCA","Everyday Expenses:Spending Money","Everyday Expenses","Spending Money",,$44.17,$0.00,C,$5040.02
"Us Bank",,,03/31/2014,"Download from usbank.com. TRADER JOE'S #20SAN FRANCISCCA","Everyday Expenses:Groceries","Everyday Expenses","Groceries",,$51.35,$0.00,C,$4988.67
"Us Bank",,,03/31/2014,"Download from usbank.com. GETAROUND       866-438-2760CA","Everyday Expenses:Transportation","Everyday Expenses","Transportation",,$61.00,$0.00,C,$4927.67
"Us Bank",,,03/31/2014,"Download from usbank.com. BUDGET.COM PREPA8006212844  NJ","Savings Goals:Vacation & Travel","Savings Goals","Vacation & Travel",,$274.01,$0.00,C,$4653.66
"Us Bank",,,04/01/2014,"Download from usbank.com. SQ *WORKSHOP CAFSan FranciscCA","Everyday Expenses:Spending Money","Everyday Expenses","Spending Money",,$12.00,$0.00,C,$4641.66
"Us Bank",,,04/01/2014,"Download from usbank.com. MET CAS INS CO","Monthly Bills:Car Insurance","Monthly Bills","Car Insurance",,$49.00,$0.00,C,$4592.66
"Us Bank",,,04/01/2014,"Download from usbank.com. BARCLAYS BANK DE","Savings Goals:Savings","Savings Goals","Savings",,$100.00,$0.00,C,$4492.66
"Us Bank",,,04/01/2014,"Download from usbank.com. BRITANNIA ARMS  SAN JOSE    CA","Everyday Expenses:Spending Money","Everyday Expenses","Spending Money",,$127.23,$0.00,C,$4365.43
"Us Bank",,,04/02/2014,"Download from usbank.com. SQ *ANOTHER CAFESan FranciscCA","Everyday Expenses:Spending Money","Everyday Expenses","Spending Money",,$1.25,$0.00,C,$4364.18
"Us Bank",,,04/02/2014,"Download from usbank.com. SQ *ANOTHER CAFESan FranciscCA","Everyday Expenses:Spending Money","Everyday Expenses","Spending Money",,$3.50,$0.00,C,$4360.68
"Us Bank",,,04/02/2014,"Download from usbank.com. SQ *ANOTHER CAFESan FranciscCA","Everyday Expenses:Spending Money","Everyday Expenses","Spending Money",,$8.50,$0.00,C,$4352.18
"Us Bank",,,04/02/2014,"Download from usbank.com. SQ *ANOTHER CAFESan FranciscCA","Everyday Expenses:Spending Money","Everyday Expenses","Spending Money",,$8.65,$0.00,C,$4343.53
"Us Bank",,,04/02/2014,"Download from usbank.com. PAYPAL","Everyday Expenses:Spending Money","Everyday Expenses","Spending Money",,$9.95,$0.00,C,$4333.58
"Us Bank",,,04/02/2014,"Download from usbank.com. DAILYBURN       800-644-9211NY","Everyday Expenses:Spending Money","Everyday Expenses","Spending Money",,$10.00,$0.00,C,$4323.58
"Us Bank",,,04/02/2014,"Download from usbank.com. AMAZON MKTPLACE AMZN.COM/BILWA","Everyday Expenses:Spending Money","Everyday Expenses","Spending Money",,$13.98,$0.00,C,$4309.60
"Us Bank",,,04/02/2014,"Download from usbank.com. SPRIG           415-894-5191CA","Everyday Expenses:Spending Money","Everyday Expenses","Spending Money",,$22.00,$0.00,C,$4287.60
"Us Bank",,,04/02/2014,"Download from usbank.com. MODCLOTH INC.   888-4959699 CA","Everyday Expenses:Clothing","Everyday Expenses","Clothing",,$24.34,$0.00,C,$4263.26
"Us Bank",,,04/02/2014,"Download from usbank.com. Amazon.com      AMZN.COM/BILWA","Everyday Expenses:Spending Money","Everyday Expenses","Spending Money",,$27.88,$0.00,C,$4235.38
"Us Bank",,,04/02/2014,"Download from usbank.com. APPLE STORE  #R0SAN FRANCISCCA","Everyday Expenses:Spending Money","Everyday Expenses","Spending Money",,$107.66,$0.00,C,$4127.72
"Us Bank",,,04/02/2014,"Download from usbank.com. Amazon.com      AMZN.COM/BILWA","Everyday Expenses:Spending Money","Everyday Expenses","Spending Money",,$136.20,$0.00,C,$3991.52
"Us Bank",,,04/03/2014,"Download from usbank.com. Apple","Everyday Expenses:Spending Money","Everyday Expenses","Spending Money",,$0.00,$34.92,C,$4026.44
"Us Bank",,,04/03/2014,"Download from usbank.com. PAYPAL","Everyday Expenses:Spending Money","Everyday Expenses","Spending Money",,$10.26,$0.00,C,$4016.18
"Us Bank",,,04/03/2014,"Download from usbank.com. YELPINC*EAT24 OS415-908-3801CA","Everyday Expenses:Spending Money","Everyday Expenses","Spending Money",,$10.92,$0.00,C,$4005.26
"Us Bank",,,04/03/2014,"Download from usbank.com. THE CHAPEL      SAN FRANCISCCA","Everyday Expenses:Spending Money","Everyday Expenses","Spending Money",,$13.00,$0.00,C,$3992.26
"Us Bank",,,04/03/2014,"Download from usbank.com. ASIAN ART MUSEUMSAN FRANCISCCA","Everyday Expenses:Spending Money","Everyday Expenses","Spending Money",,$17.00,$0.00,C,$3975.26
"Us Bank",,,04/03/2014,"Download from usbank.com. THE CHAPEL      SAN FRANCISCCA","Everyday Expenses:Spending Money","Everyday Expenses","Spending Money",,$17.00,$0.00,C,$3958.26
"Us Bank",,,04/03/2014,"Download from usbank.com. WICHCRAFT SAN FRSAN FRANCISCCA","Everyday Expenses:Spending Money","Everyday Expenses","Spending Money",,$21.51,$0.00,C,$3936.75
"Us Bank",,,04/03/2014,"Download from usbank.com. AMAZON MKTPLACE AMZN.COM/BILWA","Everyday Expenses:Spending Money","Everyday Expenses","Spending Money",,$138.91,$0.00,C,$3797.84
"Us Bank",,,04/03/2014,"Download from usbank.com.","Everyday Expenses:Spending Money","Everyday Expenses","Spending Money",,$1565.00,$0.00,C,$2232.84
"Us Bank",,,04/04/2014,"Download from usbank.com. Delia's         888-533-5427NY","Everyday Expenses:Clothing","Everyday Expenses","Clothing",,$0.00,$11.03,C,$2243.87
"Us Bank",,,04/04/2014,"Download from usbank.com. SUGAR CAFE      SAN FRANCISCCA","Everyday Expenses:Spending Money","Everyday Expenses","Spending Money",,$3.50,$0.00,C,$2240.37
"Us Bank",,,04/04/2014,"Download from usbank.com. SUGAR CAFE      SAN FRANCISCCA","Everyday Expenses:Spending Money","Everyday Expenses","Spending Money",,$9.79,$0.00,C,$2230.58
"Us Bank",,,04/04/2014,"Download from usbank.com. WALGREENS 1300 BSAN FRANCISCCA","Everyday Expenses:Household Goods","Everyday Expenses","Household Goods",,$11.94,$0.00,C,$2218.64
"Us Bank",,,04/04/2014,"Download from usbank.com. SUGAR CAFE      SAN FRANCISCCA","Everyday Expenses:Spending Money","Everyday Expenses","Spending Money",,$18.32,$0.00,C,$2200.32
"Us Bank",,,04/04/2014,"Download from usbank.com. SOLUNA CAFE AND SAN FRANCISCCA","Everyday Expenses:Spending Money","Everyday Expenses","Spending Money",,$20.00,$0.00,C,$2180.32
"Us Bank",,,04/04/2014,"Download from usbank.com. DARWIN CAFE     SAN FRANCISCCA","Everyday Expenses:Spending Money","Everyday Expenses","Spending Money",,$21.00,$0.00,C,$2159.32
"Us Bank",,,04/04/2014,"Download from usbank.com. TWITTER ADVERTIS415-4264400 CA","Monthly Bills:Web Stuff","Monthly Bills","Web Stuff",,$30.98,$0.00,C,$2128.34
"Us Bank",,,04/04/2014,"Download from usbank.com. Amazon.com      AMZN.COM/BILWA","Everyday Expenses:Spending Money","Everyday Expenses","Spending Money",,$50.66,$0.00,C,$2077.68
"Us Bank",,,04/04/2014,"Download from usbank.com. WHOLE FOODS MARKSan FranciscCA","Everyday Expenses:Groceries","Everyday Expenses","Groceries",,$64.93,$0.00,C,$2012.75
"Us Bank",,,04/07/2014,"Download from usbank.com. 040514PLUSTERM896 SUTTER ST   SAN FRANCISCCAUS1","Everyday Expenses:Spending Money","Everyday Expenses","Spending Money",,$2.50,$0.00,C,$2010.25
"Us Bank",,,04/07/2014,"Download from usbank.com. SQ *WORKSHOP CAFSan FranciscCA","Everyday Expenses:Spending Money","Everyday Expenses","Spending Money",,$6.00,$0.00,C,$2004.25
"Us Bank",,,04/07/2014,"Download from usbank.com. PAYPAL","Everyday Expenses:Spending Money","Everyday Expenses","Spending Money",,$7.92,$0.00,C,$1996.33
"Us Bank",,,04/07/2014,"Download from usbank.com. PAYPAL","Everyday Expenses:Spending Money","Everyday Expenses","Spending Money",,$8.88,$0.00,C,$1987.45
"Us Bank",,,04/07/2014,"Download from usbank.com. PAYPAL","Everyday Expenses:Spending Money","Everyday Expenses","Spending Money",,$9.48,$0.00,C,$1977.97
"Us Bank",,,04/07/2014,"Download from usbank.com. PIRAAT PIZZERIA SAN FRANCISCCA","Everyday Expenses:Spending Money","Everyday Expenses","Spending Money",,$9.59,$0.00,C,$1968.38
"Us Bank",,,04/07/2014,"Download from usbank.com. PAYPAL","Everyday Expenses:Spending Money","Everyday Expenses","Spending Money",,$10.00,$0.00,C,$1958.38
"Us Bank",,,04/07/2014,"Download from usbank.com. WALGREENS 1300 BSAN FRANCISCCA","Everyday Expenses:Household Goods","Everyday Expenses","Household Goods",,$10.62,$0.00,C,$1947.76
"Us Bank",,,04/07/2014,"Download from usbank.com. SQ *ANOTHER CAFESan FranciscCA","Everyday Expenses:Spending Money","Everyday Expenses","Spending Money",,$10.75,$0.00,C,$1937.01
"Us Bank",,,04/07/2014,"Download from usbank.com. SLIDERS DINER   SAN FRANCISCCA","Everyday Expenses:Spending Money","Everyday Expenses","Spending Money",,$11.42,$0.00,C,$1925.59
"Us Bank",,,04/07/2014,"Download from usbank.com. SAFFRON LOUNGE  SAN FRANCISCCA","Everyday Expenses:Spending Money","Everyday Expenses","Spending Money",,$13.05,$0.00,C,$1912.54
"Us Bank",,,04/07/2014,"Download from usbank.com. PAYPAL","Everyday Expenses:Spending Money","Everyday Expenses","Spending Money",,$13.44,$0.00,C,$1899.10
"Us Bank",,,04/07/2014,"Download from usbank.com. SUTTER FINE FOODSAN FRANCISCCA","Everyday Expenses:Groceries","Everyday Expenses","Groceries",,$13.69,$0.00,C,$1885.41
"Us Bank",,,04/07/2014,"Download from usbank.com. CUP A JOES COFFESAN FRANCISCCA","Everyday Expenses:Spending Money","Everyday Expenses","Spending Money",,$13.70,$0.00,C,$1871.71
"Us Bank",,,04/07/2014,"Download from usbank.com. BRICK HOUSE CAFESAN FRANCISCCA","Everyday Expenses:Spending Money","Everyday Expenses","Spending Money",,$16.67,$0.00,C,$1855.04
"Us Bank",,,04/07/2014,"Download from usbank.com. CHIPOTLE 1230   SAN FRANCISCCA","Everyday Expenses:Spending Money","Everyday Expenses","Spending Money",,$17.94,$0.00,C,$1837.10
"Us Bank",,,04/07/2014,"Download from usbank.com. AMERICAN APPARELSAN FRANCISCCA","Everyday Expenses:Clothing","Everyday Expenses","Clothing",,$21.75,$0.00,C,$1815.35
"Us Bank",,,04/07/2014,"Download from usbank.com. ONE MEDICAL GROUSAN FRANCISCCA","Everyday Expenses:Medical","Everyday Expenses","Medical",,$25.00,$0.00,C,$1790.35
"Us Bank",,,04/07/2014,"Download from usbank.com. ONE MEDICAL GROUSAN FRANCISCCA","Everyday Expenses:Medical","Everyday Expenses","Medical",,$25.00,$0.00,C,$1765.35
"Us Bank",,,04/07/2014,"Download from usbank.com. SQ *JULIAN HOLDISan FranciscCA","Everyday Expenses:Spending Money","Everyday Expenses","Spending Money",,$30.00,$0.00,C,$1735.35
"Us Bank",,,04/07/2014,"Download from usbank.com. BURRITT ROOM    415-4000500 CA","Everyday Expenses:Spending Money","Everyday Expenses","Spending Money",,$41.88,$0.00,C,$1693.47
"Us Bank",,,04/07/2014,"Download from usbank.com. BURRITT ROOM    415-4000500 CA","Everyday Expenses:Spending Money","Everyday Expenses","Spending Money",,$48.47,$0.00,C,$1645.00
"Us Bank",,,04/07/2014,"Download from usbank.com. SANTA CLARA PAINSAN JOSE    CA","Rainy Day Funds:Gifts","Rainy Day Funds","Gifts",,$53.50,$0.00,C,$1591.50
"Us Bank",,,04/07/2014,"Download from usbank.com. FOREVER 21 INC  SAN FRANCISCCA","Everyday Expenses:Clothing","Everyday Expenses","Clothing",,$62.51,$0.00,C,$1528.99
"Us Bank",,,04/07/2014,"Download from usbank.com. SOLID GOLD SALONSAN FRANCISCCA","Everyday Expenses:Spending Money","Everyday Expenses","Spending Money",,$65.00,$0.00,C,$1463.99
"Us Bank",,,04/07/2014,"Download from usbank.com. 896 SUTTER ST   SAN FRANCISCCAUS1","Everyday Expenses:Spending Money","Everyday Expenses","Spending Money",,$82.50,$0.00,C,$1381.49
"Us Bank",,,04/07/2014,"Download from usbank.com. INSTACART       910-817-2278CA","Everyday Expenses:Groceries","Everyday Expenses","Groceries",,$86.28,$0.00,C,$1295.21
"Us Bank",,,04/07/2014,"Download from usbank.com. 7246","Debt:Eric's Credit Card","Debt","Eric's Credit Card",,$500.00,$0.00,C,$795.21
"Us Bank",,,04/08/2014,"Download from usbank.com. INSTACART       9108172278  CA","Everyday Expenses:Groceries","Everyday Expenses","Groceries",,$0.00,$18.59,C,$813.80
"Us Bank",,,04/08/2014,"Download from usbank.com. APL*APPLE ITUNES866-712-7753CA","Everyday Expenses:Spending Money","Everyday Expenses","Spending Money",,$1.99,$0.00,C,$811.81
"Us Bank",,,04/08/2014,"Download from usbank.com. BELLISSIMO PIZZASAN FRANCISCCA","Everyday Expenses:Spending Money","Everyday Expenses","Spending Money",,$7.00,$0.00,C,$804.81
"Us Bank",,,04/08/2014,"Download from usbank.com. AMC VAN NESS 14 SAN FRANCISCCA","Everyday Expenses:Spending Money","Everyday Expenses","Spending Money",,$10.75,$0.00,C,$794.06
"Us Bank",,,04/08/2014,"Download from usbank.com. FLY             SAN FRANCISCCA","Everyday Expenses:Groceries","Everyday Expenses","Groceries",,$18.94,$0.00,C,$775.12
"Us Bank",,,04/08/2014,"Download from usbank.com. Wild Hare       San FranciscCA","Everyday Expenses:Spending Money","Everyday Expenses","Spending Money",,$32.80,$0.00,C,$742.32
"Us Bank",,,04/08/2014,"Download from usbank.com. COMCAST","Monthly Bills:Utilities","Monthly Bills","Utilities",,$80.40,$0.00,C,$661.92
"Us Bank",,,04/09/2014,"Download from usbank.com. WALGREENS 670 4TSAN FRANCISCCA","Everyday Expenses:Household Goods","Everyday Expenses","Household Goods",,$10.00,$0.00,C,$651.92
"Us Bank",,,04/09/2014,"Download from usbank.com. WICHCRAFT SAN FRSAN FRANCISCCA","Everyday Expenses:Spending Money","Everyday Expenses","Spending Money",,$11.26,$0.00,C,$640.66
"Us Bank",,,04/09/2014,"Download from usbank.com. PAYPAL","Everyday Expenses:Spending Money","Everyday Expenses","Spending Money",,$12.42,$0.00,C,$628.24
"Us Bank",,,04/09/2014,"Download from usbank.com. INTUIT *TURBOTAX800-446-8848CA","Everyday Expenses:Spending Money","Everyday Expenses","Spending Money",,$29.99,$0.00,C,$598.25
"Us Bank",,,04/10/2014,"Download from usbank.com. LATTE EXPRESS 4 SAN FRANCISCCA","Everyday Expenses:Spending Money","Everyday Expenses","Spending Money",,$8.23,$0.00,C,$590.02
"Us Bank",,,04/10/2014,"Download from usbank.com. PAYPAL","Everyday Expenses:Spending Money","Everyday Expenses","Spending Money",,$8.62,$0.00,C,$581.40
"Us Bank",,,04/10/2014,"Download from usbank.com. TWITTER ADVERTIS415-4264400 CA","Monthly Bills:Web Stuff","Monthly Bills","Web Stuff",,$26.66,$0.00,C,$554.74
"Us Bank",,,04/10/2014,"Download from usbank.com. CARDMEMBER SERV",,,,,$40.00,$0.00,C,$514.74
"Us Bank",,,04/11/2014,"Download from usbank.com. MODCLOTH INC","Income:Available this month","Income","Available this month",,$0.00,$1453.26,C,$1968.00
"Us Bank",,,04/11/2014,"Download from usbank.com. WALGREENS 1300 BSAN FRANCISCCA","Everyday Expenses:Household Goods","Everyday Expenses","Household Goods",,$21.29,$0.00,C,$1946.71
"Us Bank",,,04/11/2014,"Download from usbank.com. APPLE STORE  #R0SAN FRANCISCCA","Everyday Expenses:Spending Money","Everyday Expenses","Spending Money",,$54.07,$0.00,C,$1892.64
"Us Bank",,,04/11/2014,"Download from usbank.com. SWAY - ECOMMERCEOAKLAND     CA","Everyday Expenses:Spending Money","Everyday Expenses","Spending Money",,$68.60,$0.00,C,$1824.04
"Us Bank",,,04/11/2014,"Download from usbank.com. BARCLAYS BANK DE","Savings Goals:Savings","Savings Goals","Savings",,$100.00,$0.00,C,$1724.04
"Us Bank",,,04/13/2014,"Electronic Deposit Franchise Tax Bd","Everyday Expenses:Spending Money","Everyday Expenses","Spending Money",,$0.00,$424.00,C,$2148.04
"Us Bank",,,04/14/2014,"Download from usbank.com. DARWIN CAFE     SAN FRANCISCCA","Everyday Expenses:Spending Money","Everyday Expenses","Spending Money",,$12.00,$0.00,C,$2136.04
"Us Bank",,,04/14/2014,"Download from usbank.com. WHOLE FOODS MARKSan FranciscCA","Everyday Expenses:Groceries","Everyday Expenses","Groceries",,$14.97,$0.00,C,$2121.07
"Us Bank",,,04/14/2014,"Download from usbank.com. PAYPAL","Everyday Expenses:Spending Money","Everyday Expenses","Spending Money",,$15.52,$0.00,C,$2105.55
"Us Bank",,,04/14/2014,"Download from usbank.com. TACOLICIOUS II  SAN FRANCISCCA","Everyday Expenses:Spending Money","Everyday Expenses","Spending Money",,$17.97,$0.00,C,$2087.58
"Us Bank",,,04/14/2014,"Download from usbank.com. GRUBHUB FOOD ORD877-585-7878IL","Everyday Expenses:Spending Money","Everyday Expenses","Spending Money",,$19.60,$0.00,C,$2067.98
"Us Bank",,,04/14/2014,"Download from usbank.com. WALGREENS 1300 BSAN FRANCISCCA","Everyday Expenses:Household Goods","Everyday Expenses","Household Goods",,$41.31,$0.00,C,$2026.67
"Us Bank",,,04/14/2014,"Download from usbank.com. DSW UNION SQ    SAN FRANCISCCA","Everyday Expenses:Clothing","Everyday Expenses","Clothing",,$45.51,$0.00,C,$1981.16
"Us Bank",,,04/14/2014,"Download from usbank.com. TARGET T2766    SAN FRANCISCCA","Everyday Expenses:Clothing","Everyday Expenses","Clothing",,$46.75,$0.00,C,$1934.41
"Us Bank",,,04/14/2014,"Download from usbank.com. WHOLE FOODS MARKSan FranciscCA","Everyday Expenses:Groceries","Everyday Expenses","Groceries",,$119.48,$0.00,C,$1814.93
"Us Bank",,,04/15/2014,"Download from usbank.com. SQWIGGLE INC","Income:Available this month","Income","Available this month",,$0.00,$1965.99,C,$3780.92
"Us Bank",,,04/15/2014,"Download from usbank.com. SPOONROCKET.COM 510-921-9929CA","Everyday Expenses:Spending Money","Everyday Expenses","Spending Money",,$8.70,$0.00,C,$3772.22
"Us Bank",,,04/15/2014,"Download from usbank.com. BARCLAYS BANK DE","Savings Goals:Savings","Savings Goals","Savings",,$100.00,$0.00,C,$3672.22
"Us Bank",,,04/16/2014,"Download from usbank.com. IRS  TREAS 310","Everyday Expenses:Spending Money","Everyday Expenses","Spending Money",,$0.00,$875.00,C,$4547.22
"Us Bank",,,04/16/2014,"Download from usbank.com. SQ *WE2SUSHI    San FranciscCA","Everyday Expenses:Spending Money","Everyday Expenses","Spending Money",,$10.90,$0.00,C,$4536.32
"Us Bank",,,04/16/2014,"Download from usbank.com. AMAZON MKTPLACE AMZN.COM/BILWA","Everyday Expenses:Spending Money","Everyday Expenses","Spending Money",,$43.91,$0.00,C,$4492.41
"Us Bank",,,04/16/2014,"Download from usbank.com. Amazon.com      AMZN.COM/BILWA","Everyday Expenses:Spending Money","Everyday Expenses","Spending Money",,$45.66,$0.00,C,$4446.75
"Us Bank",,,04/16/2014,"Download from usbank.com. SQ *BEAUTIFIED SSan FranciscCA","Everyday Expenses:Spending Money","Everyday Expenses","Spending Money",,$66.00,$0.00,C,$4380.75
"Us Bank",,,04/16/2014,"Download from usbank.com. WALGREENS 1300 BSAN FRANCISCCA","Everyday Expenses:Household Goods","Everyday Expenses","Household Goods",,$90.24,$0.00,C,$4290.51
"Us Bank",,,04/16/2014,"Download from usbank.com. AMAZON MKTPLACE AMZN.COM/BILWA","Everyday Expenses:Spending Money","Everyday Expenses","Spending Money",,$94.86,$0.00,C,$4195.65
"Us Bank",,,04/17/2014,"Download from usbank.com. PAYPAL","Everyday Expenses:Spending Money","Everyday Expenses","Spending Money",,$5.00,$0.00,C,$4190.65
"Us Bank",,,04/17/2014,"Download from usbank.com. PRINCE PALACE C BAKERSFIELD CA","Everyday Expenses:Spending Money","Everyday Expenses","Spending Money",,$16.40,$0.00,C,$4174.25
"Us Bank",,,04/17/2014,"Download from usbank.com. TWITTER ADVERTIS415-4264400 CA","Monthly Bills:Web Stuff","Monthly Bills","Web Stuff",,$75.00,$0.00,C,$4099.25
"Us Bank",,,04/17/2014,"Download from usbank.com.","Everyday Expenses:Spending Money","Everyday Expenses","Spending Money",,$260.00,$0.00,C,$3839.25
"Us Bank",,,04/18/2014,"Download from usbank.com. PAYPAL","Everyday Expenses:Spending Money","Everyday Expenses","Spending Money",,$9.99,$0.00,C,$3829.26
"Us Bank",,,04/18/2014,"Download from usbank.com. PAYPAL","Everyday Expenses:Spending Money","Everyday Expenses","Spending Money",,$20.00,$0.00,C,$3809.26
"Us Bank",,,04/18/2014,"Download from usbank.com. GP*RYE          SAN FRANCISCCA","Everyday Expenses:Spending Money","Everyday Expenses","Spending Money",,$20.49,$0.00,C,$3788.77
"Us Bank",,,04/18/2014,"Download from usbank.com. TARGET T2441    INDIO       CA","Everyday Expenses:Clothing","Everyday Expenses","Clothing",,$26.64,$0.00,C,$3762.13
"Us Bank",,,04/18/2014,"Download from usbank.com. CHEVRON 00208824HIGHLAND    CA","Everyday Expenses:Transportation","Everyday Expenses","Transportation",,$30.00,$0.00,C,$3732.13
"Us Bank",,,04/18/2014,"Download from usbank.com. CHEVRON 00306191BAKERSFIELD CA","Everyday Expenses:Transportation","Everyday Expenses","Transportation",,$49.76,$0.00,C,$3682.37
"Us Bank",,,04/18/2014,"Download from usbank.com. JAMBER          SAN FRANCISCCA","Everyday Expenses:Spending Money","Everyday Expenses","Spending Money",,$100.40,$0.00,C,$3581.97
"Us Bank",,,04/18/2014,"Download from usbank.com. WAL-MART #2297  STEVENSON RACA","Everyday Expenses:Spending Money","Everyday Expenses","Spending Money",,$164.83,$0.00,C,$3417.14
"Us Bank",,,04/21/2014,"Download from usbank.com. 042014PLUSTERM81-800 AVE 51   INDIO       CAUS1","Everyday Expenses:Spending Money","Everyday Expenses","Spending Money",,$2.50,$0.00,C,$3414.64
"Us Bank",,,04/21/2014,"Download from usbank.com. 042014PLUSTERM81-800 AVE 51   INDIO       CAUS1","Everyday Expenses:Spending Money","Everyday Expenses","Spending Money",,$2.50,$0.00,C,$3412.14
"Us Bank",,,04/21/2014,"Download from usbank.com. PAYPAL","Monthly Bills:Web Stuff","Monthly Bills","Web Stuff",,$9.99,$0.00,C,$3402.15
"Us Bank",,,04/21/2014,"Download from usbank.com. 81-800 AVE 51   INDIO       CAUS1","Everyday Expenses:Spending Money","Everyday Expenses","Spending Money",,$43.95,$0.00,C,$3358.20
"Us Bank",,,04/21/2014,"Download from usbank.com. 81-800 AVE 51   INDIO       CAUS1","Everyday Expenses:Spending Money","Everyday Expenses","Spending Money",,$103.95,$0.00,C,$3254.25
"Us Bank",,,04/21/2014,"Download from usbank.com. ATT","Monthly Bills:Cell Phone","Monthly Bills","Cell Phone",,$225.81,$0.00,C,$3028.44
"Us Bank",,,04/22/2014,"Download from usbank.com.","Everyday Expenses:Spending Money","Everyday Expenses","Spending Money",,$0.00,$6.95,C,$3035.39
"Us Bank",,,04/22/2014,"Download from usbank.com.","Everyday Expenses:Spending Money","Everyday Expenses","Spending Money",,$6.95,$0.00,C,$3028.44
"Us Bank",,,04/22/2014,"Download from usbank.com. CHEVRON 00090030SAN FRANCISCCA","Everyday Expenses:Transportation","Everyday Expenses","Transportation",,$12.80,$0.00,C,$3015.64
"Us Bank",,,04/22/2014,"Download from usbank.com. CHEVRON 00207764NEWHALL     CA","Everyday Expenses:Transportation","Everyday Expenses","Transportation",,$33.16,$0.00,C,$2982.48
"Us Bank",,,04/22/2014,"Download from usbank.com. PAYPAL","Everyday Expenses:Spending Money","Everyday Expenses","Spending Money",,$71.68,$0.00,C,$2910.80
"Us Bank",,,04/23/2014,"Download from usbank.com. LYFT TUE AT 1009855-865-9553CA","Everyday Expenses:Transportation","Everyday Expenses","Transportation",,$8.00,$0.00,C,$2902.80
"Us Bank",,,04/23/2014,"Download from usbank.com. JOE'S TRAVEL PLAWESTLEY     CA","Everyday Expenses:Spending Money","Everyday Expenses","Spending Money",,$9.28,$0.00,C,$2893.52
"Us Bank",,,04/23/2014,"Download from usbank.com. PAYPAL","Everyday Expenses:Spending Money","Everyday Expenses","Spending Money",,$9.99,$0.00,C,$2883.53
"Us Bank",,,04/23/2014,"Download from usbank.com. SPRIG           4158945191  CA","Everyday Expenses:Groceries","Everyday Expenses","Groceries",,$22.00,$0.00,C,$2861.53
"Us Bank",,,04/23/2014,"Download from usbank.com. JOE'S TRAVEL PLAWESTLEY     CA","Everyday Expenses:Spending Money","Everyday Expenses","Spending Money",,$37.75,$0.00,C,$2823.78
"Us Bank",,,04/23/2014,"Download from usbank.com. WALGREENS 1300 BSAN FRANCISCCA","Everyday Expenses:Household Goods","Everyday Expenses","Household Goods",,$50.21,$0.00,C,$2773.57
"Us Bank",,,04/24/2014,"Download from usbank.com. CUP A JOES COFFESAN FRANCISCCA","Everyday Expenses:Spending Money","Everyday Expenses","Spending Money",,$5.95,$0.00,C,$2767.62
"Us Bank",,,04/24/2014,"Download from usbank.com. LYFT TUE AT 309P855-865-9553CA","Everyday Expenses:Transportation","Everyday Expenses","Transportation",,$9.00,$0.00,C,$2758.62
"Us Bank",,,04/24/2014,"Download from usbank.com. SLIDERS DINER   SAN FRANCISCCA","Everyday Expenses:Spending Money","Everyday Expenses","Spending Money",,$10.60,$0.00,C,$2748.02
"Us Bank",,,04/24/2014,"Download from usbank.com. WALGREENS 500 GESAN FRANCISCCA","Everyday Expenses:Household Goods","Everyday Expenses","Household Goods",,$14.10,$0.00,C,$2733.92
"Us Bank",,,04/24/2014,"Download from usbank.com. SPRIG           415-894-5191CA","Everyday Expenses:Spending Money","Everyday Expenses","Spending Money",,$22.00,$0.00,C,$2711.92
"Us Bank",,,04/24/2014,"Download from usbank.com. SPRIG           415-894-5191CA","Everyday Expenses:Spending Money","Everyday Expenses","Spending Money",,$22.00,$0.00,C,$2689.92
"Us Bank",,,04/25/2014,"Download from usbank.com. MODCLOTH INC","Income:Available this month","Income","Available this month",,$0.00,$1464.53,C,$4154.45
"Us Bank",,,04/25/2014,"Download from usbank.com. THE MELT BEACON SAN FRANCISCCA","Everyday Expenses:Spending Money","Everyday Expenses","Spending Money",,$7.79,$0.00,C,$4146.66
"Us Bank",,,04/25/2014,"Download from usbank.com. HLU*Hulu 2274453HULU.COM/BILCA","Monthly Bills:Web Stuff","Monthly Bills","Web Stuff",,$7.99,$0.00,C,$4138.67
"Us Bank",,,04/25/2014,"Download from usbank.com. DARWIN CAFE     SAN FRANCISCCA","Everyday Expenses:Spending Money","Everyday Expenses","Spending Money",,$12.00,$0.00,C,$4126.67
"Us Bank",,,04/25/2014,"Download from usbank.com. SPRIG           415-894-5191CA","Everyday Expenses:Spending Money","Everyday Expenses","Spending Money",,$22.00,$0.00,C,$4104.67
"Us Bank",,,04/25/2014,"Download from usbank.com. BARCLAYS BANK DE","Savings Goals:Savings","Savings Goals","Savings",,$100.00,$0.00,C,$4004.67
"Us Bank",,,04/28/2014,"Download from usbank.com. VENMO","Everyday Expenses:Spending Money","Everyday Expenses","Spending Money",,$0.00,$459.00,C,$4463.67
"Us Bank",,,04/28/2014,"Download from usbank.com. Discount GrocersSan FranciscCA","Everyday Expenses:Groceries","Everyday Expenses","Groceries",,$4.51,$0.00,C,$4459.16
"Us Bank",,,04/28/2014,"Download from usbank.com. WALGREENS 459 POSAN FRANCISCCA","Everyday Expenses:Household Goods","Everyday Expenses","Household Goods",,$4.67,$0.00,C,$4454.49
"Us Bank",,,04/28/2014,"Download from usbank.com. SUGAR CAFE      SAN FRANCISCCA","Everyday Expenses:Spending Money","Everyday Expenses","Spending Money",,$5.50,$0.00,C,$4448.99
"Us Bank",,,04/28/2014,"Download from usbank.com. PANERA BREAD #60PINOLE      CA","Everyday Expenses:Spending Money","Everyday Expenses","Spending Money",,$5.79,$0.00,C,$4443.20
"Us Bank",,,04/28/2014,"Download from usbank.com. TRADER JOE'S #20SAN FRANCISCCA","Everyday Expenses:Groceries","Everyday Expenses","Groceries",,$6.46,$0.00,C,$4436.74
"Us Bank",,,04/28/2014,"Download from usbank.com. HLU*Hulu 4502449HULU.COM/BILCA","Monthly Bills:Web Stuff","Monthly Bills","Web Stuff",,$7.99,$0.00,C,$4428.75
"Us Bank",,,04/28/2014,"Download from usbank.com. UNITED      0162800-932-2732TX","Savings Goals:Vacation & Travel","Savings Goals","Vacation & Travel",,$7.99,$0.00,C,$4420.76
"Us Bank",,,04/28/2014,"Download from usbank.com. SQ *ANOTHER CAFESan FranciscCA","Everyday Expenses:Spending Money","Everyday Expenses","Spending Money",,$9.50,$0.00,C,$4411.26
"Us Bank",,,04/28/2014,"Download from usbank.com. SWEET WOODRUFF  SAN FRANCISCCA","Everyday Expenses:Spending Money","Everyday Expenses","Spending Money",,$10.88,$0.00,C,$4400.38
"Us Bank",,,04/28/2014,"Download from usbank.com. WALGREENS 500 GESAN FRANCISCCA","Everyday Expenses:Household Goods","Everyday Expenses","Household Goods",,$11.72,$0.00,C,$4388.66
"Us Bank",,,04/28/2014,"Download from usbank.com. CHEAPOAIR.COM AICHEAPOAIR.CONY","Savings Goals:Vacation & Travel","Savings Goals","Vacation & Travel",,$14.00,$0.00,C,$4374.66
"Us Bank",,,04/28/2014,"Download from usbank.com. CUP A JOES COFFESAN FRANCISCCA","Everyday Expenses:Spending Money","Everyday Expenses","Spending Money",,$14.15,$0.00,C,$4360.51
"Us Bank",,,04/28/2014,"Download from usbank.com. THE OWL TREE    SAN FRANCISCCA","Everyday Expenses:Spending Money","Everyday Expenses","Spending Money",,$15.05,$0.00,C,$4345.46
"Us Bank",,,04/28/2014,"Download from usbank.com. BART-CLIPPER POWSAN FRANCISCCA","Everyday Expenses:Transportation","Everyday Expenses","Transportation",,$20.00,$0.00,C,$4325.46
"Us Bank",,,04/28/2014,"Download from usbank.com. GE Capital",,,,,$25.00,$0.00,C,$4300.46
"Us Bank",,,04/28/2014,"Download from usbank.com. MARINA KASAVIN SAN FRANCISCCA","Everyday Expenses:Medical","Everyday Expenses","Medical",,$25.00,$0.00,C,$4275.46
"Us Bank",,,04/28/2014,"Download from usbank.com. TWITTER ADVERTIS415-4264400 CA","Monthly Bills:Web Stuff","Monthly Bills","Web Stuff",,$25.00,$0.00,C,$4250.46
"Us Bank",,,04/28/2014,"Download from usbank.com. SUNDANCE KBB    SAN FRANCISCCA","Everyday Expenses:Spending Money","Everyday Expenses","Spending Money",,$26.01,$0.00,C,$4224.45
"Us Bank",,,04/28/2014,"Download from usbank.com. WALGREENS 1300 BSAN FRANCISCCA","Everyday Expenses:Household Goods","Everyday Expenses","Household Goods",,$26.60,$0.00,C,$4197.85
"Us Bank",,,04/28/2014,"Download from usbank.com. SUNDANCE KAB    818-889-8562CA","Everyday Expenses:Spending Money","Everyday Expenses","Spending Money",,$30.00,$0.00,C,$4167.85
"Us Bank",,,04/28/2014,"Download from usbank.com. SUDACHI         SAN FRANCISCCA","Everyday Expenses:Spending Money","Everyday Expenses","Spending Money",,$45.89,$0.00,C,$4121.96
"Us Bank",,,04/28/2014,"Download from usbank.com. JASPERS CORNER TSAN FRANCISCCA","Everyday Expenses:Spending Money","Everyday Expenses","Spending Money",,$118.61,$0.00,C,$4003.35
"Us Bank",,,04/28/2014,"Download from usbank.com. TRADER JOE'S #20SAN FRANCISCCA","Everyday Expenses:Groceries","Everyday Expenses","Groceries",,$121.40,$0.00,C,$3881.95
"Us Bank",,,04/29/2014,"Download from usbank.com. CUP A JOES COFFESAN FRANCISCCA","Everyday Expenses:Spending Money","Everyday Expenses","Spending Money",,$3.75,$0.00,C,$3878.20
"Us Bank",,,04/29/2014,"Download from usbank.com. Amazon.com      AMZN.COM/BILWA","Everyday Expenses:Spending Money","Everyday Expenses","Spending Money",,$28.75,$0.00,C,$3849.45
"Us Bank",,,04/29/2014,"Download from usbank.com. USAIRWAYS   0377NEW YORK    NY","Savings Goals:Vacation & Travel","Savings Goals","Vacation & Travel",,$271.00,$0.00,C,$3578.45
"Us Bank",,,04/30/2014,"Download from usbank.com. SQWIGGLE INC","Income:Available this month","Income","Available this month",,$0.00,$1965.99,C,$5544.44
"Us Bank",,,04/30/2014,"Download from usbank.com. AMAZON DIG486929","Everyday Expenses:Spending Money","Everyday Expenses","Spending Money",,$0.00,$17.44,C,$5561.88
"Us Bank",,,04/30/2014,"Download from usbank.com. WALGREENS 1300 BSAN FRANCISCCA","Everyday Expenses:Household Goods","Everyday Expenses","Household Goods",,$17.45,$0.00,C,$5544.43
"Us Bank",,,04/30/2014,"Download from usbank.com. VICTORIA'S SECRE800-888-1500OH","Everyday Expenses:Clothing","Everyday Expenses","Clothing",,$25.59,$0.00,C,$5518.84
"Us Bank",,,04/30/2014,"Download from usbank.com. SURETY BONDS.COM573-4453425 MO","Everyday Expenses:Transportation","Everyday Expenses","Transportation",,$30.00,$0.00,C,$5488.84
"Us Bank",,,04/30/2014,"Download from usbank.com. LMI*SURETY601987800-773-3312WA","Everyday Expenses:Transportation","Everyday Expenses","Transportation",,$100.00,$0.00,C,$5388.84
"Us Bank",,,04/30/2014,"Download from usbank.com. AMAZON MKTPLACE AMZN.COM/BILWA","Everyday Expenses:Spending Money","Everyday Expenses","Spending Money",,$109.99,$0.00,C,$5278.85
"Us Bank",,,04/30/2014,"Download from usbank.com. PAYPAL","Savings Goals:Vacation & Travel","Savings Goals","Vacation & Travel",,$185.00,$0.00,C,$5093.85
"Us Bank",,,05/01/2014,"Download from usbank.com. TRADER JOE'S #20SAN FRANCISCCA","Everyday Expenses:Groceries","Everyday Expenses","Groceries",,$11.55,$0.00,C,$5082.30
"Us Bank",,,05/01/2014,"Download from usbank.com. THE GROVE-HAYES SAN FRANCISCCA","Everyday Expenses:Spending Money","Everyday Expenses","Spending Money",,$17.40,$0.00,C,$5064.90
"Us Bank",,,05/01/2014,"Download from usbank.com. PAYPAL","Monthly Bills:Web Stuff","Monthly Bills","Web Stuff",,$39.99,$0.00,C,$5024.91
"Us Bank",,,05/01/2014,"Download from usbank.com. Mars Bar & RestaSan FranciscCA","Everyday Expenses:Spending Money","Everyday Expenses","Spending Money",,$42.19,$0.00,C,$4982.72
"Us Bank",,,05/01/2014,"Download from usbank.com. MET CAS INS CO","Monthly Bills:Car Insurance","Monthly Bills","Car Insurance",,$49.00,$0.00,C,$4933.72
"Us Bank",,,05/01/2014,"Download from usbank.com. BARCLAYS BANK DE","Savings Goals:Savings","Savings Goals","Savings",,$100.00,$0.00,C,$4833.72
"Us Bank",,,05/01/2014,"Download from usbank.com. PAYPAL","Savings Goals:Vacation & Travel","Savings Goals","Vacation & Travel",,$171.32,$0.00,C,$4662.40
"Us Bank",,,05/01/2014,"Download from usbank.com. PAYPAL","Savings Goals:Vacation & Travel","Savings Goals","Vacation & Travel",,$243.00,$0.00,C,$4419.40
"Us Bank",,,05/02/2014,"Download from usbank.com. STARBUCKS #05516San FranciscCA","Everyday Expenses:Spending Money","Everyday Expenses","Spending Money",,$4.25,$0.00,C,$4415.15
"Us Bank",,,05/02/2014,"Download from usbank.com. DAILYBURN       888-867-8304NY","Monthly Bills:Web Stuff","Monthly Bills","Web Stuff",,$10.00,$0.00,C,$4405.15
"Us Bank",,,05/02/2014,"Download from usbank.com. AMAZON MKTPLACE AMZN.COM/BILWA","Everyday Expenses:Spending Money","Everyday Expenses","Spending Money",,$31.85,$0.00,C,$4373.30
"Us Bank",,,05/02/2014,"Download from usbank.com. Skool RestaurantSan FranciscCA","Everyday Expenses:Spending Money","Everyday Expenses","Spending Money",,$48.65,$0.00,C,$4324.65
"Us Bank",,,05/02/2014,"Download from usbank.com. TWITTER ADVERTIS415-4264400 CA","Monthly Bills:Web Stuff","Monthly Bills","Web Stuff",,$121.57,$0.00,C,$4203.08
"Us Bank",,,05/02/2014,"Download from usbank.com. GE Capital",,,,,$469.71,$0.00,C,$3733.37
"Us Bank",,,05/02/2014,"Download from usbank.com. 7246","Debt:Eric's Credit Card","Debt","Eric's Credit Card",,$700.00,$0.00,C,$3033.37
"Us Bank",,,05/02/2014,"Download from usbank.com. 6703",,,,,$800.17,$0.00,C,$2233.20
"Us Bank",,,05/05/2014,"Download from usbank.com. VENMO","Everyday Expenses:Spending Money","Everyday Expenses","Spending Money",,$0.00,$91.25,C,$2324.45
"Us Bank",,,05/05/2014,"Download from usbank.com. 050214PLUSTERM3131 16th St.   San FranciscCAUS1","Everyday Expenses:Spending Money","Everyday Expenses","Spending Money",,$2.50,$0.00,C,$2321.95
"Us Bank",,,05/05/2014,"Download from usbank.com. LYFT FRI AT 750P855-865-9553CA","Everyday Expenses:Transportation","Everyday Expenses","Transportation",,$8.00,$0.00,C,$2313.95
"Us Bank",,,05/05/2014,"Download from usbank.com. RANDA'S MARKET  SAN FRANCISCCA","Everyday Expenses:Groceries","Everyday Expenses","Groceries",,$9.20,$0.00,C,$2304.75
"Us Bank",,,05/05/2014,"Download from usbank.com. LYFT FRI AT 849P855-865-9553CA","Everyday Expenses:Transportation","Everyday Expenses","Transportation",,$10.00,$0.00,C,$2294.75
"Us Bank",,,05/05/2014,"Download from usbank.com. LYFT THU AT 217P855-865-9553CA","Everyday Expenses:Transportation","Everyday Expenses","Transportation",,$10.00,$0.00,C,$2284.75
"Us Bank",,,05/05/2014,"Download from usbank.com. PAYPAL","Everyday Expenses:Spending Money","Everyday Expenses","Spending Money",,$10.00,$0.00,C,$2274.75
"Us Bank",,,05/05/2014,"Download from usbank.com. GE Capital",,,,,$10.17,$0.00,C,$2264.58
"Us Bank",,,05/05/2014,"Download from usbank.com. WALGREENS 459 POSAN FRANCISCCA","Everyday Expenses:Household Goods","Everyday Expenses","Household Goods",,$10.19,$0.00,C,$2254.39
"Us Bank",,,05/05/2014,"Download from usbank.com. SQ *WORKSHOP CAFSan FranciscCA","Everyday Expenses:Spending Money","Everyday Expenses","Spending Money",,$17.00,$0.00,C,$2237.39
"Us Bank",,,05/05/2014,"Download from usbank.com. GROUPON INC     877-788-7858IL","Everyday Expenses:Spending Money","Everyday Expenses","Spending Money",,$18.00,$0.00,C,$2219.39
"Us Bank",,,05/05/2014,"Download from usbank.com. 3131 16th St.   San FranciscCAUS1","Everyday Expenses:Spending Money","Everyday Expenses","Spending Money",,$22.95,$0.00,C,$2196.44
"Us Bank",,,05/05/2014,"Download from usbank.com. TWITTER ADVERTIS415-4264400 CA","Monthly Bills:Web Stuff","Monthly Bills","Web Stuff",,$25.00,$0.00,C,$2171.44
"Us Bank",,,05/05/2014,"Download from usbank.com. AMAZON MKTPLACE AMZN.COM/BILWA","Everyday Expenses:Spending Money","Everyday Expenses","Spending Money",,$25.48,$0.00,C,$2145.96
"Us Bank",,,05/05/2014,"Download from usbank.com. JOHN COLLINS    SAN FRANCISCCA","Everyday Expenses:Spending Money","Everyday Expenses","Spending Money",,$31.00,$0.00,C,$2114.96
"Us Bank",,,05/05/2014,"Download from usbank.com. TUMBLR INC      212-7965360 NY","Monthly Bills:Web Stuff","Monthly Bills","Web Stuff",,$49.00,$0.00,C,$2065.96
"Us Bank",,,05/05/2014,"Download from usbank.com. SOLID GOLD SALONSAN FRANCISCCA","Everyday Expenses:Spending Money","Everyday Expenses","Spending Money",,$63.00,$0.00,C,$2002.96
"Us Bank",,,05/05/2014,"Download from usbank.com. 79              SAN FRANCISCCA",,,,,$82.25,$0.00,C,$1920.71
"Us Bank",,,05/05/2014,"Download from usbank.com. Amazon.com      AMZN.COM/BILWA","Everyday Expenses:Spending Money","Everyday Expenses","Spending Money",,$135.97,$0.00,C,$1784.74
"Us Bank",,,05/05/2014,"Download from usbank.com. Mosser Companies","Monthly Bills:Rent","Monthly Bills","Rent",,$1565.09,$0.00,C,$219.65
"Us Bank",,,05/08/2014,"Download from usbank.com.","Income:Available this month","Income","Available this month",,$0.00,$200.00,C,$419.65
"Us Bank",,,05/08/2014,"Download from usbank.com. LYFT TUE AT 758P855-865-9553CA","Everyday Expenses:Transportation","Everyday Expenses","Transportation",,$8.00,$0.00,C,$411.65
"Us Bank",,,05/08/2014,"Download from usbank.com.","Everyday Expenses:Spending Money","Everyday Expenses","Spending Money",,$12.50,$0.00,C,$399.15
"Us Bank",,,05/08/2014,"Download from usbank.com. BRICK HOUSE CAFESAN FRANCISCCA","Everyday Expenses:Spending Money","Everyday Expenses","Spending Money",,$12.96,$0.00,C,$386.19
"Us Bank",,,05/08/2014,"Download from usbank.com. WALGREENS 500 GESAN FRANCISCCA","Everyday Expenses:Household Goods","Everyday Expenses","Household Goods",,$14.78,$0.00,C,$371.41
"Us Bank",,,05/08/2014,"Download from usbank.com. SPRIG           415-894-5191CA","Everyday Expenses:Groceries","Everyday Expenses","Groceries",,$22.00,$0.00,C,$349.41
"Us Bank",,,05/08/2014,"Download from usbank.com. MODCLOTH INC.   888-4959699 CA","Everyday Expenses:Clothing","Everyday Expenses","Clothing",,$102.39,$0.00,C,$247.02
"Us Bank",,,05/09/2014,"Download from usbank.com. MODCLOTH INC","Income:Available this month","Income","Available this month",,$0.00,$1453.26,C,$1700.28
"Us Bank",,,05/09/2014,"Download from usbank.com. SPRIG           4158945191  CA","Everyday Expenses:Groceries","Everyday Expenses","Groceries",,$0.00,$22.00,C,$1722.28
"Us Bank",,,05/09/2014,"Download from usbank.com. STARBUCKS #05757San FranciscCA","Everyday Expenses:Spending Money","Everyday Expenses","Spending Money",,$5.90,$0.00,C,$1716.38
"Us Bank",,,05/09/2014,"Download from usbank.com. BARCLAYS BANK DE","Savings Goals:Savings","Savings Goals","Savings",,$100.00,$0.00,C,$1616.38
"Us Bank",,,05/09/2014,"Download from usbank.com. 000152303861271","Everyday Expenses:Spending Money","Everyday Expenses","Spending Money",,$200.12,$0.00,C,$1416.26
"Us Bank",,,05/12/2014,"Download from usbank.com.","Income:Available this month","Income","Available this month",,$0.00,$650.00,C,$2066.26
"Us Bank",,,05/12/2014,"Download from usbank.com. PUBLIX SUPER MARFRANKLIN    TN","Everyday Expenses:Spending Money","Everyday Expenses","Spending Money",,$2.35,$0.00,C,$2063.91
"Us Bank",,,05/12/2014,"Download from usbank.com. PEETS COFFEE SFOSAN FRANCISCCA","Everyday Expenses:Spending Money","Everyday Expenses","Spending Money",,$2.69,$0.00,C,$2061.22
"Us Bank",,,05/12/2014,"Download from usbank.com. SUTTER FINE FOODSAN FRANCISCCA","Everyday Expenses:Groceries","Everyday Expenses","Groceries",,$3.98,$0.00,C,$2057.24
"Us Bank",,,05/12/2014,"Download from usbank.com. LYFT FRI AT 1002855-865-9553CA","Everyday Expenses:Transportation","Everyday Expenses","Transportation",,$6.00,$0.00,C,$2051.24
"Us Bank",,,05/12/2014,"Download from usbank.com. PAYPAL","Everyday Expenses:Spending Money","Everyday Expenses","Spending Money",,$8.00,$0.00,C,$2043.24
"Us Bank",,,05/12/2014,"Download from usbank.com. EAT24.COM       EAT24HOURS.CCA","Everyday Expenses:Spending Money","Everyday Expenses","Spending Money",,$9.89,$0.00,C,$2033.35
"Us Bank",,,05/12/2014,"Download from usbank.com. SOUTHWESTAIR*INFDALLAS      TX","Everyday Expenses:Spending Money","Everyday Expenses","Spending Money",,$10.00,$0.00,C,$2023.35
"Us Bank",,,05/12/2014,"Download from usbank.com. BITE            SAN FRANCISCCA","Everyday Expenses:Spending Money","Everyday Expenses","Spending Money",,$10.10,$0.00,C,$2013.25
"Us Bank",,,05/12/2014,"Download from usbank.com. VICTORIA'S SECRESAN FRANCISCCA","Everyday Expenses:Clothing","Everyday Expenses","Clothing",,$11.42,$0.00,C,$2001.83
"Us Bank",,,05/12/2014,"Download from usbank.com. PEETS COFFEE SFOSAN FRANCISCCA","Everyday Expenses:Spending Money","Everyday Expenses","Spending Money",,$11.56,$0.00,C,$1990.27
"Us Bank",,,05/12/2014,"Download from usbank.com.","Everyday Expenses:Spending Money","Everyday Expenses","Spending Money",,$12.50,$0.00,C,$1977.77
"Us Bank",,,05/12/2014,"Download from usbank.com. CHEVRON 00090030SAN FRANCISCCA","Everyday Expenses:Transportation","Everyday Expenses","Transportation",,$14.53,$0.00,C,$1963.24
"Us Bank",,,05/12/2014,"Download from usbank.com. GETAROUND       866-438-2760CA","Everyday Expenses:Transportation","Everyday Expenses","Transportation",,$18.00,$0.00,C,$1945.24
"Us Bank",,,05/12/2014,"Download from usbank.com. Amazon.com      AMZN.COM/BILWA","Everyday Expenses:Spending Money","Everyday Expenses","Spending Money",,$19.02,$0.00,C,$1926.22
"Us Bank",,,05/12/2014,"Download from usbank.com. SPRIG           415-894-5191CA","Everyday Expenses:Groceries","Everyday Expenses","Groceries",,$22.00,$0.00,C,$1904.22
"Us Bank",,,05/12/2014,"Download from usbank.com. VENMO","Everyday Expenses:Spending Money","Everyday Expenses","Spending Money",,$22.50,$0.00,C,$1881.72
"Us Bank",,,05/12/2014,"Download from usbank.com. AMAZON MKTPLACE AMZN.COM/BILWA","Everyday Expenses:Spending Money","Everyday Expenses","Spending Money",,$22.89,$0.00,C,$1858.83
"Us Bank",,,05/12/2014,"Download from usbank.com. SUNDANCE KAB    818-889-8562CA","Everyday Expenses:Spending Money","Everyday Expenses","Spending Money",,$30.00,$0.00,C,$1828.83
"Us Bank",,,05/12/2014,"Download from usbank.com. TRADER JOE'S #20SAN FRANCISCCA","Everyday Expenses:Groceries","Everyday Expenses","Groceries",,$31.58,$0.00,C,$1797.25
"Us Bank",,,05/12/2014,"Download from usbank.com. WAL Wal-Mart SupFRANKLIN    TN","Everyday Expenses:Spending Money","Everyday Expenses","Spending Money",,$34.75,$0.00,C,$1762.50
"Us Bank",,,05/12/2014,"Download from usbank.com. ESTRELLA TAQUERISAN FRANCISCCA","Everyday Expenses:Spending Money","Everyday Expenses","Spending Money",,$36.59,$0.00,C,$1725.91
"Us Bank",,,05/12/2014,"Download from usbank.com. ROOT DOWN REST- DENVER      CO","Everyday Expenses:Spending Money","Everyday Expenses","Spending Money",,$39.02,$0.00,C,$1686.89
"Us Bank",,,05/12/2014,"Download from usbank.com. CARDMEMBER SERV",,,,,$41.00,$0.00,C,$1645.89
"Us Bank",,,05/12/2014,"Download from usbank.com. PAYPAL","Savings Goals:Vacation & Travel","Savings Goals","Vacation & Travel",,$74.98,$0.00,C,$1570.91
"Us Bank",,,05/12/2014,"Download from usbank.com. SOUTHWES    5262800-435-9792TX","Savings Goals:Vacation & Travel","Savings Goals","Vacation & Travel",,$95.00,$0.00,C,$1475.91
"Us Bank",,,05/12/2014,"Download from usbank.com. JASPERS CORNER TSAN FRANCISCCA","Everyday Expenses:Spending Money","Everyday Expenses","Spending Money",,$100.75,$0.00,C,$1375.16
"Us Bank",,,05/12/2014,"Download from usbank.com. H&M             SAN FRANCISCCA","Everyday Expenses:Clothing","Everyday Expenses","Clothing",,$134.36,$0.00,C,$1240.80
"Us Bank",,,05/12/2014,"Download from usbank.com. APPLE STORE  #R0SAN FRANCISCCA","Everyday Expenses:Spending Money","Everyday Expenses","Spending Money",,$162.04,$0.00,C,$1078.76
"Us Bank",,,05/12/2014,"Download from usbank.com. AmazonPrime Membamzn.com/prmNV","Everyday Expenses:Spending Money","Everyday Expenses","Spending Money",,$325.16,$0.00,C,$753.60
"Us Bank",,,05/13/2014,"Download from usbank.com.","Everyday Expenses:Spending Money","Everyday Expenses","Spending Money",,$0.00,$300.00,C,$1053.60
"Us Bank",,,05/13/2014,"Download from usbank.com. LYFT            8558659553  CA","Everyday Expenses:Transportation","Everyday Expenses","Transportation",,$0.00,$7.00,C,$1060.60
"Us Bank",,,05/13/2014,"Download from usbank.com. CUP A JOES COFFESAN FRANCISCCA","Everyday Expenses:Spending Money","Everyday Expenses","Spending Money",,$6.50,$0.00,C,$1054.10
"Us Bank",,,05/13/2014,"Download from usbank.com. LYFT SUN AT 215A855-865-9553CA","Everyday Expenses:Transportation","Everyday Expenses","Transportation",,$7.00,$0.00,C,$1047.10
"Us Bank",,,05/13/2014,"Download from usbank.com. EINSTEINS # 4043FRANKLIN    TN","Everyday Expenses:Spending Money","Everyday Expenses","Spending Money",,$8.50,$0.00,C,$1038.60
"Us Bank",,,05/13/2014,"Download from usbank.com. DARWIN CAFE LLC SAN FRANCISCCA","Everyday Expenses:Spending Money","Everyday Expenses","Spending Money",,$11.00,$0.00,C,$1027.60
"Us Bank",,,05/13/2014,"Download from usbank.com.","Everyday Expenses:Spending Money","Everyday Expenses","Spending Money",,$12.50,$0.00,C,$1015.10
"Us Bank",,,05/13/2014,"Download from usbank.com. ZUSHIMAKI       FRANKLIN    TN","Everyday Expenses:Spending Money","Everyday Expenses","Spending Money",,$20.00,$0.00,C,$995.10
"Us Bank",,,05/13/2014,"Download from usbank.com. CORK AND COW  55FRANKLIN    TN","Everyday Expenses:Spending Money","Everyday Expenses","Spending Money",,$30.00,$0.00,C,$965.10
"Us Bank",,,05/14/2014,"Download from usbank.com. AmazonPrime Membamzn.com/prmNV","Everyday Expenses:Spending Money","Everyday Expenses","Spending Money",,$0.00,$325.16,C,$1290.26
"Us Bank",,,05/14/2014,"Download from usbank.com. BART-CLIPPER CIVSAN FRANCISCCA","Everyday Expenses:Transportation","Everyday Expenses","Transportation",,$20.00,$0.00,C,$1270.26
"Us Bank",,,05/14/2014,"Download from usbank.com. WALGREENS 1300 BSAN FRANCISCCA","Everyday Expenses:Household Goods","Everyday Expenses","Household Goods",,$20.50,$0.00,C,$1249.76
"Us Bank",,,05/14/2014,"Download from usbank.com. H&M             SAN FRANCISCCA","Everyday Expenses:Clothing","Everyday Expenses","Clothing",,$21.70,$0.00,C,$1228.06
"Us Bank",,,05/14/2014,"Download from usbank.com. PAYPAL","Everyday Expenses:Spending Money","Everyday Expenses","Spending Money",,$39.54,$0.00,C,$1188.52
"Us Bank",,,05/14/2014,"Download from usbank.com. TRADER JOE'S #20SAN FRANCISCCA","Everyday Expenses:Groceries","Everyday Expenses","Groceries",,$63.40,$0.00,C,$1125.12
"Us Bank",,,05/14/2014,"Download from usbank.com. SQ *BEAUTIFIED SSan FranciscCA","Everyday Expenses:Spending Money","Everyday Expenses","Spending Money",,$66.00,$0.00,C,$1059.12
"Us Bank",,,05/14/2014,"Download from usbank.com. AmazonPrime Membamzn.com/prmNV","Everyday Expenses:Spending Money","Everyday Expenses","Spending Money",,$107.66,$0.00,C,$951.46
"Us Bank",,,05/15/2014,"Download from usbank.com. SQWIGGLE INC","Income:Available this month","Income","Available this month",,$0.00,$1965.99,C,$2917.45
"Us Bank",,,05/15/2014,"Download from usbank.com. APL*APPLE ITUNES866-712-7753CA","Everyday Expenses:Spending Money","Everyday Expenses","Spending Money",,$2.99,$0.00,C,$2914.46
"Us Bank",,,05/15/2014,"Download from usbank.com. LYFT TUE AT 446P855-865-9553CA","Everyday Expenses:Transportation","Everyday Expenses","Transportation",,$5.00,$0.00,C,$2909.46
"Us Bank",,,05/15/2014,"Download from usbank.com. TACQUERIA DOS AM415-5751111 CA","Everyday Expenses:Transportation","Everyday Expenses","Transportation",,$8.16,$0.00,C,$2901.30
"Us Bank",,,05/15/2014,"Download from usbank.com. PAYPAL","Everyday Expenses:Spending Money","Everyday Expenses","Spending Money",,$10.58,$0.00,C,$2890.72
"Us Bank",,,05/15/2014,"Download from usbank.com. AT&T PARK CONCESSAN FRANCISCCA","Everyday Expenses:Spending Money","Everyday Expenses","Spending Money",,$14.25,$0.00,C,$2876.47
"Us Bank",,,05/15/2014,"Download from usbank.com. BARCLAYS BANK DE","Savings Goals:Savings","Savings Goals","Savings",,$100.00,$0.00,C,$2776.47
"Us Bank",,,05/16/2014,"Download from usbank.com. MODCLOTH INC.   888-4959699 CA","Everyday Expenses:Clothing","Everyday Expenses","Clothing",,$51.79,$0.00,C,$2724.68
"Us Bank",,,05/16/2014,"Download from usbank.com. MODCLOTH INC.   888-4959699 CA","Everyday Expenses:Clothing","Everyday Expenses","Clothing",,$587.28,$0.00,C,$2137.40
"Us Bank",,,05/19/2014,"Download from usbank.com. SAVE A LOT #2323OTTO        MO","Everyday Expenses:Spending Money","Everyday Expenses","Spending Money",,$4.27,$0.00,C,$2133.13
"Us Bank",,,05/19/2014,"Download from usbank.com. MCDONALD'S F4838POPLAR BLUFFMO","Everyday Expenses:Spending Money","Everyday Expenses","Spending Money",,$5.21,$0.00,C,$2127.92
"Us Bank",,,05/19/2014,"Download from usbank.com. PANERA BREAD #10FRANKLIN    TN","Everyday Expenses:Spending Money","Everyday Expenses","Spending Money",,$6.42,$0.00,C,$2121.50
"Us Bank",,,05/19/2014,"Download from usbank.com. PAYPAL","Monthly Bills:Web Stuff","Monthly Bills","Web Stuff",,$9.99,$0.00,C,$2111.51
"Us Bank",,,05/19/2014,"Download from usbank.com. THE BREAD COMPANPOPLAR BLUFFMO","Everyday Expenses:Spending Money","Everyday Expenses","Spending Money",,$11.83,$0.00,C,$2099.68
"Us Bank",,,05/19/2014,"Download from usbank.com. PILOT #0049     OAK GROVE   KY","Everyday Expenses:Spending Money","Everyday Expenses","Spending Money",,$12.37,$0.00,C,$2087.31
"Us Bank",,,05/19/2014,"Download from usbank.com. THE BREAD COMPANPOPLAR BLUFFMO","Everyday Expenses:Spending Money","Everyday Expenses","Spending Money",,$28.08,$0.00,C,$2059.23
"Us Bank",,,05/19/2014,"Download from usbank.com. COUNTRY CORNER  DESOTO      MO","Everyday Expenses:Spending Money","Everyday Expenses","Spending Money",,$37.80,$0.00,C,$2021.43
"Us Bank",,,05/19/2014,"Download from usbank.com. LONGHORN STEAK00HAZELWOOD   MO","Everyday Expenses:Spending Money","Everyday Expenses","Spending Money",,$43.40,$0.00,C,$1978.03
"Us Bank",,,05/19/2014,"Download from usbank.com. PILOT           Oak Grove   KY","Everyday Expenses:Transportation","Everyday Expenses","Transportation",,$45.86,$0.00,C,$1932.17
"Us Bank",,,05/19/2014,"Download from usbank.com. MAURICES 1035 MAOPLAR BLUFF MO","Everyday Expenses:Clothing","Everyday Expenses","Clothing",,$86.10,$0.00,C,$1846.07
"Us Bank",,,05/19/2014,"Download from usbank.com. LAMBERT INTL-CONSAINT LOUIS MOUS1",,,,,$300.00,$0.00,C,$1546.07
"Us Bank",,,05/20/2014,"Download from usbank.com. PAYPAL","Monthly Bills:Web Stuff","Monthly Bills","Web Stuff",,$9.99,$0.00,C,$1536.08
"Us Bank",,,05/20/2014,"Download from usbank.com. ATT","Monthly Bills:Cell Phone","Monthly Bills","Cell Phone",,$226.28,$0.00,C,$1309.80
"Us Bank",,,05/22/2014,"Download from usbank.com.","Everyday Expenses:Spending Money","Everyday Expenses","Spending Money",,$0.00,$6.95,C,$1316.75
"Us Bank",,,05/22/2014,"Download from usbank.com.","Everyday Expenses:Spending Money","Everyday Expenses","Spending Money",,$6.95,$0.00,C,$1309.80
"Us Bank",,,05/23/2014,"Download from usbank.com. MODCLOTH INC","Income:Available this month","Income","Available this month",,$0.00,$1453.24,C,$2763.04
"Us Bank",,,05/23/2014,"Download from usbank.com. PAYPAL","Monthly Bills:Web Stuff","Monthly Bills","Web Stuff",,$9.99,$0.00,C,$2753.05
"Us Bank",,,05/23/2014,"Download from usbank.com. PAYPAL","Everyday Expenses:Spending Money","Everyday Expenses","Spending Money",,$12.42,$0.00,C,$2740.63
"Us Bank",,,05/23/2014,"Download from usbank.com. BARCLAYS BANK DE","Savings Goals:Savings","Savings Goals","Savings",,$100.00,$0.00,C,$2640.63
"Us Bank",,,05/27/2014,"Download from usbank.com. HLU*Hulu 2274453HULU.COM/BILCA","Monthly Bills:Web Stuff","Monthly Bills","Web Stuff",,$7.99,$0.00,C,$2632.64
"Us Bank",,,05/27/2014,"Download from usbank.com. HLU*Hulu 4502449HULU.COM/BILCA","Monthly Bills:Web Stuff","Monthly Bills","Web Stuff",,$7.99,$0.00,C,$2624.65
"Us Bank",,,05/27/2014,"Download from usbank.com. BART SFIA       SAN FRANCISCCA","Everyday Expenses:Transportation","Everyday Expenses","Transportation",,$8.65,$0.00,C,$2616.00
"Us Bank",,,05/27/2014,"Download from usbank.com. DOMINO'S 1517   636-537-1120MO","Everyday Expenses:Spending Money","Everyday Expenses","Spending Money",,$26.29,$0.00,C,$2589.71
"Us Bank",,,05/27/2014,"Download from usbank.com. PAYPAL","Monthly Bills:Web Stuff","Monthly Bills","Web Stuff",,$39.95,$0.00,C,$2549.76
"Us Bank",,,05/27/2014,"Download from usbank.com. WALGREENS 1300 BSAN FRANCISCCA","Everyday Expenses:Household Goods","Everyday Expenses","Household Goods",,$86.88,$0.00,C,$2462.88
"Us Bank",,,05/28/2014,"Download from usbank.com. LYFT MON AT 214P855-865-9553CA","Everyday Expenses:Transportation","Everyday Expenses","Transportation",,$7.00,$0.00,C,$2455.88
"Us Bank",,,05/28/2014,"Download from usbank.com. LYFT TUE AT 934P855-865-9553CA","Everyday Expenses:Transportation","Everyday Expenses","Transportation",,$8.00,$0.00,C,$2447.88
"Us Bank",,,05/28/2014,"Download from usbank.com. STARBUCKS E-1820ST LOUIS    MO","Everyday Expenses:Spending Money","Everyday Expenses","Spending Money",,$9.71,$0.00,C,$2438.17
"Us Bank",,,05/28/2014,"Download from usbank.com. LYFT FRI AT 1115855-865-9553CA","Everyday Expenses:Transportation","Everyday Expenses","Transportation",,$10.00,$0.00,C,$2428.17
"Us Bank",,,05/28/2014,"Download from usbank.com. LYFT TUE AT 711P855-865-9553CA","Everyday Expenses:Transportation","Everyday Expenses","Transportation",,$10.00,$0.00,C,$2418.17
"Us Bank",,,05/28/2014,"Download from usbank.com. T1 LA BREA BAK32LOS ANGELES CA","Everyday Expenses:Spending Money","Everyday Expenses","Spending Money",,$22.43,$0.00,C,$2395.74
"Us Bank",,,05/28/2014,"Download from usbank.com. QUALITY INN AIRPSAINT LOUIS MO","Savings Goals:Vacation & Travel","Savings Goals","Vacation & Travel",,$77.40,$0.00,C,$2318.34
"Us Bank",,,05/28/2014,"Download from usbank.com. WHOLE FOODS MARKSan FranciscCA","Everyday Expenses:Groceries","Everyday Expenses","Groceries",,$116.50,$0.00,C,$2201.84
"Us Bank",,,05/29/2014,"Download from usbank.com. CUP A JOES COFFESAN FRANCISCCA","Everyday Expenses:Spending Money","Everyday Expenses","Spending Money",,$7.61,$0.00,C,$2194.23
"Us Bank",,,05/29/2014,"Download from usbank.com. BITE            SAN FRANCISCCA","Everyday Expenses:Spending Money","Everyday Expenses","Spending Money",,$10.86,$0.00,C,$2183.37
"Us Bank",,,05/29/2014,"Download from usbank.com. AmazonLocal     www.amazonloWA","Everyday Expenses:Spending Money","Everyday Expenses","Spending Money",,$12.00,$0.00,C,$2171.37
"Us Bank",,,05/30/2014,"Download from usbank.com. SQWIGGLE INC","Income:Available this month","Income","Available this month",,$0.00,$1965.99,C,$4137.36
"Us Bank",,,05/30/2014,"Download from usbank.com. VENMO","Everyday Expenses:Spending Money","Everyday Expenses","Spending Money",,$0.00,$587.20,C,$4724.56
"Us Bank",,,05/30/2014,"Download from usbank.com. AMAZON DIG494604","Everyday Expenses:Spending Money","Everyday Expenses","Spending Money",,$0.00,$13.31,C,$4737.87
"Us Bank",,,05/30/2014,"Download from usbank.com. SPRIG           415-894-5191CA","Everyday Expenses:Groceries","Everyday Expenses","Groceries",,$11.00,$0.00,C,$4726.87
"Us Bank",,,06/02/2014,"Download from usbank.com. LYFT SAT AT 546P855-865-9553CA","Everyday Expenses:Transportation","Everyday Expenses","Transportation",,$5.00,$0.00,C,$4721.87
"Us Bank",,,06/02/2014,"Download from usbank.com. PAYPAL","Everyday Expenses:Spending Money","Everyday Expenses","Spending Money",,$9.87,$0.00,C,$4712.00
"Us Bank",,,06/02/2014,"Download from usbank.com. FLY             SAN FRANCISCCA","Everyday Expenses:Groceries","Everyday Expenses","Groceries",,$9.97,$0.00,C,$4702.03
"Us Bank",,,06/02/2014,"Download from usbank.com. DAILYBURN       888-867-8304NY","Monthly Bills:Web Stuff","Monthly Bills","Web Stuff",,$10.00,$0.00,C,$4692.03
"Us Bank",,,06/02/2014,"Download from usbank.com. AMC VAN NESS 14 SAN FRANCISCCA","Everyday Expenses:Spending Money","Everyday Expenses","Spending Money",,$20.50,$0.00,C,$4671.53
"Us Bank",,,06/02/2014,"Download from usbank.com. MOULIN CAFE/887 SAN FRANCISCCA","Everyday Expenses:Spending Money","Everyday Expenses","Spending Money",,$26.56,$0.00,C,$4644.97
"Us Bank",,,06/02/2014,"Download from usbank.com. MET CAS INS CO","Monthly Bills:Car Insurance","Monthly Bills","Car Insurance",,$49.00,$0.00,C,$4595.97
"Us Bank",,,06/02/2014,"Download from usbank.com. BARCLAYS BANK DE","Savings Goals:Savings","Savings Goals","Savings",,$100.00,$0.00,C,$4495.97
"Us Bank",,,06/02/2014,"Download from usbank.com. MODCLOTH INC.   888-4959699 CA","Everyday Expenses:Clothing","Everyday Expenses","Clothing",,$107.16,$0.00,C,$4388.81
"Us Bank",,,06/02/2014,"Download from usbank.com. WHOLE FOODS MARKSan FranciscCA","Everyday Expenses:Groceries","Everyday Expenses","Groceries",,$197.01,$0.00,C,$4191.80
"Us Bank",,,06/03/2014,"Download from usbank.com. SUDACHI         SAN FRANCISCCA","Everyday Expenses:Spending Money","Everyday Expenses","Spending Money",,$16.84,$0.00,C,$4174.96
"Us Bank",,,06/04/2014,"Download from usbank.com. NORDSTROM 474 90SAN FRANCISCCA","Everyday Expenses:Clothing","Everyday Expenses","Clothing",,$7.58,$0.00,C,$4167.38
"Us Bank",,,06/04/2014,"Download from usbank.com. SUPER DUPER BURGSAN FRANCISCCA","Everyday Expenses:Spending Money","Everyday Expenses","Spending Money",,$8.16,$0.00,C,$4159.22
"Us Bank",,,06/04/2014,"Download from usbank.com. PGANDE","Monthly Bills:Utilities","Monthly Bills","Utilities",,$11.77,$0.00,C,$4147.45
"Us Bank",,,06/04/2014,"Download from usbank.com. SNPFINGERONLINEF678-739-4669GA","Everyday Expenses:Spending Money","Everyday Expenses","Spending Money",,$12.56,$0.00,C,$4134.89
"Us Bank",,,06/04/2014,"Download from usbank.com. SUTTER FINE FOODSAN FRANCISCCA","Everyday Expenses:Groceries","Everyday Expenses","Groceries",,$17.39,$0.00,C,$4117.50
"Us Bank",,,06/04/2014,"Download from usbank.com. TJ TJ MAXX      SFRANCISO   CA","Everyday Expenses:Clothing","Everyday Expenses","Clothing",,$34.78,$0.00,C,$4082.72
"Us Bank",,,06/05/2014,"Download from usbank.com. Apple","Everyday Expenses:Spending Money","Everyday Expenses","Spending Money",,$0.00,$13.77,C,$4096.49
"Us Bank",,,06/05/2014,"Download from usbank.com. SUPER DUPER BURGSAN FRANCISCCA","Everyday Expenses:Spending Money","Everyday Expenses","Spending Money",,$3.81,$0.00,C,$4092.68
"Us Bank",,,06/05/2014,"Download from usbank.com. SQ *WORKSHOP CAFSan FranciscCA","Everyday Expenses:Spending Money","Everyday Expenses","Spending Money",,$5.00,$0.00,C,$4087.68
"Us Bank",,,06/05/2014,"Download from usbank.com. LYFT WED AT 614P855-865-9553CA","Everyday Expenses:Transportation","Everyday Expenses","Transportation",,$6.00,$0.00,C,$4081.68
"Us Bank",,,06/05/2014,"Download from usbank.com. LYFT WED AT 1013855-865-9553CA","Everyday Expenses:Transportation","Everyday Expenses","Transportation",,$6.00,$0.00,C,$4075.68
"Us Bank",,,06/05/2014,"Download from usbank.com. APL*APPLE ITUNES866-712-7753CA","Everyday Expenses:Spending Money","Everyday Expenses","Spending Money",,$7.98,$0.00,C,$4067.70
"Us Bank",,,06/05/2014,"Download from usbank.com. PAYPAL","Everyday Expenses:Transportation","Everyday Expenses","Transportation",,$8.57,$0.00,C,$4059.13
"Us Bank",,,06/05/2014,"Download from usbank.com. Mosser Companies","Monthly Bills:Rent","Monthly Bills","Rent",,$1565.09,$0.00,C,$2494.04
"Us Bank",,,06/06/2014,"Download from usbank.com. MODCLOTH INC","Income:Available this month","Income","Available this month",,$0.00,$1453.25,C,$3947.29
"Us Bank",,,06/06/2014,"Download from usbank.com. BAMBOO ASIA     SAN FRANCISCCA","Everyday Expenses:Spending Money","Everyday Expenses","Spending Money",,$7.23,$0.00,C,$3940.06
"Us Bank",,,06/06/2014,"Download from usbank.com. CHIPOTLE 1857   SAN FRANCISCCA","Everyday Expenses:Spending Money","Everyday Expenses","Spending Money",,$8.05,$0.00,C,$3932.01
"Us Bank",,,06/06/2014,"Download from usbank.com. BAMBOO ASIA     SAN FRANCISCCA","Everyday Expenses:Spending Money","Everyday Expenses","Spending Money",,$9.23,$0.00,C,$3922.78
"Us Bank",,,06/06/2014,"Download from usbank.com. SPRIG           415-894-5191CA","Everyday Expenses:Groceries","Everyday Expenses","Groceries",,$22.00,$0.00,C,$3900.78
"Us Bank",,,06/06/2014,"Download from usbank.com. RESTAURANT LULU SAN FRANCISCCA","Everyday Expenses:Spending Money","Everyday Expenses","Spending Money",,$35.00,$0.00,C,$3865.78
"Us Bank",,,06/06/2014,"Download from usbank.com. VENMO           646-801-3023NY","Everyday Expenses:Spending Money","Everyday Expenses","Spending Money",,$38.00,$0.00,C,$3827.78
"Us Bank",,,06/06/2014,"Download from usbank.com. WHOLE FOODS MARKSan FranciscCA","Everyday Expenses:Groceries","Everyday Expenses","Groceries",,$40.08,$0.00,C,$3787.70
"Us Bank",,,06/06/2014,"Download from usbank.com. BARCLAYS BANK DE","Savings Goals:Savings","Savings Goals","Savings",,$100.00,$0.00,C,$3687.70
"Us Bank",,,06/09/2014,"Download from usbank.com. VIRGIN AMER 9842SAN FRANCISCCA","Savings Goals:Vacation & Travel","Savings Goals","Vacation & Travel",,$0.00,$44.00,C,$3731.70
"Us Bank",,,06/09/2014,"Download from usbank.com. VIRGIN AMER 9842SAN FRANCISCCA","Savings Goals:Vacation & Travel","Savings Goals","Vacation & Travel",,$0.00,$14.00,C,$3745.70
"Us Bank",,,06/09/2014,"Download from usbank.com. APL*APPLE ITUNES866-712-7753CA","Everyday Expenses:Spending Money","Everyday Expenses","Spending Money",,$0.99,$0.00,C,$3744.71
"Us Bank",,,06/09/2014,"Download from usbank.com. 060714PLUSTERM50 OVERLOOK DRIVSAN FRANCISCCAUS1","Everyday Expenses:Spending Money","Everyday Expenses","Spending Money",,$2.50,$0.00,C,$3742.21
"Us Bank",,,06/09/2014,"Download from usbank.com. D URSOS ITALIAN SAN FRANCISCCA","Everyday Expenses:Spending Money","Everyday Expenses","Spending Money",,$5.40,$0.00,C,$3736.81
"Us Bank",,,06/09/2014,"Download from usbank.com. SPOONROCKET.COM 510-921-9929CA","Everyday Expenses:Spending Money","Everyday Expenses","Spending Money",,$6.52,$0.00,C,$3730.29
"Us Bank",,,06/09/2014,"Download from usbank.com. WALGREENS 1300 BSAN FRANCISCCA","Everyday Expenses:Household Goods","Everyday Expenses","Household Goods",,$16.72,$0.00,C,$3713.57
"Us Bank",,,06/09/2014,"Download from usbank.com. LYFT SAT AT 221P855-865-9553CA","Everyday Expenses:Transportation","Everyday Expenses","Transportation",,$19.00,$0.00,C,$3694.57
"Us Bank",,,06/09/2014,"Download from usbank.com. HOWABOUTWE.COM  718-310-3363NY","Everyday Expenses:Spending Money","Everyday Expenses","Spending Money",,$20.00,$0.00,C,$3674.57
"Us Bank",,,06/09/2014,"Download from usbank.com. SUNDANCE KAB    818-889-8562CA","Everyday Expenses:Spending Money","Everyday Expenses","Spending Money",,$30.00,$0.00,C,$3644.57
"Us Bank",,,06/09/2014,"Download from usbank.com. WARAKU          SAN FRANCISCCA","Everyday Expenses:Spending Money","Everyday Expenses","Spending Money",,$40.40,$0.00,C,$3604.17
"Us Bank",,,06/09/2014,"Download from usbank.com. WHOLE FOODS MARKSan FranciscCA","Everyday Expenses:Groceries","Everyday Expenses","Groceries",,$52.20,$0.00,C,$3551.97
"Us Bank",,,06/09/2014,"Download from usbank.com. 50 OVERLOOK DRIVSAN FRANCISCCAUS1","Everyday Expenses:Spending Money","Everyday Expenses","Spending Money",,$84.95,$0.00,C,$3467.02
"Us Bank",,,06/09/2014,"Download from usbank.com. WHOLE FOODS MARKSan FranciscCA","Everyday Expenses:Groceries","Everyday Expenses","Groceries",,$89.55,$0.00,C,$3377.47
"Us Bank",,,06/09/2014,"Download from usbank.com. VIRGIN AMER 9842SAN FRANCISCCA","Savings Goals:Vacation & Travel","Savings Goals","Vacation & Travel",,$298.00,$0.00,C,$3079.47
"Us Bank",,,06/09/2014,"Download from usbank.com. VIRGIN AMER 9842SAN FRANCISCCA","Savings Goals:Vacation & Travel","Savings Goals","Vacation & Travel",,$313.00,$0.00,C,$2766.47
"Us Bank",,,06/10/2014,"Download from usbank.com. LYFT MON AT 904P855-865-9553CA","Everyday Expenses:Transportation","Everyday Expenses","Transportation",,$9.00,$0.00,C,$2757.47
"Us Bank",,,06/10/2014,"Download from usbank.com. VENMO           646-801-3023NY","Everyday Expenses:Spending Money","Everyday Expenses","Spending Money",,$11.00,$0.00,C,$2746.47
"Us Bank",,,06/10/2014,"Download from usbank.com. LUSH POWELL ST  SAN FRANCISCCA","Everyday Expenses:Spending Money","Everyday Expenses","Spending Money",,$28.22,$0.00,C,$2718.25
"Us Bank",,,06/10/2014,"Download from usbank.com. CARDMEMBER SERV",,,,,$38.00,$0.00,C,$2680.25
"Us Bank",,,06/11/2014,"Download from usbank.com. 000152303861271","Everyday Expenses:Spending Money","Everyday Expenses","Spending Money",,$25.00,$0.00,C,$2655.25
"Us Bank",,,06/11/2014,"Download from usbank.com. SQ *BEAUTIFIED SSan FranciscCA","Everyday Expenses:Spending Money","Everyday Expenses","Spending Money",,$66.00,$0.00,C,$2589.25
"Us Bank",,,06/11/2014,"Download from usbank.com. COMCAST","Monthly Bills:Utilities","Monthly Bills","Utilities",,$151.30,$0.00,C,$2437.95
"Us Bank",,,06/12/2014,"Download from usbank.com. DELTA AIR   0060ATLANTA     GA","Savings Goals:Vacation & Travel","Savings Goals","Vacation & Travel",,$6.00,$0.00,C,$2431.95
"Us Bank",,,06/12/2014,"Download from usbank.com. DELTA AIR   0060ATLANTA     GA","Savings Goals:Vacation & Travel","Savings Goals","Vacation & Travel",,$6.00,$0.00,C,$2425.95
"Us Bank",,,06/12/2014,"Download from usbank.com. CHIPOTLE 0974   SALT LAKE CIUT","Everyday Expenses:Spending Money","Everyday Expenses","Spending Money",,$17.09,$0.00,C,$2408.86
"Us Bank",,,06/12/2014,"Download from usbank.com. WALGREENS 1300 BSAN FRANCISCCA","Everyday Expenses:Household Goods","Everyday Expenses","Household Goods",,$31.50,$0.00,C,$2377.36
"Us Bank",,,06/12/2014,"Download from usbank.com. BART-CIVIC CENTESAN FRANCISCCA","Everyday Expenses:Transportation","Everyday Expenses","Transportation",,$34.60,$0.00,C,$2342.76
"Us Bank",,,06/13/2014,"Sqwiggle pay","Income:Available this month","Income","Available this month",,$0.00,$1965.99,C,$4308.75
"Us Bank",,,06/13/2014,"Download from usbank.com. MODCLOTH INC.   888-4959699 CA","Everyday Expenses:Clothing","Everyday Expenses","Clothing",,$0.00,$317.48,C,$4626.23
"Us Bank",,,06/13/2014,"Download from usbank.com. PERRYS        00SAN FRANCISCCA","Everyday Expenses:Spending Money","Everyday Expenses","Spending Money",,$4.35,$0.00,C,$4621.88
"Us Bank",,,06/13/2014,"Download from usbank.com. LYFT WED AT 303P855-865-9553CA","Everyday Expenses:Transportation","Everyday Expenses","Transportation",,$6.00,$0.00,C,$4615.88
"Us Bank",,,06/13/2014,"Download from usbank.com. JUICE N JAVA PROPROVO       UT","Everyday Expenses:Spending Money","Everyday Expenses","Spending Money",,$12.00,$0.00,C,$4603.88
"Us Bank",,,06/16/2014,"Download from usbank.com. PANDA EXPRESS 52OREM        UT","Everyday Expenses:Spending Money","Everyday Expenses","Spending Money",,$7.11,$0.00,C,$4596.77
"Us Bank",,,06/16/2014,"Download from usbank.com. FRESH MKT PROVO PROVO       UT","Everyday Expenses:Groceries","Everyday Expenses","Groceries",,$16.67,$0.00,C,$4580.10
"Us Bank",,,06/16/2014,"Download from usbank.com. COMMUNAL        PROVO       UT","Everyday Expenses:Spending Money","Everyday Expenses","Spending Money",,$32.02,$0.00,C,$4548.08
"Us Bank",,,06/16/2014,"Download from usbank.com. CHEVRON 00071050SALT LAKE CIUT","Everyday Expenses:Transportation","Everyday Expenses","Transportation",,$36.47,$0.00,C,$4511.61
"Us Bank",,,06/16/2014,"Download from usbank.com. TARGET T1754    Orem        UT","Everyday Expenses:Spending Money","Everyday Expenses","Spending Money",,$40.90,$0.00,C,$4470.71
"Us Bank",,,06/16/2014,"Download from usbank.com. YAMATO          OREM        UT","Everyday Expenses:Spending Money","Everyday Expenses","Spending Money",,$46.33,$0.00,C,$4424.38
"Us Bank",,,06/16/2014,"Download from usbank.com. TRADER JOE'S #20SAN FRANCISCCA","Everyday Expenses:Groceries","Everyday Expenses","Groceries",,$48.74,$0.00,C,$4375.64
"Us Bank",,,06/16/2014,"Download from usbank.com. ESSENCE NAILS ANPROVO       UT","Everyday Expenses:Spending Money","Everyday Expenses","Spending Money",,$78.00,$0.00,C,$4297.64
"Us Bank",,,06/16/2014,"Download from usbank.com. BARCLAYS BANK DE","Savings Goals:Savings","Savings Goals","Savings",,$100.00,$0.00,C,$4197.64
"Us Bank",,,06/16/2014,"Download from usbank.com. 000152303861271","Debt:Eric's Credit Card","Debt","Eric's Credit Card",,$944.70,$0.00,C,$3252.94
"Us Bank",,,06/17/2014,"Download from usbank.com. LYFT MON AT 643P855-865-9553CA","Everyday Expenses:Transportation","Everyday Expenses","Transportation",,$8.00,$0.00,C,$3244.94
"Us Bank",,,06/17/2014,"Download from usbank.com. FRENCH MEADOW 32SALT LAKE CIUT","Everyday Expenses:Spending Money","Everyday Expenses","Spending Money",,$8.62,$0.00,C,$3236.32
"Us Bank",,,06/17/2014,"Download from usbank.com. SUBWAY        03PROVO       UT","Everyday Expenses:Spending Money","Everyday Expenses","Spending Money",,$8.62,$0.00,C,$3227.70
"Us Bank",,,06/17/2014,"Download from usbank.com. FRENCH MEADOW 32SALT LAKE CIUT","Everyday Expenses:Spending Money","Everyday Expenses","Spending Money",,$20.90,$0.00,C,$3206.80
"Us Bank",,,06/17/2014,"Download from usbank.com. VENMO           646-801-3023NY","Everyday Expenses:Spending Money","Everyday Expenses","Spending Money",,$56.00,$0.00,C,$3150.80
"Us Bank",,,06/17/2014,"Download from usbank.com. WHOLE FOODS MARKSan FranciscCA","Everyday Expenses:Groceries","Everyday Expenses","Groceries",,$63.87,$0.00,C,$3086.93
"Us Bank",,,06/17/2014,"Download from usbank.com. VENMO           646-801-3023NY","Everyday Expenses:Spending Money","Everyday Expenses","Spending Money",,$317.48,$0.00,C,$2769.45
"Us Bank",,,06/18/2014,"Download from usbank.com. SAJJ            MENLO PARK  CA","Everyday Expenses:Spending Money","Everyday Expenses","Spending Money",,$8.99,$0.00,C,$2760.46
"Us Bank",,,06/18/2014,"Download from usbank.com. PAYPAL","Monthly Bills:Web Stuff","Monthly Bills","Web Stuff",,$9.99,$0.00,C,$2750.47
"Us Bank",,,06/18/2014,"Download from usbank.com. SPRIG           415-894-5191CA","Everyday Expenses:Groceries","Everyday Expenses","Groceries",,$11.00,$0.00,C,$2739.47
"Us Bank",,,06/18/2014,"Download from usbank.com. VENMO           646-801-3023NY","Everyday Expenses:Spending Money","Everyday Expenses","Spending Money",,$67.47,$0.00,C,$2672.00
"Us Bank",,,06/19/2014,"Download from usbank.com. MODCLOTH INC.   888-4959699 CA","Everyday Expenses:Clothing","Everyday Expenses","Clothing",,$0.00,$67.45,C,$2739.45
"Us Bank",,,06/19/2014,"Download from usbank.com. CAPITAL ONE 360 SAN FRANCISCCA","Everyday Expenses:Spending Money","Everyday Expenses","Spending Money",,$1.50,$0.00,C,$2737.95
"Us Bank",,,06/19/2014,"Download from usbank.com. WP ENGINE INC   877-9736446 TX","Monthly Bills:Web Stuff","Monthly Bills","Web Stuff",,$4.00,$0.00,C,$2733.95
"Us Bank",,,06/19/2014,"Download from usbank.com. LYFT MON AT 858P855-865-9553CA","Everyday Expenses:Transportation","Everyday Expenses","Transportation",,$6.00,$0.00,C,$2727.95
"Us Bank",,,06/19/2014,"Download from usbank.com. SQ *SUBS ON HUBSSan FranciscCA","Everyday Expenses:Spending Money","Everyday Expenses","Spending Money",,$10.45,$0.00,C,$2717.50
"Us Bank",,,06/19/2014,"Download from usbank.com. WORKING GIRLS CASAN FRANCISCCA","Everyday Expenses:Spending Money","Everyday Expenses","Spending Money",,$10.68,$0.00,C,$2706.82
"Us Bank",,,06/19/2014,"Download from usbank.com. LYFT TUE AT 940A855-865-9553CA","Everyday Expenses:Transportation","Everyday Expenses","Transportation",,$12.00,$0.00,C,$2694.82
"Us Bank",,,06/19/2014,"Download from usbank.com. SPRIG           415-894-5191CA","Everyday Expenses:Groceries","Everyday Expenses","Groceries",,$22.00,$0.00,C,$2672.82
"Us Bank",,,06/19/2014,"Download from usbank.com. WALGREENS 500 GESAN FRANCISCCA","Everyday Expenses:Household Goods","Everyday Expenses","Household Goods",,$22.82,$0.00,C,$2650.00
"Us Bank",,,06/19/2014,"Download from usbank.com. ATT","Monthly Bills:Cell Phone","Monthly Bills","Cell Phone",,$226.00,$0.00,C,$2424.00
"Us Bank",,,06/20/2014,"Download from usbank.com. MODCLOTH INC","Income:Available this month","Income","Available this month",,$0.00,$1453.25,C,$3877.25
"Us Bank",,,06/20/2014,"Download from usbank.com. YELPINC*EAT24 HO415-908-3801CA","Everyday Expenses:Spending Money","Everyday Expenses","Spending Money",,$9.89,$0.00,C,$3867.36
"Us Bank",,,06/20/2014,"Download from usbank.com. PAYPAL","Monthly Bills:Internet","Monthly Bills","Internet",,$9.99,$0.00,C,$3857.37
"Us Bank",,,06/20/2014,"Download from usbank.com. LYFT THU AT 951P855-865-9553CA","Everyday Expenses:Transportation","Everyday Expenses","Transportation",,$13.00,$0.00,C,$3844.37
"Us Bank",,,06/20/2014,"Download from usbank.com. LYFT THU AT 606P855-865-9553CA","Everyday Expenses:Transportation","Everyday Expenses","Transportation",,$14.00,$0.00,C,$3830.37
"Us Bank",,,06/20/2014,"Download from usbank.com. VENMO","Everyday Expenses:Spending Money","Everyday Expenses","Spending Money",,$25.26,$0.00,C,$3805.11
"Us Bank",,,06/20/2014,"Download from usbank.com. FOOTLOCKER      800-9916815 WI","Everyday Expenses:Clothing","Everyday Expenses","Clothing",,$87.81,$0.00,C,$3717.30
"Us Bank",,,06/20/2014,"Download from usbank.com. BARCLAYS BANK DE","Savings Goals:Savings","Savings Goals","Savings",,$150.00,$0.00,C,$3567.30
"Us Bank",,,06/23/2014,"Download from usbank.com. VENMO","Everyday Expenses:Spending Money","Everyday Expenses","Spending Money",,$0.00,$35.00,C,$3602.30
"Us Bank",,,06/23/2014,"Download from usbank.com.","Income:Available this month","Income","Available this month",,$0.00,$6.95,C,$3609.25
"Us Bank",,,06/23/2014,"Download from usbank.com. JAMBA JUICE EX00SAN FRANCISCCA","Everyday Expenses:Spending Money","Everyday Expenses","Spending Money",,$4.89,$0.00,C,$3604.36
"Us Bank",,,06/23/2014,"Download from usbank.com. CHEVRON 00090030SAN FRANCISCCA","Everyday Expenses:Transportation","Everyday Expenses","Transportation",,$6.00,$0.00,C,$3598.36
"Us Bank",,,06/23/2014,"Download from usbank.com.","Income:Available this month","Income","Available this month",,$6.95,$0.00,C,$3591.41
"Us Bank",,,06/23/2014,"Download from usbank.com. FLY             SAN FRANCISCCA","Everyday Expenses:Groceries","Everyday Expenses","Groceries",,$9.97,$0.00,C,$3581.44
"Us Bank",,,06/23/2014,"Download from usbank.com. PAYPAL","Monthly Bills:Internet","Monthly Bills","Internet",,$9.99,$0.00,C,$3571.45
"Us Bank",,,06/23/2014,"Download from usbank.com. LIVINGSOCIAL*   202-695-8945DC","Everyday Expenses:Spending Money","Everyday Expenses","Spending Money",,$10.00,$0.00,C,$3561.45
"Us Bank",,,06/23/2014,"Download from usbank.com. SWEET WOODRUFF  SAN FRANCISCCA","Everyday Expenses:Spending Money","Everyday Expenses","Spending Money",,$10.33,$0.00,C,$3551.12
"Us Bank",,,06/23/2014,"Download from usbank.com. KASA INDIAN EATESAN FRANCISCCA","Everyday Expenses:Groceries","Everyday Expenses","Groceries",,$11.66,$0.00,C,$3539.46
"Us Bank",,,06/23/2014,"Download from usbank.com. SAMOVAR TEA LOUNSAN FRANCISCCA","Everyday Expenses:Spending Money","Everyday Expenses","Spending Money",,$16.35,$0.00,C,$3523.11
"Us Bank",,,06/23/2014,"Download from usbank.com. CORIANDER GOURMESAN FRANCISCCA","Everyday Expenses:Spending Money","Everyday Expenses","Spending Money",,$19.40,$0.00,C,$3503.71
"Us Bank",,,06/23/2014,"Download from usbank.com. DOMINOS 7764    SAN FRANCISCCA","Everyday Expenses:Spending Money","Everyday Expenses","Spending Money",,$20.64,$0.00,C,$3483.07
"Us Bank",,,06/23/2014,"Download from usbank.com. MACY'S      428 SAN FRANCISCCA","Everyday Expenses:Clothing","Everyday Expenses","Clothing",,$26.10,$0.00,C,$3456.97
"Us Bank",,,06/23/2014,"Download from usbank.com. WALGREENS 1300 BSAN FRANCISCCA","Everyday Expenses:Household Goods","Everyday Expenses","Household Goods",,$26.82,$0.00,C,$3430.15
"Us Bank",,,06/23/2014,"Download from usbank.com. AMC METREON 16 #SAN FRANCISCCA","Everyday Expenses:Spending Money","Everyday Expenses","Spending Money",,$33.00,$0.00,C,$3397.15
"Us Bank",,,06/23/2014,"Download from usbank.com. SQ *OLEA RESTAURSAN FRANCISCCA","Everyday Expenses:Groceries","Everyday Expenses","Groceries",,$37.22,$0.00,C,$3359.93
"Us Bank",,,06/23/2014,"Download from usbank.com. VENMO","Everyday Expenses:Spending Money","Everyday Expenses","Spending Money",,$48.00,$0.00,C,$3311.93
"Us Bank",,,06/23/2014,"Download from usbank.com. H&M             SAN FRANCISCCA","Everyday Expenses:Clothing","Everyday Expenses","Clothing",,$59.64,$0.00,C,$3252.29
"Us Bank",,,06/23/2014,"Download from usbank.com. SUDACHI         SAN FRANCISCCA","Everyday Expenses:Spending Money","Everyday Expenses","Spending Money",,$143.14,$0.00,C,$3109.15
"Us Bank",,,06/24/2014,"Download from usbank.com. PAYPAL","Monthly Bills:Internet","Monthly Bills","Internet",,$1.87,$0.00,C,$3107.28
"Us Bank",,,06/24/2014,"Download from usbank.com. CHIPOTLE 1857   SAN FRANCISCCA","Everyday Expenses:Groceries","Everyday Expenses","Groceries",,$8.05,$0.00,C,$3099.23
"Us Bank",,,06/24/2014,"Download from usbank.com. SQ *DOC'S OF THESan FranciscCA","Everyday Expenses:Spending Money","Everyday Expenses","Spending Money",,$11.97,$0.00,C,$3087.26
"Us Bank",,,06/24/2014,"Download from usbank.com. WHOLE FOODS MARKSan FranciscCA","Everyday Expenses:Groceries","Everyday Expenses","Groceries",,$175.43,$0.00,C,$2911.83
"Us Bank",,,06/24/2014,"Download from usbank.com. ERGO DEPOT LLC  503-477-7729OR","Savings Goals:House Stuff","Savings Goals","House Stuff",,$516.56,$0.00,C,$2395.27
"Us Bank",,,06/25/2014,"Download from usbank.com. ANGRAY FANTASTICSAN FRANCISCCA","Everyday Expenses:Spending Money","Everyday Expenses","Spending Money",,$4.46,$0.00,C,$2390.81
"Us Bank",,,06/25/2014,"Download from usbank.com. HLU*Hulu 2274453HULU.COM/BILCA","Monthly Bills:Web Stuff","Monthly Bills","Web Stuff",,$7.99,$0.00,C,$2382.82
"Us Bank",,,06/25/2014,"Download from usbank.com. WALGREENS 1300 BSAN FRANCISCCA","Everyday Expenses:Household Goods","Everyday Expenses","Household Goods",,$9.78,$0.00,C,$2373.04
"Us Bank",,,06/25/2014,"Download from usbank.com. STARBUCKS #05516San FranciscCA","Everyday Expenses:Spending Money","Everyday Expenses","Spending Money",,$10.00,$0.00,C,$2363.04
"Us Bank",,,06/25/2014,"Download from usbank.com. SUGAR CAFE      SAN FRANCISCCA","Everyday Expenses:Spending Money","Everyday Expenses","Spending Money",,$11.97,$0.00,C,$2351.07
"Us Bank",,,06/26/2014,"Download from usbank.com. SQ *SHOWPLACE CASan FranciscCA","Everyday Expenses:Spending Money","Everyday Expenses","Spending Money",,$2.75,$0.00,C,$2348.32
"Us Bank",,,06/26/2014,"Download from usbank.com. PAYPAL","Everyday Expenses:Transportation","Everyday Expenses","Transportation",,$7.33,$0.00,C,$2340.99
"Us Bank",,,06/26/2014,"Download from usbank.com. LYFT TUE AT 934A855-280-0278CA","Everyday Expenses:Transportation","Everyday Expenses","Transportation",,$8.00,$0.00,C,$2332.99
"Us Bank",,,06/26/2014,"Download from usbank.com. WALGREENS 1300 BSAN FRANCISCCA","Everyday Expenses:Household Goods","Everyday Expenses","Household Goods",,$15.96,$0.00,C,$2317.03
"Us Bank",,,06/27/2014,"Download from usbank.com. CAPITAL ONE 360 SAN FRANCISCCA","Everyday Expenses:Spending Money","Everyday Expenses","Spending Money",,$1.50,$0.00,C,$2315.53
"Us Bank",,,06/27/2014,"Download from usbank.com. SUTTER FINE FOODSAN FRANCISCCA","Everyday Expenses:Groceries","Everyday Expenses","Groceries",,$13.04,$0.00,C,$2302.49
"Us Bank",,,06/27/2014,"Download from usbank.com. THE GROVE-HAYES SAN FRANCISCCA","Everyday Expenses:Spending Money","Everyday Expenses","Spending Money",,$13.39,$0.00,C,$2289.10
"Us Bank",,,06/27/2014,"Download from usbank.com. PUBLIC BARBER SASAN FRANCISCCA","Everyday Expenses:Spending Money","Everyday Expenses","Spending Money",,$39.00,$0.00,C,$2250.10
"Us Bank",,,06/30/2014,"Download from usbank.com. SQWIGGLE INC","Income:Available this month","Income","Available this month",,$0.00,$1965.99,C,$4216.09
"Us Bank",,,06/30/2014,"Download from usbank.com. AMAZON DIG504244","Everyday Expenses:Spending Money","Everyday Expenses","Spending Money",,$0.00,$14.00,C,$4230.09
"Us Bank",,,06/30/2014,"Download from usbank.com. 062814PLUSTERMGCA* EXCALIBUR HLAS VEGAS   NVUS1","Everyday Expenses:Spending Money","Everyday Expenses","Spending Money",,$2.50,$0.00,C,$4227.59
"Us Bank",,,06/30/2014,"Download from usbank.com. EXCALIBUR CASTLELAS VEGAS   NV","Everyday Expenses:Spending Money","Everyday Expenses","Spending Money",,$5.92,$0.00,C,$4221.67
"Us Bank",,,06/30/2014,"Download from usbank.com. PAYPAL","Everyday Expenses:Spending Money","Everyday Expenses","Spending Money",,$10.00,$0.00,C,$4211.67
"Us Bank",,,06/30/2014,"Download from usbank.com. PAYPAL","Everyday Expenses:Spending Money","Everyday Expenses","Spending Money",,$12.42,$0.00,C,$4199.25
"Us Bank",,,06/30/2014,"Download from usbank.com. VIRGIN AMERICA  BURLINGAME  CA","Everyday Expenses:Spending Money","Everyday Expenses","Spending Money",,$13.50,$0.00,C,$4185.75
"Us Bank",,,06/30/2014,"Download from usbank.com. AIRLINE LIMOUSINLAS VEGAS   NV","Everyday Expenses:Transportation","Everyday Expenses","Transportation",,$16.00,$0.00,C,$4169.75
"Us Bank",,,06/30/2014,"Download from usbank.com. SFO PEET'S COFFESAN FRANCISCCA","Everyday Expenses:Spending Money","Everyday Expenses","Spending Money",,$16.73,$0.00,C,$4153.02
"Us Bank",,,06/30/2014,"Download from usbank.com. JOHNNY FOLEYS IRSAN FRANCISCCA","Everyday Expenses:Spending Money","Everyday Expenses","Spending Money",,$17.00,$0.00,C,$4136.02
"Us Bank",,,06/30/2014,"Download from usbank.com. BART-CIVIC CENTESAN FRANCISCCA","Everyday Expenses:Transportation","Everyday Expenses","Transportation",,$17.30,$0.00,C,$4118.72
"Us Bank",,,06/30/2014,"Download from usbank.com. BART-CLIPPER CIVSAN FRANCISCCA","Everyday Expenses:Transportation","Everyday Expenses","Transportation",,$20.00,$0.00,C,$4098.72
"Us Bank",,,06/30/2014,"Download from usbank.com. SPRIG           415-894-5191CA","Everyday Expenses:Groceries","Everyday Expenses","Groceries",,$20.00,$0.00,C,$4078.72
"Us Bank",,,06/30/2014,"Download from usbank.com. WALGREENS 1300 BSAN FRANCISCCA","Everyday Expenses:Household Goods","Everyday Expenses","Household Goods",,$21.73,$0.00,C,$4056.99
"Us Bank",,,06/30/2014,"Download from usbank.com. NY-NY HOTEL - POLAS VEGAS   NV","Everyday Expenses:Spending Money","Everyday Expenses","Spending Money",,$29.75,$0.00,C,$4027.24
"Us Bank",,,06/30/2014,"Download from usbank.com. EXCALIBUR DRENCHLAS VEGAS   NV","Everyday Expenses:Spending Money","Everyday Expenses","Spending Money",,$30.00,$0.00,C,$3997.24
"Us Bank",,,06/30/2014,"Download from usbank.com. BAJA FRESH      LAS VEGAS   NV","Everyday Expenses:Spending Money","Everyday Expenses","Spending Money",,$30.21,$0.00,C,$3967.03
"Us Bank",,,06/30/2014,"Download from usbank.com. MODCLOTH INC.   888-4959699 CA","Everyday Expenses:Clothing","Everyday Expenses","Clothing",,$76.99,$0.00,C,$3890.04
"Us Bank",,,06/30/2014,"Download from usbank.com. LUXOR PUBLIC HOULAS VEGAS   NV","Everyday Expenses:Spending Money","Everyday Expenses","Spending Money",,$80.00,$0.00,C,$3810.04
"Us Bank",,,06/30/2014,"Download from usbank.com. MGM GRAND GRDN BLAS VEGAS   NV","Everyday Expenses:Spending Money","Everyday Expenses","Spending Money",,$197.85,$0.00,C,$3612.19
"Us Bank",,,06/30/2014,"Download from usbank.com. GCA* EXCALIBUR HLAS VEGAS   NVUS1","Everyday Expenses:Spending Money","Everyday Expenses","Spending Money",,$305.99,$0.00,C,$3306.20
"Us Bank",,,07/01/2014,"Download from usbank.com. PAYPAL","Everyday Expenses:Spending Money","Everyday Expenses","Spending Money",,$5.00,$0.00,C,$3301.20
"Us Bank",,,07/01/2014,"Download from usbank.com. PAYPAL","Everyday Expenses:Spending Money","Everyday Expenses","Spending Money",,$6.98,$0.00,C,$3294.22
"Us Bank",,,07/01/2014,"Download from usbank.com. CHIPOTLE 1857   SAN FRANCISCCA","Everyday Expenses:Groceries","Everyday Expenses","Groceries",,$8.05,$0.00,C,$3286.17
"Us Bank",,,07/01/2014,"Download from usbank.com. EXCALIBUR  SPIRILAS VEGAS   NV","Everyday Expenses:Spending Money","Everyday Expenses","Spending Money",,$12.73,$0.00,C,$3273.44
"Us Bank",,,07/01/2014,"Download from usbank.com. MET CAS INS CO","Monthly Bills:Car Insurance","Monthly Bills","Car Insurance",,$49.00,$0.00,C,$3224.44
"Us Bank",,,07/01/2014,"Download from usbank.com. BARCLAYS BANK DE","Savings Goals:Savings","Savings Goals","Savings",,$150.00,$0.00,C,$3074.44
"Us Bank",,,07/02/2014,"Download from usbank.com. CHIPOTLE 1857   SAN FRANCISCCA","Everyday Expenses:Groceries","Everyday Expenses","Groceries",,$7.94,$0.00,C,$3066.50
"Us Bank",,,07/02/2014,"Download from usbank.com. DAILYBURN       888-867-8304NY","Monthly Bills:Web Stuff","Monthly Bills","Web Stuff",,$10.00,$0.00,C,$3056.50
"Us Bank",,,07/02/2014,"Download from usbank.com. WHOLE FOODS MARKSan FranciscCA","Everyday Expenses:Groceries","Everyday Expenses","Groceries",,$143.16,$0.00,C,$2913.34
"Us Bank",,,07/02/2014,"Download from usbank.com. Mosser Companies","Monthly Bills:Rent","Monthly Bills","Rent",,$1565.09,$0.00,C,$1348.25
"Us Bank",,,07/03/2014,"Download from usbank.com. MODCLOTH INC","Income:Available this month","Income","Available this month",,$0.00,$1453.24,C,$2801.49
"Us Bank",,,07/03/2014,"Download from usbank.com. 24 HOUR FITNESS SAN FRANCISCCA","Everyday Expenses:Spending Money","Everyday Expenses","Spending Money",,$5.50,$0.00,C,$2795.99
"Us Bank",,,07/03/2014,"Download from usbank.com. SQ *HIYAAA      San FranciscCA","Everyday Expenses:Spending Money","Everyday Expenses","Spending Money",,$13.00,$0.00,C,$2782.99
"Us Bank",,,07/03/2014,"Download from usbank.com. JASPERS CORNER TSAN FRANCISCCA","Everyday Expenses:Spending Money","Everyday Expenses","Spending Money",,$49.78,$0.00,C,$2733.21
"Us Bank",,,07/07/2014,"Download from usbank.com. 24 HOUR FITNESS SAN FRANCISCCA","Everyday Expenses:Spending Money","Everyday Expenses","Spending Money",,$4.62,$0.00,C,$2728.59
"Us Bank",,,07/07/2014,"Download from usbank.com. APL* ITUNES.COM/866-712-7753CA","Everyday Expenses:Spending Money","Everyday Expenses","Spending Money",,$5.94,$0.00,C,$2722.65
"Us Bank",,,07/07/2014,"Download from usbank.com. LYFT WED AT 809P855-280-0278CA","Everyday Expenses:Transportation","Everyday Expenses","Transportation",,$6.00,$0.00,C,$2716.65
"Us Bank",,,07/07/2014,"Download from usbank.com. LYFT SAT AT 1222855-280-0278CA","Everyday Expenses:Transportation","Everyday Expenses","Transportation",,$8.00,$0.00,C,$2708.65
"Us Bank",,,07/07/2014,"Download from usbank.com. PAYPAL","Everyday Expenses:Spending Money","Everyday Expenses","Spending Money",,$10.00,$0.00,C,$2698.65
"Us Bank",,,07/07/2014,"Download from usbank.com. SPRIG           415-894-5191CA","Everyday Expenses:Groceries","Everyday Expenses","Groceries",,$11.00,$0.00,C,$2687.65
"Us Bank",,,07/07/2014,"Download from usbank.com. PAYPAL","Everyday Expenses:Spending Money","Everyday Expenses","Spending Money",,$11.63,$0.00,C,$2676.02
"Us Bank",,,07/07/2014,"Download from usbank.com. SUDACHI         SAN FRANCISCCA","Everyday Expenses:Spending Money","Everyday Expenses","Spending Money",,$21.13,$0.00,C,$2654.89
"Us Bank",,,07/07/2014,"Download from usbank.com. DARBAR CUISINE ISAN FRANCISCCA","Everyday Expenses:Spending Money","Everyday Expenses","Spending Money",,$26.02,$0.00,C,$2628.87
"Us Bank",,,07/07/2014,"Download from usbank.com. WALGREENS 1300 BSAN FRANCISCCA","Everyday Expenses:Household Goods","Everyday Expenses","Household Goods",,$27.18,$0.00,C,$2601.69
"Us Bank",,,07/07/2014,"Download from usbank.com. WALGREENS 1300 BSAN FRANCISCCA","Everyday Expenses:Household Goods","Everyday Expenses","Household Goods",,$73.28,$0.00,C,$2528.41
"Us Bank",,,07/07/2014,"Download from usbank.com. WHOLE FOODS MARKSan FranciscCA","Everyday Expenses:Groceries","Everyday Expenses","Groceries",,$110.87,$0.00,C,$2417.54
"Us Bank",,,07/07/2014,"Download from usbank.com. BARCLAYS BANK DE","Savings Goals:Savings","Savings Goals","Savings",,$150.00,$0.00,C,$2267.54
"Us Bank",,,07/08/2014,"Download from usbank.com. PAYPAL","Everyday Expenses:Transportation","Everyday Expenses","Transportation",,$5.00,$0.00,C,$2262.54
"Us Bank",,,07/08/2014,"Download from usbank.com. Chile Pies & IceSAN FRANCISCCA","Everyday Expenses:Spending Money","Everyday Expenses","Spending Money",,$5.64,$0.00,C,$2256.90
"Us Bank",,,07/08/2014,"Download from usbank.com. LYFT SUN AT 1059855-280-0278CA","Everyday Expenses:Transportation","Everyday Expenses","Transportation",,$8.00,$0.00,C,$2248.90
"Us Bank",,,07/08/2014,"Download from usbank.com. SQ *DOC'S OF THESan FranciscCA","Everyday Expenses:Spending Money","Everyday Expenses","Spending Money",,$11.95,$0.00,C,$2236.95
"Us Bank",,,07/08/2014,"Download from usbank.com. Chile Pies & IceSAN FRANCISCCA","Everyday Expenses:Spending Money","Everyday Expenses","Spending Money",,$14.66,$0.00,C,$2222.29
"Us Bank",,,07/08/2014,"Download from usbank.com. HOWABOUTWE.COM  718-310-3363NY","Everyday Expenses:Spending Money","Everyday Expenses","Spending Money",,$18.00,$0.00,C,$2204.29
"Us Bank",,,07/08/2014,"Download from usbank.com. 7246","Debt:Eric's Credit Card","Debt","Eric's Credit Card",,$200.00,$0.00,C,$2004.29
"Us Bank",,,07/09/2014,"Download from usbank.com. USPS 0568050007 SAN FRANCISCCA","Everyday Expenses:Spending Money","Everyday Expenses","Spending Money",,$5.60,$0.00,C,$1998.69
"Us Bank",,,07/09/2014,"Download from usbank.com. LATTE EXPRESS 4 SAN FRANCISCCA","Everyday Expenses:Spending Money","Everyday Expenses","Spending Money",,$10.77,$0.00,C,$1987.92
"Us Bank",,,07/09/2014,"Download from usbank.com. MODCLOTH INC.   888-4959699 CA","Everyday Expenses:Clothing","Everyday Expenses","Clothing",,$45.77,$0.00,C,$1942.15
"Us Bank",,,07/10/2014,"Download from usbank.com. PAYPAL","Everyday Expenses:Transportation","Everyday Expenses","Transportation",,$5.00,$0.00,C,$1937.15
"Us Bank",,,07/10/2014,"Download from usbank.com. SPRIG           415-894-5191CA","Everyday Expenses:Groceries","Everyday Expenses","Groceries",,$22.00,$0.00,C,$1915.15
"Us Bank",,,07/10/2014,"Download from usbank.com. CARDMEMBER SERV",,,,,$34.00,$0.00,C,$1881.15
"Us Bank",,,07/10/2014,"Download from usbank.com. SONGBIRD STUDIOSSAN FRANCISCCA","Everyday Expenses:Spending Money","Everyday Expenses","Spending Money",,$240.00,$0.00,C,$1641.15
"Us Bank",,,07/11/2014,"Download from usbank.com. SPRIG           4158945191  CA","Everyday Expenses:Groceries","Everyday Expenses","Groceries",,$0.00,$22.00,C,$1663.15
"Us Bank",,,07/11/2014,"Download from usbank.com. SPRIG           415-894-5191CA","Everyday Expenses:Groceries","Everyday Expenses","Groceries",,$11.00,$0.00,C,$1652.15
"Us Bank",,,07/11/2014,"Download from usbank.com. TRADER JOE'S #20SAN FRANCISCCA","Everyday Expenses:Groceries","Everyday Expenses","Groceries",,$37.60,$0.00,C,$1614.55
"Us Bank",,,07/14/2014,"Download from usbank.com. WP ENGINE INC   877-9736446 TX","Monthly Bills:Web Stuff","Monthly Bills","Web Stuff",,$0.00,$4.00,C,$1618.55
"Us Bank",,,07/14/2014,"Download from usbank.com. SPRIG           415-894-5191CA","Everyday Expenses:Groceries","Everyday Expenses","Groceries",,$11.00,$0.00,C,$1607.55
"Us Bank",,,07/14/2014,"Download from usbank.com. CVS #10080      SAN FRANCISCCA","Everyday Expenses:Household Goods","Everyday Expenses","Household Goods",,$11.41,$0.00,C,$1596.14
"Us Bank",,,07/14/2014,"Download from usbank.com. SQ *KOREAN BOBCHSan FranciscCA","Everyday Expenses:Spending Money","Everyday Expenses","Spending Money",,$11.69,$0.00,C,$1584.45
"Us Bank",,,07/14/2014,"Download from usbank.com. LYFT SAT AT 329P855-280-0278CA","Everyday Expenses:Transportation","Everyday Expenses","Transportation",,$12.00,$0.00,C,$1572.45
"Us Bank",,,07/14/2014,"Download from usbank.com. SQ *JOY'S PLACE San FranciscCA","Everyday Expenses:Spending Money","Everyday Expenses","Spending Money",,$22.40,$0.00,C,$1550.05
"Us Bank",,,07/14/2014,"Download from usbank.com. FANDANGO.COM    FANDANGO.COMCA","Everyday Expenses:Spending Money","Everyday Expenses","Spending Money",,$24.50,$0.00,C,$1525.55
"Us Bank",,,07/14/2014,"Download from usbank.com. WHOLE FOODS MARKSan FranciscCA","Everyday Expenses:Groceries","Everyday Expenses","Groceries",,$24.68,$0.00,C,$1500.87
"Us Bank",,,07/14/2014,"Download from usbank.com. SUTTER FINE FOODSAN FRANCISCCA","Everyday Expenses:Groceries","Everyday Expenses","Groceries",,$26.88,$0.00,C,$1473.99
"Us Bank",,,07/14/2014,"Download from usbank.com. NOB HILL GRILLE SAN FRANCISCCA","Everyday Expenses:Spending Money","Everyday Expenses","Spending Money",,$30.00,$0.00,C,$1443.99
"Us Bank",,,07/14/2014,"Download from usbank.com. EB *2014 PHONO DEVENTBRITE  CA","Everyday Expenses:Spending Money","Everyday Expenses","Spending Money",,$54.48,$0.00,C,$1389.51
"Us Bank",,,07/14/2014,"Download from usbank.com. GUITAR CENTER #2SAN FRANCISCCA","Everyday Expenses:Spending Money","Everyday Expenses","Spending Money",,$217.49,$0.00,C,$1172.02
"Us Bank",,,07/14/2014,"Download from usbank.com. 7246","Debt:Eric's Credit Card","Debt","Eric's Credit Card",,$300.00,$0.00,C,$872.02
"Us Bank",,,07/15/2014,"Download from usbank.com. SQWIGGLE INC","Income:Available this month","Income","Available this month",,$0.00,$1965.99,C,$2838.01
"Us Bank",,,07/15/2014,"Download from usbank.com. PAYPAL","Everyday Expenses:Spending Money","Everyday Expenses","Spending Money",,$5.00,$0.00,C,$2833.01
"Us Bank",,,07/15/2014,"Download from usbank.com. CHIPOTLE 1857   SAN FRANCISCCA","Everyday Expenses:Groceries","Everyday Expenses","Groceries",,$7.56,$0.00,C,$2825.45
"Us Bank",,,07/15/2014,"Download from usbank.com. TRADER JOE'S #20SAN FRANCISCCA","Everyday Expenses:Groceries","Everyday Expenses","Groceries",,$59.98,$0.00,C,$2765.47
"Us Bank",,,07/15/2014,"Download from usbank.com. BARCLAYS BANK DE","Savings Goals:Savings","Savings Goals","Savings",,$150.00,$0.00,C,$2615.47
"Us Bank",,,07/16/2014,"Download from usbank.com. CUP A JOES COFFESAN FRANCISCCA","Everyday Expenses:Spending Money","Everyday Expenses","Spending Money",,$6.00,$0.00,C,$2609.47
"Us Bank",,,07/16/2014,"Download from usbank.com. CHIPOTLE 1857   SAN FRANCISCCA","Everyday Expenses:Groceries","Everyday Expenses","Groceries",,$7.56,$0.00,C,$2601.91
"Us Bank",,,07/16/2014,"Download from usbank.com. LYFT TUE AT 936A855-280-0278CA","Everyday Expenses:Spending Money","Everyday Expenses","Spending Money",,$10.00,$0.00,C,$2591.91
"Us Bank",,,07/16/2014,"Download from usbank.com. SAM'S CHOWDER MOHALF MOON BACA","Everyday Expenses:Spending Money","Everyday Expenses","Spending Money",,$11.00,$0.00,C,$2580.91
"Us Bank",,,07/17/2014,"Download from usbank.com. PAYPAL","Everyday Expenses:Spending Money","Everyday Expenses","Spending Money",,$5.00,$0.00,C,$2575.91
"Us Bank",,,07/17/2014,"Download from usbank.com. SQ *KASA INDIAN San FranciscCA","Everyday Expenses:Spending Money","Everyday Expenses","Spending Money",,$9.51,$0.00,C,$2566.40
"Us Bank",,,07/17/2014,"Download from usbank.com. SPRIG           415-894-5191CA","Everyday Expenses:Groceries","Everyday Expenses","Groceries",,$12.00,$0.00,C,$2554.40
"Us Bank",,,07/17/2014,"Download from usbank.com. THE IRON CACTUS SAN FRANCISCCA","Everyday Expenses:Spending Money","Everyday Expenses","Spending Money",,$13.65,$0.00,C,$2540.75
"Us Bank",,,07/17/2014,"Download from usbank.com. WALGREENS 1300 BSAN FRANCISCCA","Everyday Expenses:Household Goods","Everyday Expenses","Household Goods",,$20.96,$0.00,C,$2519.79
"Us Bank",,,07/17/2014,"Download from usbank.com. RESTAURANT LULU SAN FRANCISCCA","Everyday Expenses:Spending Money","Everyday Expenses","Spending Money",,$33.26,$0.00,C,$2486.53
"Us Bank",,,07/18/2014,"Download from usbank.com. MODCLOTH INC","Income:Available this month","Income","Available this month",,$0.00,$1453.26,C,$3939.79
"Us Bank",,,07/18/2014,"Download from usbank.com. PAYPAL","Monthly Bills:Web Stuff","Monthly Bills","Web Stuff",,$9.99,$0.00,C,$3929.80
"Us Bank",,,07/18/2014,"Download from usbank.com. SPRIG           415-894-5191CA","Everyday Expenses:Groceries","Everyday Expenses","Groceries",,$12.00,$0.00,C,$3917.80
"Us Bank",,,07/18/2014,"Download from usbank.com. URBAN-OUTFITTERS972-550-2751PA","Savings Goals:House Stuff","Savings Goals","House Stuff",,$326.24,$0.00,C,$3591.56
"Us Bank",,,07/21/2014,"Download from usbank.com. VENMO","Everyday Expenses:Spending Money","Everyday Expenses","Spending Money",,$0.00,$26.00,C,$3617.56
"Us Bank",,,07/21/2014,"Download from usbank.com. THE CHIEFTAIN IRSAN FRANCISCCA","Everyday Expenses:Spending Money","Everyday Expenses","Spending Money",,$8.25,$0.00,C,$3609.31
"Us Bank",,,07/21/2014,"Download from usbank.com. GROUPON INC     877-788-7858IL","Everyday Expenses:Spending Money","Everyday Expenses","Spending Money",,$9.75,$0.00,C,$3599.56
"Us Bank",,,07/21/2014,"Download from usbank.com. THE IRON CACTUS SAN FRANCISCCA","Everyday Expenses:Spending Money","Everyday Expenses","Spending Money",,$9.79,$0.00,C,$3589.77
"Us Bank",,,07/21/2014,"Download from usbank.com. PAYPAL","Monthly Bills:Web Stuff","Monthly Bills","Web Stuff",,$9.99,$0.00,C,$3579.78
"Us Bank",,,07/21/2014,"Download from usbank.com. PAYPAL","Everyday Expenses:Spending Money","Everyday Expenses","Spending Money",,$10.00,$0.00,C,$3569.78
"Us Bank",,,07/21/2014,"Download from usbank.com. SUTTER FINE FOODSAN FRANCISCCA","Everyday Expenses:Groceries","Everyday Expenses","Groceries",,$11.19,$0.00,C,$3558.59
"Us Bank",,,07/21/2014,"Download from usbank.com. WALGREENS 1300 BSAN FRANCISCCA","Everyday Expenses:Household Goods","Everyday Expenses","Household Goods",,$20.72,$0.00,C,$3537.87
"Us Bank",,,07/21/2014,"Download from usbank.com. WALGREENS 500 GESAN FRANCISCCA","Everyday Expenses:Household Goods","Everyday Expenses","Household Goods",,$26.30,$0.00,C,$3511.57
"Us Bank",,,07/21/2014,"Download from usbank.com. SUTTER FINE FOODSAN FRANCISCCA","Everyday Expenses:Groceries","Everyday Expenses","Groceries",,$30.44,$0.00,C,$3481.13
"Us Bank",,,07/21/2014,"Download from usbank.com. MYMY COFFEE SHOPSAN FRANCISCCA","Everyday Expenses:Spending Money","Everyday Expenses","Spending Money",,$35.27,$0.00,C,$3445.86
"Us Bank",,,07/21/2014,"Download from usbank.com. WAYO SUSHI      SAN FRANCISCCA","Everyday Expenses:Spending Money","Everyday Expenses","Spending Money",,$67.26,$0.00,C,$3378.60
"Us Bank",,,07/21/2014,"Download from usbank.com. MODCLOTH INC.   888-4959699 CA","Everyday Expenses:Clothing","Everyday Expenses","Clothing",,$81.62,$0.00,C,$3296.98
"Us Bank",,,07/21/2014,"Download from usbank.com. BARCLAYS BANK DE","Savings Goals:Savings","Savings Goals","Savings",,$150.00,$0.00,C,$3146.98
"Us Bank",,,07/21/2014,"Download from usbank.com. ATT","Monthly Bills:Cell Phone","Monthly Bills","Cell Phone",,$225.81,$0.00,C,$2921.17
"Us Bank",,,07/22/2014,"Download from usbank.com. VENMO","Everyday Expenses:Spending Money","Everyday Expenses","Spending Money",,$0.75,$0.00,C,$2920.42
"Us Bank",,,07/22/2014,"Download from usbank.com. PAYPAL","Everyday Expenses:Spending Money","Everyday Expenses","Spending Money",,$5.00,$0.00,C,$2915.42
"Us Bank",,,07/22/2014,"Download from usbank.com. CHIPOTLE 1857   SAN FRANCISCCA","Everyday Expenses:Groceries","Everyday Expenses","Groceries",,$7.56,$0.00,C,$2907.86
"Us Bank",,,07/22/2014,"Download from usbank.com. BELLISSIMO PIZZASAN FRANCISCCA","Everyday Expenses:Spending Money","Everyday Expenses","Spending Money",,$8.50,$0.00,C,$2899.36
"Us Bank",,,07/22/2014,"Download from usbank.com. AMC VAN NESS 14 SAN FRANCISCCA","Everyday Expenses:Spending Money","Everyday Expenses","Spending Money",,$11.00,$0.00,C,$2888.36
"Us Bank",,,07/22/2014,"Download from usbank.com. PICNIC          SAN FRANCISCCA","Everyday Expenses:Household Goods","Everyday Expenses","Household Goods",,$17.94,$0.00,C,$2870.42
"Us Bank",,,07/22/2014,"Download from usbank.com. CUP A JOES COFFESAN FRANCISCCA","Everyday Expenses:Spending Money","Everyday Expenses","Spending Money",,$19.03,$0.00,C,$2851.39
"Us Bank",,,07/22/2014,"Download from usbank.com. SPRIG           415-894-5191CA","Everyday Expenses:Groceries","Everyday Expenses","Groceries",,$22.00,$0.00,C,$2829.39
"Us Bank",,,07/22/2014,"Download from usbank.com. NNT COLE HARDWARSAN FRANCISCCA","Everyday Expenses:Spending Money","Everyday Expenses","Spending Money",,$34.78,$0.00,C,$2794.61
"Us Bank",,,07/22/2014,"Download from usbank.com. NARA SUSHI      SAN FRANCISCCA","Everyday Expenses:Spending Money","Everyday Expenses","Spending Money",,$35.29,$0.00,C,$2759.32
"Us Bank",,,07/23/2014,"Download from usbank.com.","Income:Available this month","Income","Available this month",,$0.00,$6.95,C,$2766.27
"Us Bank",,,07/23/2014,"Download from usbank.com. CAPITAL ONE 360 SAN FRANCISCCA","Everyday Expenses:Spending Money","Everyday Expenses","Spending Money",,$1.50,$0.00,C,$2764.77
"Us Bank",,,07/23/2014,"Download from usbank.com.","Income:Available this month","Income","Available this month",,$6.95,$0.00,C,$2757.82
"Us Bank",,,07/23/2014,"Download from usbank.com. BLUE FOG MARKETSSAN FRANCISCCA","Everyday Expenses:Groceries","Everyday Expenses","Groceries",,$8.15,$0.00,C,$2749.67
"Us Bank",,,07/23/2014,"Download from usbank.com. PAYPAL","Monthly Bills:Web Stuff","Monthly Bills","Web Stuff",,$9.99,$0.00,C,$2739.68
"Us Bank",,,07/23/2014,"Download from usbank.com. DARWIN CAFE LLC SAN FRANCISCCA","Everyday Expenses:Spending Money","Everyday Expenses","Spending Money",,$11.00,$0.00,C,$2728.68
"Us Bank",,,07/23/2014,"Download from usbank.com. SPRIG           415-894-5191CA","Everyday Expenses:Groceries","Everyday Expenses","Groceries",,$22.00,$0.00,C,$2706.68
"Us Bank",,,07/23/2014,"Download from usbank.com. ROBERT PURCHASE SAN FRANCISCCA","Everyday Expenses:Medical","Everyday Expenses","Medical",,$25.00,$0.00,C,$2681.68
"Us Bank",,,07/23/2014,"Download from usbank.com. Amazon.com      AMZN.COM/BILWA","Everyday Expenses:Spending Money","Everyday Expenses","Spending Money",,$32.31,$0.00,C,$2649.37
"Us Bank",,,07/23/2014,"Download from usbank.com. WHOLE FOODS MARKSan FranciscCA","Everyday Expenses:Groceries","Everyday Expenses","Groceries",,$61.58,$0.00,C,$2587.79
"Us Bank",,,07/24/2014,"Download from usbank.com. PAYPAL","Everyday Expenses:Spending Money","Everyday Expenses","Spending Money",,$5.00,$0.00,C,$2582.79
"Us Bank",,,07/24/2014,"Download from usbank.com. CHIPOTLE 1857   SAN FRANCISCCA","Everyday Expenses:Groceries","Everyday Expenses","Groceries",,$7.56,$0.00,C,$2575.23
"Us Bank",,,07/24/2014,"Download from usbank.com. CAFE MADELEINE -SAN FRANCISCCA","Everyday Expenses:Spending Money","Everyday Expenses","Spending Money",,$8.65,$0.00,C,$2566.58
"Us Bank",,,07/24/2014,"Download from usbank.com. VENMO           855-812-4430NY","Everyday Expenses:Spending Money","Everyday Expenses","Spending Money",,$20.00,$0.00,C,$2546.58
"Us Bank",,,07/24/2014,"Download from usbank.com. TECHSHOP SOMA   800-6401975 CA",,,,,$150.00,$0.00,C,$2396.58
"Us Bank",,,07/25/2014,"Download from usbank.com. HLU*Hulu 2274453HULU.COM/BILCA","Monthly Bills:Web Stuff","Monthly Bills","Web Stuff",,$7.99,$0.00,C,$2388.59
"Us Bank",,,07/25/2014,"Download from usbank.com. VENMO           855-812-4430NY","Everyday Expenses:Spending Money","Everyday Expenses","Spending Money",,$8.00,$0.00,C,$2380.59
"Us Bank",,,07/25/2014,"Download from usbank.com. SQ *JOY'S PLACE San FranciscCA","Everyday Expenses:Spending Money","Everyday Expenses","Spending Money",,$11.24,$0.00,C,$2369.35
"Us Bank",,,07/25/2014,"Download from usbank.com. WALGREENS 141 KESAN FRANCISCCA","Everyday Expenses:Household Goods","Everyday Expenses","Household Goods",,$11.66,$0.00,C,$2357.69
"Us Bank",,,07/25/2014,"Download from usbank.com. SANRAKU RESTAURASAN FRANCISCCA","Everyday Expenses:Spending Money","Everyday Expenses","Spending Money",,$72.35,$0.00,C,$2285.34
"Us Bank",,,07/28/2014,"Download from usbank.com. BLUE FOG MARKETSSAN FRANCISCCA","Everyday Expenses:Groceries","Everyday Expenses","Groceries",,$5.42,$0.00,C,$2279.92
"Us Bank",,,07/28/2014,"Download from usbank.com. JAMBA JUICE #91 SAN FRANCISCCA","Everyday Expenses:Spending Money","Everyday Expenses","Spending Money",,$5.69,$0.00,C,$2274.23
"Us Bank",,,07/28/2014,"Download from usbank.com. SUNDANCE KBB    SAN FRANCISCCA","Everyday Expenses:Spending Money","Everyday Expenses","Spending Money",,$9.79,$0.00,C,$2264.44
"Us Bank",,,07/28/2014,"Download from usbank.com. PAYPAL","Everyday Expenses:Spending Money","Everyday Expenses","Spending Money",,$10.00,$0.00,C,$2254.44
"Us Bank",,,07/28/2014,"Download from usbank.com. BITE            SAN FRANCISCCA","Everyday Expenses:Spending Money","Everyday Expenses","Spending Money",,$10.76,$0.00,C,$2243.68
"Us Bank",,,07/28/2014,"Download from usbank.com. GRUBSTAKE INC   SAN FRANCISCCA","Everyday Expenses:Spending Money","Everyday Expenses","Spending Money",,$14.78,$0.00,C,$2228.90
"Us Bank",,,07/28/2014,"Download from usbank.com. AMAZON MKTPLACE AMZN.COM/BILWA","Everyday Expenses:Spending Money","Everyday Expenses","Spending Money",,$23.38,$0.00,C,$2205.52
"Us Bank",,,07/28/2014,"Download from usbank.com. SPIRO COFFEE    SAN FRANCISCCA","Everyday Expenses:Spending Money","Everyday Expenses","Spending Money",,$24.65,$0.00,C,$2180.87
"Us Bank",,,07/28/2014,"Download from usbank.com. ONE MEDICAL GROUSAN FRANCISCCA","Everyday Expenses:Medical","Everyday Expenses","Medical",,$25.00,$0.00,C,$2155.87
"Us Bank",,,07/28/2014,"Download from usbank.com. TRADER JOE'S #20SAN FRANCISCCA","Everyday Expenses:Groceries","Everyday Expenses","Groceries",,$30.98,$0.00,C,$2124.89
"Us Bank",,,07/28/2014,"Download from usbank.com. BAR NONE        SAN FRANCISCCA","Everyday Expenses:Spending Money","Everyday Expenses","Spending Money",,$48.00,$0.00,C,$2076.89
"Us Bank",,,07/28/2014,"Download from usbank.com. VENMO           855-812-4430NY","Everyday Expenses:Spending Money","Everyday Expenses","Spending Money",,$50.00,$0.00,C,$2026.89
"Us Bank",,,07/28/2014,"Download from usbank.com. BEAUTIFIED SKIN SAN FRANCISCCA","Everyday Expenses:Spending Money","Everyday Expenses","Spending Money",,$65.00,$0.00,C,$1961.89
"Us Bank",,,07/28/2014,"Download from usbank.com. INT*GOLDEN GATE SAN FRANCISCCA","Everyday Expenses:Medical","Everyday Expenses","Medical",,$80.00,$0.00,C,$1881.89
"Us Bank",,,07/28/2014,"Download from usbank.com. URBAN-OUTFITTERS972-550-2751PA","Savings Goals:House Stuff","Savings Goals","House Stuff",,$162.68,$0.00,C,$1719.21
"Us Bank",,,07/29/2014,"Download from usbank.com. CAPITAL ONE 360 SAN FRANCISCCA","Everyday Expenses:Spending Money","Everyday Expenses","Spending Money",,$1.50,$0.00,C,$1717.71
"Us Bank",,,07/29/2014,"Download from usbank.com. PAYPAL","Everyday Expenses:Spending Money","Everyday Expenses","Spending Money",,$5.00,$0.00,C,$1712.71
"Us Bank",,,07/29/2014,"Download from usbank.com. CHIPOTLE 1857   SAN FRANCISCCA","Everyday Expenses:Groceries","Everyday Expenses","Groceries",,$7.56,$0.00,C,$1705.15
"Us Bank",,,07/29/2014,"Download from usbank.com. CVS 10080       SAN FRANCISCCA","Everyday Expenses:Household Goods","Everyday Expenses","Household Goods",,$13.25,$0.00,C,$1691.90
"Us Bank",,,07/29/2014,"Download from usbank.com. AMC METREON 16 #SAN FRANCISCCA","Everyday Expenses:Spending Money","Everyday Expenses","Spending Money",,$22.50,$0.00,C,$1669.40
"Us Bank",,,07/29/2014,"Download from usbank.com. TRADER JOE'S #20SAN FRANCISCCA","Everyday Expenses:Groceries","Everyday Expenses","Groceries",,$86.06,$0.00,C,$1583.34
"Us Bank",,,07/30/2014,"Download from usbank.com. AMAZON DIG513214","Everyday Expenses:Spending Money","Everyday Expenses","Spending Money",,$0.00,$8.45,C,$1591.79
"Us Bank",,,07/30/2014,"Download from usbank.com. CHIPOTLE 1857   SAN FRANCISCCA","Everyday Expenses:Groceries","Everyday Expenses","Groceries",,$7.56,$0.00,C,$1584.23
"Us Bank",,,07/30/2014,"Download from usbank.com. FLYWHEEL SOFTWARFLYWHEEL.COMCA","Everyday Expenses:Spending Money","Everyday Expenses","Spending Money",,$8.12,$0.00,C,$1576.11
"Us Bank",,,07/30/2014,"Download from usbank.com. SUTTER FINE FOODSAN FRANCISCCA","Everyday Expenses:Groceries","Everyday Expenses","Groceries",,$32.39,$0.00,C,$1543.72
"Us Bank",,,07/31/2014,"Download from usbank.com. SQWIGGLE INC","Income:Available this month","Income","Available this month",,$0.00,$1965.99,C,$3509.71
"Us Bank",,,07/31/2014,"Download from usbank.com. Apple","Everyday Expenses:Spending Money","Everyday Expenses","Spending Money",,$0.00,$11.59,C,$3521.30
"Us Bank",,,07/31/2014,"Download from usbank.com. VENMO","Everyday Expenses:Spending Money","Everyday Expenses","Spending Money",,$0.00,$10.25,C,$3531.55
"Us Bank",,,07/31/2014,"Download from usbank.com. SQ *WORKSHOP CAFSan FranciscCA","Everyday Expenses:Spending Money","Everyday Expenses","Spending Money",,$4.00,$0.00,C,$3527.55
"Us Bank",,,07/31/2014,"Download from usbank.com. PAYPAL","Everyday Expenses:Spending Money","Everyday Expenses","Spending Money",,$5.00,$0.00,C,$3522.55
"Us Bank",,,07/31/2014,"Download from usbank.com. WORKING GIRLS CASAN FRANCISCCA","Everyday Expenses:Spending Money","Everyday Expenses","Spending Money",,$9.73,$0.00,C,$3512.82
"Us Bank",,,07/31/2014,"Download from usbank.com. WALGREENS 1300 BSAN FRANCISCCA","Everyday Expenses:Household Goods","Everyday Expenses","Household Goods",,$12.79,$0.00,C,$3500.03
"Us Bank",,,08/01/2014,"Download from usbank.com. MODCLOTH INC","Income:Available this month","Income","Available this month",,$0.00,$1453.24,C,$4953.27
"Us Bank",,,08/01/2014,"Download from usbank.com. SQ *ANOTHER CAFESan FranciscCA","Everyday Expenses:Spending Money","Everyday Expenses","Spending Money",,$8.65,$0.00,C,$4944.62
"Us Bank",,,08/01/2014,"Download from usbank.com. MET CAS INS CO","Monthly Bills:Car Insurance","Monthly Bills","Car Insurance",,$49.00,$0.00,C,$4895.62
"Us Bank",,,08/01/2014,"Download from usbank.com. BARCLAYS BANK DE","Savings Goals:Savings","Savings Goals","Savings",,$150.00,$0.00,C,$4745.62
"Us Bank",,,08/04/2014,"Download from usbank.com. SUGAR CAFE      SAN FRANCISCCA","Everyday Expenses:Spending Money","Everyday Expenses","Spending Money",,$9.00,$0.00,C,$4736.62
"Us Bank",,,08/04/2014,"Download from usbank.com. SPIRO COFFEE    SAN FRANCISCCA","Everyday Expenses:Spending Money","Everyday Expenses","Spending Money",,$9.85,$0.00,C,$4726.77
"Us Bank",,,08/04/2014,"Download from usbank.com. DAILYBURN       888-867-8304NY","Monthly Bills:Web Stuff","Monthly Bills","Web Stuff",,$10.00,$0.00,C,$4716.77
"Us Bank",,,08/04/2014,"Download from usbank.com. CB2 #53         SAN FRANCISCCA","Savings Goals:House Stuff","Savings Goals","House Stuff",,$12.90,$0.00,C,$4703.87
"Us Bank",,,08/04/2014,"Download from usbank.com. CHIPOTLE 1230   SAN FRANCISCCA","Everyday Expenses:Spending Money","Everyday Expenses","Spending Money",,$15.71,$0.00,C,$4688.16
"Us Bank",,,08/04/2014,"Download from usbank.com. TARGET T2766    SAN FRANCISCCA","Savings Goals:House Stuff","Savings Goals","House Stuff",,$16.82,$0.00,C,$4671.34
"Us Bank",,,08/04/2014,"Download from usbank.com. WALGREENS 1300 BSAN FRANCISCCA","Everyday Expenses:Household Goods","Everyday Expenses","Household Goods",,$20.08,$0.00,C,$4651.26
"Us Bank",,,08/04/2014,"Download from usbank.com. BOUDIN MACYS 424SAN FRANCISCCA","Everyday Expenses:Spending Money","Everyday Expenses","Spending Money",,$20.96,$0.00,C,$4630.30
"Us Bank",,,08/04/2014,"Download from usbank.com. NARA SUSHI      SAN FRANCISCCA","Everyday Expenses:Spending Money","Everyday Expenses","Spending Money",,$22.46,$0.00,C,$4607.84
"Us Bank",,,08/04/2014,"Download from usbank.com. MIZU SPA        SAN FRANCISCCA","Everyday Expenses:Spending Money","Everyday Expenses","Spending Money",,$25.00,$0.00,C,$4582.84
"Us Bank",,,08/04/2014,"Download from usbank.com. SAFEWAY  STORE  SUNNYVALE   CA","Everyday Expenses:Groceries","Everyday Expenses","Groceries",,$26.50,$0.00,C,$4556.34
"Us Bank",,,08/04/2014,"Download from usbank.com. SO RESTAURANT   SAN FRANCISCCA","Everyday Expenses:Spending Money","Everyday Expenses","Spending Money",,$30.55,$0.00,C,$4525.79
"Us Bank",,,08/04/2014,"Download from usbank.com. CONTAINERSTORESASAN FRANCISCCA","Savings Goals:House Stuff","Savings Goals","House Stuff",,$32.61,$0.00,C,$4493.18
"Us Bank",,,08/04/2014,"Download from usbank.com. SAFEWAY  STORE  SUNNYVALE   CA","Everyday Expenses:Spending Money","Everyday Expenses","Spending Money",,$41.55,$0.00,C,$4451.63
"Us Bank",,,08/04/2014,"Download from usbank.com. DISTRICT        SAN FRANCISCCA","Everyday Expenses:Spending Money","Everyday Expenses","Spending Money",,$46.60,$0.00,C,$4405.03
"Us Bank",,,08/04/2014,"Download from usbank.com. INT*GOLDEN GATE SAN FRANCISCCA","Everyday Expenses:Medical","Everyday Expenses","Medical",,$50.00,$0.00,C,$4355.03
"Us Bank",,,08/04/2014,"Download from usbank.com. MODCLOTH INC.   888-4959699 CA","Everyday Expenses:Clothing","Everyday Expenses","Clothing",,$72.73,$0.00,C,$4282.30
"Us Bank",,,08/04/2014,"Download from usbank.com. CB2 #53         SAN FRANCISCCA","Savings Goals:House Stuff","Savings Goals","House Stuff",,$114.02,$0.00,C,$4168.28
"Us Bank",,,08/04/2014,"Download from usbank.com. BARCLAYS BANK DE","Savings Goals:Savings","Savings Goals","Savings",,$150.00,$0.00,C,$4018.28
"Us Bank",,,08/04/2014,"Download from usbank.com. WHOLE FOODS MARKSan FranciscCA","Everyday Expenses:Groceries","Everyday Expenses","Groceries",,$166.86,$0.00,C,$3851.42
"Us Bank",,,08/04/2014,"Download from usbank.com. 7246","Debt:Eric's Credit Card","Debt","Eric's Credit Card",,$500.00,$0.00,C,$3351.42
"Us Bank",,,08/05/2014,"Download from usbank.com. PAYPAL","Everyday Expenses:Spending Money","Everyday Expenses","Spending Money",,$5.00,$0.00,C,$3346.42
"Us Bank",,,08/05/2014,"Download from usbank.com. LYFT FRI AT 834P855-280-0278CA","Everyday Expenses:Transportation","Everyday Expenses","Transportation",,$8.00,$0.00,C,$3338.42
"Us Bank",,,08/05/2014,"Download from usbank.com. CUP A JOES COFFESAN FRANCISCCA","Everyday Expenses:Spending Money","Everyday Expenses","Spending Money",,$8.43,$0.00,C,$3329.99
"Us Bank",,,08/05/2014,"Download from usbank.com. Mosser Companies","Monthly Bills:Rent","Monthly Bills","Rent",,$1582.72,$0.00,C,$1747.27
"Us Bank",,,08/06/2014,"Download from usbank.com. PAYPAL","Everyday Expenses:Spending Money","Everyday Expenses","Spending Money",,$10.00,$0.00,C,$1737.27
"Us Bank",,,08/06/2014,"Download from usbank.com. TRADER JOE'S #20SAN FRANCISCCA","Everyday Expenses:Groceries","Everyday Expenses","Groceries",,$10.72,$0.00,C,$1726.55
"Us Bank",,,08/07/2014,"Download from usbank.com. BARCLAYS BANK DE","Savings Goals:Savings","Savings Goals","Savings",,$0.00,$2856.67,C,$4583.22
"Us Bank",,,08/07/2014,"Download from usbank.com. PANERA BREAD #45SAN FRANCISCCA","Everyday Expenses:Spending Money","Everyday Expenses","Spending Money",,$11.98,$0.00,C,$4571.24
"Us Bank",,,08/07/2014,"Download from usbank.com. PGANDE","Monthly Bills:Utilities","Monthly Bills","Utilities",,$41.09,$0.00,C,$4530.15
"Us Bank",,,08/08/2014,"Download from usbank.com. SOUTHWES    5262800-435-9792TX","Everyday Expenses:Spending Money","Everyday Expenses","Spending Money",,$5.60,$0.00,C,$4524.55
"Us Bank",,,08/08/2014,"Download from usbank.com. TRADER JOE'S #20SAN FRANCISCCA","Everyday Expenses:Groceries","Everyday Expenses","Groceries",,$11.52,$0.00,C,$4513.03
"Us Bank",,,08/08/2014,"Download from usbank.com. SUTTER FINE FOODSAN FRANCISCCA","Everyday Expenses:Groceries","Everyday Expenses","Groceries",,$17.39,$0.00,C,$4495.64
"Us Bank",,,08/08/2014,"Download from usbank.com. TEDS SPORTS BAR SAN FRANCISCCA","Everyday Expenses:Spending Money","Everyday Expenses","Spending Money",,$22.00,$0.00,C,$4473.64
"Us Bank",,,08/08/2014,"Download from usbank.com. OOLA RESTAURANT SAN FRANCISCCA","Everyday Expenses:Spending Money","Everyday Expenses","Spending Money",,$40.00,$0.00,C,$4433.64
"Us Bank",,,08/08/2014,"Download from usbank.com. SOUTHWES    5262800-435-9792TX","Everyday Expenses:Spending Money","Everyday Expenses","Spending Money",,$150.60,$0.00,C,$4283.04
"Us Bank",,,08/08/2014,"Download from usbank.com. 7246","Debt:Eric's Credit Card","Debt","Eric's Credit Card",,$250.00,$0.00,C,$4033.04
"Us Bank",,,08/11/2014,"Download from usbank.com. SQ *DELISH DELI San FranciscCA","Everyday Expenses:Spending Money","Everyday Expenses","Spending Money",,$3.99,$0.00,C,$4029.05
"Us Bank",,,08/11/2014,"Download from usbank.com. CUP A JOES COFFESAN FRANCISCCA","Everyday Expenses:Spending Money","Everyday Expenses","Spending Money",,$5.95,$0.00,C,$4023.10
"Us Bank",,,08/11/2014,"Download from usbank.com. IKEA EAST BAY   EMERYVILLE  CA","Everyday Expenses:Spending Money","Everyday Expenses","Spending Money",,$7.62,$0.00,C,$4015.48
"Us Bank",,,08/11/2014,"Download from usbank.com. Amazon Services-866-216-1072WA","Everyday Expenses:Spending Money","Everyday Expenses","Spending Money",,$9.99,$0.00,C,$4005.49
"Us Bank",,,08/11/2014,"Download from usbank.com. MODERN THAI     SAN FRANCISCCA","Everyday Expenses:Spending Money","Everyday Expenses","Spending Money",,$11.96,$0.00,C,$3993.53
"Us Bank",,,08/11/2014,"Download from usbank.com. HERBIVORE       BERKELEY    CA","Everyday Expenses:Spending Money","Everyday Expenses","Spending Money",,$17.28,$0.00,C,$3976.25
"Us Bank",,,08/11/2014,"Download from usbank.com. TFI*TICKETFLY EV877-435-9849CA","Everyday Expenses:Spending Money","Everyday Expenses","Spending Money",,$18.00,$0.00,C,$3958.25
"Us Bank",,,08/11/2014,"Download from usbank.com.","Income:Available this month","Income","Available this month",,$20.00,$0.00,C,$3938.25
"Us Bank",,,08/11/2014,"Download from usbank.com. BITE            SAN FRANCISCCA","Everyday Expenses:Spending Money","Everyday Expenses","Spending Money",,$20.63,$0.00,C,$3917.62
"Us Bank",,,08/11/2014,"Download from usbank.com. FANDANGO.COM    FANDANGO.COMCA","Everyday Expenses:Spending Money","Everyday Expenses","Spending Money",,$24.50,$0.00,C,$3893.12
"Us Bank",,,08/11/2014,"Download from usbank.com. CARDMEMBER SERV",,,,,$34.00,$0.00,C,$3859.12
"Us Bank",,,08/11/2014,"Download from usbank.com. WALGREENS 1300 BSAN FRANCISCCA","Everyday Expenses:Household Goods","Everyday Expenses","Household Goods",,$37.65,$0.00,C,$3821.47
"Us Bank",,,08/11/2014,"Download from usbank.com. WHOLE FOODS MARKSan FranciscCA","Everyday Expenses:Groceries","Everyday Expenses","Groceries",,$125.94,$0.00,C,$3695.53
"Us Bank",,,08/11/2014,"Download from usbank.com. COMCAST CALIFORN800-COMCAST CA","Monthly Bills:Internet","Monthly Bills","Internet",,$151.30,$0.00,C,$3544.23
"Us Bank",,,08/11/2014,"Download from usbank.com.","Savings Goals:Savings","Savings Goals","Savings",,$2856.67,$0.00,C,$687.56
"Us Bank",,,08/12/2014,"Download from usbank.com. PAYPAL","Everyday Expenses:Spending Money","Everyday Expenses","Spending Money",,$5.00,$0.00,C,$682.56
"Us Bank",,,08/12/2014,"Download from usbank.com. CRAFTSMAN AND WOSAN FRANCISCCA","Everyday Expenses:Spending Money","Everyday Expenses","Spending Money",,$13.29,$0.00,C,$669.27
"Us Bank",,,08/12/2014,"Download from usbank.com. BLUE FOG MARKETSSAN FRANCISCCA","Everyday Expenses:Groceries","Everyday Expenses","Groceries",,$17.87,$0.00,C,$651.40
"Us Bank",,,08/13/2014,"Download from usbank.com. SUTTER FINE FOODSAN FRANCISCCA","Everyday Expenses:Groceries","Everyday Expenses","Groceries",,$19.46,$0.00,C,$631.94
"Us Bank",,,08/13/2014,"Download from usbank.com. SPRIG           415-894-5191CA","Everyday Expenses:Groceries","Everyday Expenses","Groceries",,$32.00,$0.00,C,$599.94
"Us Bank",,,08/14/2014,"Download from usbank.com. TRADER JOE'S #20SAN FRANCISCCA","Everyday Expenses:Groceries","Everyday Expenses","Groceries",,$3.18,$0.00,C,$596.76
"Us Bank",,,08/14/2014,"Download from usbank.com. LYFT WED AT 930A855-280-0278CA","Everyday Expenses:Transportation","Everyday Expenses","Transportation",,$7.00,$0.00,C,$589.76
"Us Bank",,,08/14/2014,"Download from usbank.com. CHIPOTLE 1857   SAN FRANCISCCA","Everyday Expenses:Groceries","Everyday Expenses","Groceries",,$7.56,$0.00,C,$582.20
"Us Bank",,,08/14/2014,"Download from usbank.com. WALGREENS 500 GESAN FRANCISCCA","Everyday Expenses:Household Goods","Everyday Expenses","Household Goods",,$8.47,$0.00,C,$573.73
"Us Bank",,,08/14/2014,"Download from usbank.com. Uber Technologie866-5761039 CA","Everyday Expenses:Transportation","Everyday Expenses","Transportation",,$9.96,$0.00,C,$563.77
"Us Bank",,,08/14/2014,"Download from usbank.com. 21ST AMENDMENT BSAN FRANCISCCA","Everyday Expenses:Spending Money","Everyday Expenses","Spending Money",,$21.00,$0.00,C,$542.77
"Us Bank",,,08/14/2014,"Download from usbank.com. RESTAURANT LULU SAN FRANCISCCA","Everyday Expenses:Spending Money","Everyday Expenses","Spending Money",,$48.42,$0.00,C,$494.35
"Us Bank",,,08/15/2014,"Download from usbank.com. SQWIGGLE INC","Income:Available this month","Income","Available this month",,$0.00,$1965.99,C,$2460.34
"Us Bank",,,08/15/2014,"Download from usbank.com. MODCLOTH INC","Income:Available this month","Income","Available this month",,$0.00,$1453.26,C,$3913.60
"Us Bank",,,08/15/2014,"Download from usbank.com. PAYPAL","Everyday Expenses:Spending Money","Everyday Expenses","Spending Money",,$0.00,$47.00,C,$3960.60
"Us Bank",,,08/15/2014,"Download from usbank.com. VENMO","Everyday Expenses:Spending Money","Everyday Expenses","Spending Money",,$11.00,$0.00,C,$3949.60
"Us Bank",,,08/15/2014,"Download from usbank.com. SAFEWAY STORE  2SAN FRANCISCCA","Everyday Expenses:Groceries","Everyday Expenses","Groceries",,$16.05,$0.00,C,$3933.55
"Us Bank",,,08/15/2014,"Download from usbank.com. MODCLOTH INC.   888-4959699 CA","Everyday Expenses:Clothing","Everyday Expenses","Clothing",,$52.16,$0.00,C,$3881.39
"Us Bank",,,08/15/2014,"Download from usbank.com. BARCLAYS BANK DE","Savings Goals:Savings","Savings Goals","Savings",,$150.00,$0.00,C,$3731.39
"Us Bank",,,08/18/2014,"Download from usbank.com. GOOGLE*ADWS","Monthly Bills:Web Stuff","Monthly Bills","Web Stuff",,$0.65,$0.00,C,$3730.74
"Us Bank",,,08/18/2014,"Download from usbank.com. THE SHIP'S STORESAUSALITO   CA","Everyday Expenses:Spending Money","Everyday Expenses","Spending Money",,$6.86,$0.00,C,$3723.88
"Us Bank",,,08/18/2014,"Download from usbank.com. EPICENTER CAFE  SAN FRANCISCCA","Everyday Expenses:Spending Money","Everyday Expenses","Spending Money",,$7.00,$0.00,C,$3716.88
"Us Bank",,,08/18/2014,"Download from usbank.com. EPICENTER CAFE  SAN FRANCISCCA","Everyday Expenses:Spending Money","Everyday Expenses","Spending Money",,$7.61,$0.00,C,$3709.27
"Us Bank",,,08/18/2014,"Download from usbank.com. CHAAT CAFE EXPRESAN FRANCISCCA","Everyday Expenses:Spending Money","Everyday Expenses","Spending Money",,$8.69,$0.00,C,$3700.58
"Us Bank",,,08/18/2014,"Download from usbank.com. SUGAR CAFE      SAN FRANCISCCA","Everyday Expenses:Spending Money","Everyday Expenses","Spending Money",,$9.00,$0.00,C,$3691.58
"Us Bank",,,08/18/2014,"Download from usbank.com. PAYPAL","Everyday Expenses:Spending Money","Everyday Expenses","Spending Money",,$9.99,$0.00,C,$3681.59
"Us Bank",,,08/18/2014,"Download from usbank.com. Uber Technologie866-5761039 CA","Everyday Expenses:Transportation","Everyday Expenses","Transportation",,$11.54,$0.00,C,$3670.05
"Us Bank",,,08/18/2014,"Download from usbank.com. WALGREENS 1301 FSAN FRANCISCCA","Everyday Expenses:Medical","Everyday Expenses","Medical",,$11.66,$0.00,C,$3658.39
"Us Bank",,,08/18/2014,"Download from usbank.com. LYFT FRI AT 617P855-280-0278CA","Everyday Expenses:Transportation","Everyday Expenses","Transportation",,$13.00,$0.00,C,$3645.39
"Us Bank",,,08/18/2014,"Download from usbank.com. CHIPOTLE 1857   SAN FRANCISCCA","Everyday Expenses:Groceries","Everyday Expenses","Groceries",,$15.12,$0.00,C,$3630.27
"Us Bank",,,08/18/2014,"Download from usbank.com. SUTTER FINE FOODSAN FRANCISCCA","Everyday Expenses:Groceries","Everyday Expenses","Groceries",,$18.48,$0.00,C,$3611.79
"Us Bank",,,08/18/2014,"Download from usbank.com. TOAST           SAN FRANCISCCA","Everyday Expenses:Spending Money","Everyday Expenses","Spending Money",,$29.05,$0.00,C,$3582.74
"Us Bank",,,08/18/2014,"Download from usbank.com. SUNDANCE KAB    818-889-8562CA","Everyday Expenses:Spending Money","Everyday Expenses","Spending Money",,$30.00,$0.00,C,$3552.74
"Us Bank",,,08/18/2014,"Download from usbank.com. MODCLOTH INC.   888-4959699 CA","Everyday Expenses:Clothing","Everyday Expenses","Clothing",,$31.82,$0.00,C,$3520.92
"Us Bank",,,08/18/2014,"Download from usbank.com. MIFUNE BISTRO   SAN FRANCISCCA","Everyday Expenses:Spending Money","Everyday Expenses","Spending Money",,$32.38,$0.00,C,$3488.54
"Us Bank",,,08/18/2014,"Download from usbank.com. WALGREENS 1300 BSAN FRANCISCCA","Everyday Expenses:Household Goods","Everyday Expenses","Household Goods",,$36.90,$0.00,C,$3451.64
"Us Bank",,,08/18/2014,"Download from usbank.com. OSAKA SUSHI     SAN FRANCISCCA","Everyday Expenses:Spending Money","Everyday Expenses","Spending Money",,$40.92,$0.00,C,$3410.72
"Us Bank",,,08/18/2014,"Download from usbank.com. SF Muni GGF LarkSan FranciscCA","Everyday Expenses:Transportation","Everyday Expenses","Transportation",,$43.00,$0.00,C,$3367.72
"Us Bank",,,08/18/2014,"Download from usbank.com. SO RESTAURANT   SAN FRANCISCCA","Everyday Expenses:Spending Money","Everyday Expenses","Spending Money",,$49.85,$0.00,C,$3317.87
"Us Bank",,,08/18/2014,"Download from usbank.com. US BANK CASTRO  SAN FRANCISCCAUS1","Everyday Expenses:Spending Money","Everyday Expenses","Spending Money",,$60.00,$0.00,C,$3257.87
"Us Bank",,,08/18/2014,"Download from usbank.com. BARCLAYS BANK DE","Savings Goals:Savings","Savings Goals","Savings",,$150.00,$0.00,C,$3107.87
"Us Bank",,,08/18/2014,"Download from usbank.com. 7246","Debt:Eric's Credit Card","Debt","Eric's Credit Card",,$750.00,$0.00,C,$2357.87
"Us Bank",,,08/19/2014,"Download from usbank.com. CHIPOTLE 1857   SAN FRANCISCCA","Everyday Expenses:Groceries","Everyday Expenses","Groceries",,$7.56,$0.00,C,$2350.31
"Us Bank",,,08/19/2014,"Download from usbank.com. CUP A JOES COFFESAN FRANCISCCA","Everyday Expenses:Spending Money","Everyday Expenses","Spending Money",,$15.65,$0.00,C,$2334.66
"Us Bank",,,08/19/2014,"Download from usbank.com. MUIR WOODS NATL MILL VALLEY CA","Everyday Expenses:Spending Money","Everyday Expenses","Spending Money",,$24.00,$0.00,C,$2310.66
"Us Bank",,,08/19/2014,"Download from usbank.com. DE IPHONE REPAIRSAN FRANCISCCA","Everyday Expenses:Spending Money","Everyday Expenses","Spending Money",,$129.00,$0.00,C,$2181.66
"Us Bank",,,08/19/2014,"Download from usbank.com. ATT","Monthly Bills:Cell Phone","Monthly Bills","Cell Phone",,$225.59,$0.00,C,$1956.07
"Us Bank",,,08/20/2014,"Download from usbank.com. CUP A JOES COFFESAN FRANCISCCA","Everyday Expenses:Spending Money","Everyday Expenses","Spending Money",,$5.25,$0.00,C,$1950.82
"Us Bank",,,08/20/2014,"Download from usbank.com. PAYPAL","Monthly Bills:Web Stuff","Monthly Bills","Web Stuff",,$9.99,$0.00,C,$1940.83
"Us Bank",,,08/20/2014,"Download from usbank.com. Bread and Cocoa San FranciscCA","Everyday Expenses:Spending Money","Everyday Expenses","Spending Money",,$10.75,$0.00,C,$1930.08
"Us Bank",,,08/20/2014,"Download from usbank.com. SPRIG           415-894-5191CA","Everyday Expenses:Groceries","Everyday Expenses","Groceries",,$11.00,$0.00,C,$1919.08
"Us Bank",,,08/20/2014,"Download from usbank.com. EAT24.COM       EAT24HOURS.CCA","Everyday Expenses:Spending Money","Everyday Expenses","Spending Money",,$25.83,$0.00,C,$1893.25
"Us Bank",,,08/20/2014,"Download from usbank.com. TRADER JOE'S #20SAN FRANCISCCA","Everyday Expenses:Groceries","Everyday Expenses","Groceries",,$59.47,$0.00,C,$1833.78
"Us Bank",,,08/21/2014,"Download from usbank.com. 6703",,,,,$0.00,$44.94,C,$1878.72
"Us Bank",,,08/21/2014,"Download from usbank.com. PAYPAL","Everyday Expenses:Spending Money","Everyday Expenses","Spending Money",,$5.00,$0.00,C,$1873.72
"Us Bank",,,08/21/2014,"Download from usbank.com. CUP A JOES COFFESAN FRANCISCCA","Everyday Expenses:Spending Money","Everyday Expenses","Spending Money",,$5.75,$0.00,C,$1867.97
"Us Bank",,,08/21/2014,"Download from usbank.com. CA WED AT 736PM 206-321-1054CA","Everyday Expenses:Spending Money","Everyday Expenses","Spending Money",,$10.00,$0.00,C,$1857.97
"Us Bank",,,08/21/2014,"Download from usbank.com. THISTLECHANGEYOUTHISTLECHANGCA","Everyday Expenses:Spending Money","Everyday Expenses","Spending Money",,$10.00,$0.00,C,$1847.97
"Us Bank",,,08/22/2014,"Download from usbank.com.","Everyday Expenses:Spending Money","Everyday Expenses","Spending Money",,$0.00,$6.95,C,$1854.92
"Us Bank",,,08/22/2014,"Download from usbank.com.","Everyday Expenses:Spending Money","Everyday Expenses","Spending Money",,$6.95,$0.00,C,$1847.97
"Us Bank",,,08/22/2014,"Download from usbank.com. THE CREAMERY    SAN FRANCISCCA","Everyday Expenses:Spending Money","Everyday Expenses","Spending Money",,$12.78,$0.00,C,$1835.19
"Us Bank",,,08/22/2014,"Download from usbank.com. GROUPON INC     877-788-7858IL","Everyday Expenses:Spending Money","Everyday Expenses","Spending Money",,$29.00,$0.00,C,$1806.19
"Us Bank",,,08/25/2014,"Download from usbank.com. SQ *CARTEL COFFETempe       AZ","Everyday Expenses:Spending Money","Everyday Expenses","Spending Money",,$3.75,$0.00,C,$1802.44
"Us Bank",,,08/25/2014,"Download from usbank.com. APL* ITUNES.COM/866-712-7753CA","Everyday Expenses:Spending Money","Everyday Expenses","Spending Money",,$3.99,$0.00,C,$1798.45
"Us Bank",,,08/25/2014,"Download from usbank.com. AROMA ROASTERS &SANTA ROSA  CA","Everyday Expenses:Spending Money","Everyday Expenses","Spending Money",,$4.00,$0.00,C,$1794.45
"Us Bank",,,08/25/2014,"Download from usbank.com. LYFT.COM SAT AT 855-280-0278CA","Everyday Expenses:Transportation","Everyday Expenses","Transportation",,$5.00,$0.00,C,$1789.45
"Us Bank",,,08/25/2014,"Download from usbank.com. SHELL Service StSCOTTSDALE  AZ","Everyday Expenses:Spending Money","Everyday Expenses","Spending Money",,$7.55,$0.00,C,$1781.90
"Us Bank",,,08/25/2014,"Download from usbank.com. HLU*Hulu 2274453HULU.COM/BILCA","Monthly Bills:Web Stuff","Monthly Bills","Web Stuff",,$7.99,$0.00,C,$1773.91
"Us Bank",,,08/25/2014,"Download from usbank.com. CHIPOTLE 0026   CHANDLER    AZ","Everyday Expenses:Spending Money","Everyday Expenses","Spending Money",,$8.43,$0.00,C,$1765.48
"Us Bank",,,08/25/2014,"Download from usbank.com. SQ *CARTEL COFFETempe       AZ","Everyday Expenses:Spending Money","Everyday Expenses","Spending Money",,$9.00,$0.00,C,$1756.48
"Us Bank",,,08/25/2014,"Download from usbank.com. BITE            SAN FRANCISCCA","Everyday Expenses:Spending Money","Everyday Expenses","Spending Money",,$9.78,$0.00,C,$1746.70
"Us Bank",,,08/25/2014,"Download from usbank.com. PAYPAL","Monthly Bills:Web Stuff","Monthly Bills","Web Stuff",,$9.99,$0.00,C,$1736.71
"Us Bank",,,08/25/2014,"Download from usbank.com. PAYPAL","Everyday Expenses:Spending Money","Everyday Expenses","Spending Money",,$10.00,$0.00,C,$1726.71
"Us Bank",,,08/25/2014,"Download from usbank.com. PARKVIEW MARKET SAN FRANCISCCA","Everyday Expenses:Spending Money","Everyday Expenses","Spending Money",,$13.45,$0.00,C,$1713.26
"Us Bank",,,08/25/2014,"Download from usbank.com. KLEINS DELI GATESAN FRANCISCCA","Everyday Expenses:Spending Money","Everyday Expenses","Spending Money",,$16.40,$0.00,C,$1696.86
"Us Bank",,,08/25/2014,"Download from usbank.com. BART-POWELL     SAN FRANCISCCA","Everyday Expenses:Transportation","Everyday Expenses","Transportation",,$17.30,$0.00,C,$1679.56
"Us Bank",,,08/25/2014,"Download from usbank.com. Uber Technologie866-5761039 CA","Everyday Expenses:Transportation","Everyday Expenses","Transportation",,$18.47,$0.00,C,$1661.09
"Us Bank",,,08/25/2014,"Download from usbank.com. OOLA RESTAURANT SAN FRANCISCCA","Everyday Expenses:Spending Money","Everyday Expenses","Spending Money",,$19.45,$0.00,C,$1641.64
"Us Bank",,,08/25/2014,"Download from usbank.com. SQ *ANOTHER CAFESan FranciscCA","Everyday Expenses:Spending Money","Everyday Expenses","Spending Money",,$19.50,$0.00,C,$1622.14
"Us Bank",,,08/25/2014,"Download from usbank.com. CHICK-FIL-A #031SANTA ROSA  CA","Everyday Expenses:Spending Money","Everyday Expenses","Spending Money",,$22.67,$0.00,C,$1599.47
"Us Bank",,,08/25/2014,"Download from usbank.com. WARAKU          SAN FRANCISCCA","Everyday Expenses:Spending Money","Everyday Expenses","Spending Money",,$23.00,$0.00,C,$1576.47
"Us Bank",,,08/25/2014,"Download from usbank.com. WALGREENS 1300 BSAN FRANCISCCA","Everyday Expenses:Household Goods","Everyday Expenses","Household Goods",,$27.15,$0.00,C,$1549.32
"Us Bank",,,08/25/2014,"Download from usbank.com. RUSSIAN RIVER BRSANTA ROSA  CA","Everyday Expenses:Spending Money","Everyday Expenses","Spending Money",,$46.50,$0.00,C,$1502.82
"Us Bank",,,08/25/2014,"Download from usbank.com. WHOLE FOODS MARKSan FranciscCA","Everyday Expenses:Groceries","Everyday Expenses","Groceries",,$85.87,$0.00,C,$1416.95
"Us Bank",,,08/25/2014,"Download from usbank.com. HOTEL LA ROSE   SANTA ROSA  CA","Everyday Expenses:Spending Money","Everyday Expenses","Spending Money",,$205.19,$0.00,C,$1211.76
"Us Bank",,,08/26/2014,"Download from usbank.com. CUP A JOES COFFESAN FRANCISCCA","Everyday Expenses:Spending Money","Everyday Expenses","Spending Money",,$5.25,$0.00,C,$1206.51
"Us Bank",,,08/26/2014,"Download from usbank.com. US EGG          TEMPE       AZ","Everyday Expenses:Spending Money","Everyday Expenses","Spending Money",,$11.98,$0.00,C,$1194.53
"Us Bank",,,08/26/2014,"Download from usbank.com. DAILY DOSE      SCOTTSDALE  AZ","Everyday Expenses:Spending Money","Everyday Expenses","Spending Money",,$15.49,$0.00,C,$1179.04
"Us Bank",,,08/26/2014,"Download from usbank.com. CORNISH PASTY COTEMPE       AZ","Everyday Expenses:Spending Money","Everyday Expenses","Spending Money",,$17.70,$0.00,C,$1161.34
"Us Bank",,,08/27/2014,"Download from usbank.com. TRADER JOE'S #20SAN FRANCISCCA","Everyday Expenses:Groceries","Everyday Expenses","Groceries",,$3.18,$0.00,C,$1158.16
"Us Bank",,,08/27/2014,"Download from usbank.com. COPPER PLATE    PHOENIX     AZ","Everyday Expenses:Spending Money","Everyday Expenses","Spending Money",,$8.00,$0.00,C,$1150.16
"Us Bank",,,08/27/2014,"Download from usbank.com. CHIPOTLE 1857   SAN FRANCISCCA","Everyday Expenses:Groceries","Everyday Expenses","Groceries",,$9.14,$0.00,C,$1141.02
"Us Bank",,,08/27/2014,"Download from usbank.com. MELLOW MUSHROOM TEMPE       AZ","Everyday Expenses:Spending Money","Everyday Expenses","Spending Money",,$15.27,$0.00,C,$1125.75
"Us Bank",,,08/27/2014,"Download from usbank.com. PAYPAL","Savings Goals:Vacation & Travel","Savings Goals","Vacation & Travel",,$227.20,$0.00,C,$898.55
"Us Bank",,,08/28/2014,"Download from usbank.com. AMAZON DIG522071","Everyday Expenses:Spending Money","Everyday Expenses","Spending Money",,$0.00,$8.40,C,$906.95
"Us Bank",,,08/28/2014,"Download from usbank.com. PAYPAL","Monthly Bills:Web Stuff","Monthly Bills","Web Stuff",,$5.00,$0.00,C,$901.95
"Us Bank",,,08/29/2014,"Download from usbank.com. SQWIGGLE INC","Income:Available next month","Income","Available next month",,$0.00,$1965.99,C,$2867.94
"Us Bank",,,08/29/2014,"Download from usbank.com. MODCLOTH INC","Income:Available next month","Income","Available next month",,$0.00,$1453.26,C,$4321.20
"Us Bank",,,08/29/2014,"Download from usbank.com. 082914PLUSTERM475 3RD ST      SAN FRANCISCCAUS1","Everyday Expenses:Spending Money","Everyday Expenses","Spending Money",,$2.50,$0.00,C,$4318.70
"Us Bank",,,08/29/2014,"Download from usbank.com. CUP A JOES COFFESAN FRANCISCCA","Everyday Expenses:Spending Money","Everyday Expenses","Spending Money",,$7.00,$0.00,C,$4311.70
"Us Bank",,,08/29/2014,"Download from usbank.com. WALGREENS 670 4TSAN FRANCISCCA","Everyday Expenses:Household Goods","Everyday Expenses","Household Goods",,$8.69,$0.00,C,$4303.01
"Us Bank",,,08/29/2014,"Download from usbank.com. SPRIG           415-894-5191CA","Everyday Expenses:Groceries","Everyday Expenses","Groceries",,$11.00,$0.00,C,$4292.01
"Us Bank",,,08/29/2014,"Download from usbank.com. SPIRO COFFEE    SAN FRANCISCCA","Everyday Expenses:Spending Money","Everyday Expenses","Spending Money",,$13.05,$0.00,C,$4278.96
"Us Bank",,,08/29/2014,"Download from usbank.com. 475 3RD ST      SAN FRANCISCCAUS1","Everyday Expenses:Spending Money","Everyday Expenses","Spending Money",,$22.00,$0.00,C,$4256.96
"Us Bank",,,08/29/2014,"Download from usbank.com. TRADER JOE'S #20SAN FRANCISCCA","Everyday Expenses:Groceries","Everyday Expenses","Groceries",,$28.86,$0.00,C,$4228.10
"Us Bank",,,09/02/2014,"Download from usbank.com. VENMO","Everyday Expenses:Spending Money","Everyday Expenses","Spending Money",,$0.00,$132.58,C,$4360.68
"Us Bank",,,09/02/2014,"Download from usbank.com. VENMO","Everyday Expenses:Spending Money","Everyday Expenses","Spending Money",,$0.00,$60.00,C,$4420.68
"Us Bank",,,09/02/2014,"Download from usbank.com. LYFT.COM SUN AT 855-280-0278CA","Everyday Expenses:Transportation","Everyday Expenses","Transportation",,$6.00,$0.00,C,$4414.68
"Us Bank",,,09/02/2014,"Download from usbank.com. LYFT.COM FRI AT 855-280-0278CA","Everyday Expenses:Transportation","Everyday Expenses","Transportation",,$7.00,$0.00,C,$4407.68
"Us Bank",,,09/02/2014,"Download from usbank.com. CHIPOTLE 1857   SAN FRANCISCCA","Everyday Expenses:Groceries","Everyday Expenses","Groceries",,$7.56,$0.00,C,$4400.12
"Us Bank",,,09/02/2014,"Download from usbank.com. FLY             SAN FRANCISCCA","Everyday Expenses:Groceries","Everyday Expenses","Groceries",,$8.00,$0.00,C,$4392.12
"Us Bank",,,09/02/2014,"Download from usbank.com. DAILYBURN       888-867-8304NY","Monthly Bills:Web Stuff","Monthly Bills","Web Stuff",,$10.00,$0.00,C,$4382.12
"Us Bank",,,09/02/2014,"Download from usbank.com. PAYPAL","Everyday Expenses:Spending Money","Everyday Expenses","Spending Money",,$10.00,$0.00,C,$4372.12
"Us Bank",,,09/02/2014,"Download from usbank.com. BRITEX FABRICS  SAN FRANCISCCA","Everyday Expenses:Spending Money","Everyday Expenses","Spending Money",,$10.86,$0.00,C,$4361.26
"Us Bank",,,09/02/2014,"Download from usbank.com. APL* ITUNES.COM/866-712-7753CA","Everyday Expenses:Spending Money","Everyday Expenses","Spending Money",,$14.98,$0.00,C,$4346.28
"Us Bank",,,09/02/2014,"Download from usbank.com. FLY             SAN FRANCISCCA","Everyday Expenses:Groceries","Everyday Expenses","Groceries",,$16.00,$0.00,C,$4330.28
"Us Bank",,,09/02/2014,"Download from usbank.com. TROPISUENO      SAN FRANCISCCA","Everyday Expenses:Spending Money","Everyday Expenses","Spending Money",,$19.68,$0.00,C,$4310.60
"Us Bank",,,09/02/2014,"Download from usbank.com. WHOLE FOODS MARKSan FranciscCA","Everyday Expenses:Groceries","Everyday Expenses","Groceries",,$25.52,$0.00,C,$4285.08
"Us Bank",,,09/02/2014,"Download from usbank.com. WALGREENS 1300 BSAN FRANCISCCA","Everyday Expenses:Household Goods","Everyday Expenses","Household Goods",,$28.56,$0.00,C,$4256.52
"Us Bank",,,09/02/2014,"Download from usbank.com. MAYES OYSTER HOUSAN FRANCISCCA","Everyday Expenses:Spending Money","Everyday Expenses","Spending Money",,$30.00,$0.00,C,$4226.52
"Us Bank",,,09/02/2014,"Download from usbank.com. TRADER JOE'S #20SAN FRANCISCCA","Everyday Expenses:Groceries","Everyday Expenses","Groceries",,$38.08,$0.00,C,$4188.44
"Us Bank",,,09/02/2014,"Download from usbank.com. FLY             SAN FRANCISCCA","Everyday Expenses:Spending Money","Everyday Expenses","Spending Money",,$43.79,$0.00,C,$4144.65
"Us Bank",,,09/02/2014,"Download from usbank.com. MET CAS INS CO","Monthly Bills:Car Insurance","Monthly Bills","Car Insurance",,$49.00,$0.00,C,$4095.65
"Us Bank",,,09/02/2014,"Download from usbank.com. OSHA THAI UNION SAN FRANCISCCA","Everyday Expenses:Spending Money","Everyday Expenses","Spending Money",,$55.39,$0.00,C,$4040.26
"Us Bank",,,09/02/2014,"Download from usbank.com. POINTS RAPID REW800-435-9792IL","Savings Goals:Vacation & Travel","Savings Goals","Vacation & Travel",,$82.50,$0.00,C,$3957.76
"Us Bank",,,09/02/2014,"Download from usbank.com. TARGET T2766    SAN FRANCISCCA","Savings Goals:House Stuff","Savings Goals","House Stuff",,$84.04,$0.00,C,$3873.72
"Us Bank",,,09/02/2014,"Download from usbank.com. GUITAR CENTER #2SAN FRANCISCCA","Everyday Expenses:Spending Money","Everyday Expenses","Spending Money",,$108.74,$0.00,C,$3764.98
"Us Bank",,,09/02/2014,"Download from usbank.com. IZAKAYA NINJA   SAN FRANCISCCA","Everyday Expenses:Spending Money","Everyday Expenses","Spending Money",,$111.46,$0.00,C,$3653.52
"Us Bank",,,09/02/2014,"Download from usbank.com. BARCLAYS BANK DE","Savings Goals:Savings","Savings Goals","Savings",,$150.00,$0.00,C,$3503.52
"Us Bank",,,09/02/2014,"Download from usbank.com. BARCLAYS BANK DE","Savings Goals:Savings","Savings Goals","Savings",,$150.00,$0.00,C,$3353.52
"Us Bank",,,09/02/2014,"Download from usbank.com. VENMO","Everyday Expenses:Spending Money","Everyday Expenses","Spending Money",,$240.00,$0.00,C,$3113.52
"Us Bank",,,09/02/2014,"Download from usbank.com. JETBLUE     2792SALT LAKE CTUT","Savings Goals:Vacation & Travel","Savings Goals","Vacation & Travel",,$337.98,$0.00,C,$2775.54
"Us Bank",,,09/02/2014,"Download from usbank.com. AIRBNB INC      415-800-5959CA","Savings Goals:Vacation & Travel","Savings Goals","Vacation & Travel",,$718.00,$0.00,C,$2057.54
"Us Bank",,,09/03/2014,"Download from usbank.com. 090314PLUSTERM475 3RD ST      SAN FRANCISCCAUS1","Everyday Expenses:Spending Money","Everyday Expenses","Spending Money",,$2.50,$0.00,C,$2055.04
"Us Bank",,,09/03/2014,"Download from usbank.com. CHIPOTLE 1857   SAN FRANCISCCA","Everyday Expenses:Groceries","Everyday Expenses","Groceries",,$7.56,$0.00,C,$2047.48
"Us Bank",,,09/03/2014,"Download from usbank.com. SQ *WU WEI LLC  San FranciscCA","Everyday Expenses:Spending Money","Everyday Expenses","Spending Money",,$10.00,$0.00,C,$2037.48
"Us Bank",,,09/03/2014,"Download from usbank.com. CHRONICLE BOOKS SAN FRANCISCCA","Everyday Expenses:Spending Money","Everyday Expenses","Spending Money",,$14.09,$0.00,C,$2023.39
"Us Bank",,,09/03/2014,"Download from usbank.com. CUP A JOES COFFESAN FRANCISCCA","Everyday Expenses:Spending Money","Everyday Expenses","Spending Money",,$15.40,$0.00,C,$2007.99
"Us Bank",,,09/03/2014,"Download from usbank.com. 475 3RD ST      SAN FRANCISCCAUS1","Everyday Expenses:Spending Money","Everyday Expenses","Spending Money",,$22.00,$0.00,C,$1985.99
"Us Bank",,,09/03/2014,"Download from usbank.com. SPRIG           415-894-5191CA","Everyday Expenses:Groceries","Everyday Expenses","Groceries",,$22.00,$0.00,C,$1963.99
"Us Bank",,,09/03/2014,"Download from usbank.com. Mosser Companies","Monthly Bills:Rent","Monthly Bills","Rent",,$1582.72,$0.00,C,$381.27
"Us Bank",,,09/04/2014,"Download from usbank.com. VENMO","Savings Goals:Vacation & Travel","Savings Goals","Vacation & Travel",,$0.00,$480.00,C,$861.27
"Us Bank",,,09/04/2014,"Download from usbank.com. Apple","Everyday Expenses:Spending Money","Everyday Expenses","Spending Money",,$0.00,$11.62,C,$872.89
"Us Bank",,,09/04/2014,"Download from usbank.com. APL* ITUNES.COM/866-712-7753CA","Everyday Expenses:Spending Money","Everyday Expenses","Spending Money",,$4.99,$0.00,C,$867.90
"Us Bank",,,09/04/2014,"Download from usbank.com. PAYPAL","Everyday Expenses:Spending Money","Everyday Expenses","Spending Money",,$5.00,$0.00,C,$862.90
"Us Bank",,,09/04/2014,"Download from usbank.com. CUP A JOES COFFESAN FRANCISCCA","Everyday Expenses:Spending Money","Everyday Expenses","Spending Money",,$5.75,$0.00,C,$857.15
"Us Bank",,,09/04/2014,"Download from usbank.com. WHOLE FOODS MARKSan FranciscCA","Everyday Expenses:Groceries","Everyday Expenses","Groceries",,$93.77,$0.00,C,$763.38
"Us Bank",,,09/05/2014,"Download from usbank.com. SPECIALTYS CAFE SAN FRANCISCCA","Everyday Expenses:Spending Money","Everyday Expenses","Spending Money",,$3.85,$0.00,C,$759.53
"Us Bank",,,09/05/2014,"Download from usbank.com. SQ *WORKSHOP CAFSan FranciscCA","Everyday Expenses:Spending Money","Everyday Expenses","Spending Money",,$5.00,$0.00,C,$754.53
"Us Bank",,,09/05/2014,"Download from usbank.com. AmazonLocal     www.amazonloWA","Everyday Expenses:Spending Money","Everyday Expenses","Spending Money",,$7.00,$0.00,C,$747.53
"Us Bank",,,09/05/2014,"Download from usbank.com. AmazonLocal     www.amazonloWA","Everyday Expenses:Spending Money","Everyday Expenses","Spending Money",,$7.00,$0.00,C,$740.53
"Us Bank",,,09/05/2014,"Download from usbank.com. TACQUERIA DOS AMSAN FRANCISCCA","Everyday Expenses:Spending Money","Everyday Expenses","Spending Money",,$8.27,$0.00,C,$732.26
"Us Bank",,,09/08/2014,"Atm deposit","Everyday Expenses:Spending Money","Everyday Expenses","Spending Money","check from sqwiggle",$0.00,$400.00,C,$1132.26
"Us Bank",,,09/08/2014,"Download from usbank.com. SQ *JACOBS CAFE San FranciscCA","Everyday Expenses:Spending Money","Everyday Expenses","Spending Money",,$1.90,$0.00,C,$1130.36
"Us Bank",,,09/08/2014,"Download from usbank.com. CB2 #53         SAN FRANCISCCA","Savings Goals:House Stuff","Savings Goals","House Stuff",,$8.60,$0.00,C,$1121.76
"Us Bank",,,09/08/2014,"Download from usbank.com. CABIN           SAN FRANCISCCA","Everyday Expenses:Spending Money","Everyday Expenses","Spending Money",,$9.00,$0.00,C,$1112.76
"Us Bank",,,09/08/2014,"Download from usbank.com. POLK AND CLAY LISAN FRANCISCCA","Everyday Expenses:Spending Money","Everyday Expenses","Spending Money",,$12.48,$0.00,C,$1100.28
"Us Bank",,,09/08/2014,"Download from usbank.com. GROUPON INC     877-788-7858IL","Everyday Expenses:Spending Money","Everyday Expenses","Spending Money",,$15.00,$0.00,C,$1085.28
"Us Bank",,,09/08/2014,"Download from usbank.com. R BAR INC       SAN FRANCISCCA","Everyday Expenses:Spending Money","Everyday Expenses","Spending Money",,$16.00,$0.00,C,$1069.28
"Us Bank",,,09/08/2014,"Download from usbank.com. GUITAR CENTER #2SAN FRANCISCCA","Everyday Expenses:Spending Money","Everyday Expenses","Spending Money",,$16.29,$0.00,C,$1052.99
"Us Bank",,,09/08/2014,"Download from usbank.com. GROUPON INC     877-788-7858IL","Everyday Expenses:Spending Money","Everyday Expenses","Spending Money",,$23.00,$0.00,C,$1029.99
"Us Bank",,,09/08/2014,"Download from usbank.com. PINECREST DINNERSAN FRANCISCCA","Everyday Expenses:Spending Money","Everyday Expenses","Spending Money",,$25.80,$0.00,C,$1004.19
"Us Bank",,,09/08/2014,"Download from usbank.com. WALGREENS 1300 BSAN FRANCISCCA","Everyday Expenses:Household Goods","Everyday Expenses","Household Goods",,$28.56,$0.00,C,$975.63
"Us Bank",,,09/08/2014,"Download from usbank.com. MODCLOTH INC.   888-4959699 CA","Everyday Expenses:Clothing","Everyday Expenses","Clothing",,$34.62,$0.00,C,$941.01
"Us Bank",,,09/08/2014,"Download from usbank.com. SUSHI ROCK      SAN FRANCISCCA","Everyday Expenses:Spending Money","Everyday Expenses","Spending Money",,$39.58,$0.00,C,$901.43
"Us Bank",,,09/08/2014,"Download from usbank.com. PUBLIC BARBER SASAN FRANCISCCA","Everyday Expenses:Spending Money","Everyday Expenses","Spending Money",,$44.00,$0.00,C,$857.43
"Us Bank",,,09/08/2014,"Download from usbank.com. APPLE STORE  #R0SAN FRANCISCCA","Everyday Expenses:Spending Money","Everyday Expenses","Spending Money",,$77.21,$0.00,C,$780.22
"Us Bank",,,09/08/2014,"Download from usbank.com. WHOLE FOODS MARKSan FranciscCA","Everyday Expenses:Groceries","Everyday Expenses","Groceries",,$100.94,$0.00,C,$679.28
"Us Bank",,,09/09/2014,"fix balance","Everyday Expenses:Spending Money","Everyday Expenses","Spending Money",,$0.02,$0.00,C,$679.26
"Us Bank",,,09/09/2014,"Download from usbank.com. PAYPAL","Everyday Expenses:Spending Money","Everyday Expenses","Spending Money",,$5.00,$0.00,C,$674.26
"Us Bank",,,09/09/2014,"Download from usbank.com. CHIPOTLE 1857   SAN FRANCISCCA","Everyday Expenses:Groceries","Everyday Expenses","Groceries",,$7.56,$0.00,C,$666.70
"Us Bank",,,09/10/2014,"Download from usbank.com. 091014PLUSTERM428 11th Street San FranciscCAUS1","Everyday Expenses:Spending Money","Everyday Expenses","Spending Money",,$2.50,$0.00,C,$664.20
"Us Bank",,,09/10/2014,"Download from usbank.com. CARDMEMBER SERV",,,,,$34.00,$0.00,C,$630.20
"Us Bank",,,09/10/2014,"Download from usbank.com. 428 11th Street San FranciscCAUS1","Everyday Expenses:Spending Money","Everyday Expenses","Spending Money",,$62.75,$0.00,C,$567.45
"Us Bank",,,09/11/2014,"Download from usbank.com. DARWIN CAFE LLC SAN FRANCISCCA","Everyday Expenses:Spending Money","Everyday Expenses","Spending Money",,$11.00,$0.00,C,$556.45
"Us Bank",,,09/11/2014,"Download from usbank.com. SQ *OUI CHEF    San FranciscCA","Everyday Expenses:Spending Money","Everyday Expenses","Spending Money",,$27.19,$0.00,C,$529.26
"Us Bank",,,09/12/2014,"Download from usbank.com. MODCLOTH INC","Income:Available next month","Income","Available next month",,$0.00,$1453.25,C,$1982.51
"Us Bank",,,09/12/2014,"Download from usbank.com. SPRIG           415-894-5191CA","Everyday Expenses:Groceries","Everyday Expenses","Groceries",,$12.00,$0.00,C,$1970.51
"Us Bank",,,09/12/2014,"Download from usbank.com. BART-CIVIC CENTESAN FRANCISCCA","Everyday Expenses:Transportation","Everyday Expenses","Transportation",,$17.30,$0.00,C,$1953.21
"Us Bank",,,09/12/2014,"Download from usbank.com. BART-POWELL     SAN FRANCISCCA","Everyday Expenses:Transportation","Everyday Expenses","Transportation",,$17.30,$0.00,C,$1935.91
"Us Bank",,,09/12/2014,"Download from usbank.com. WALGREENS 1300 BSAN FRANCISCCA","Everyday Expenses:Household Goods","Everyday Expenses","Household Goods",,$17.50,$0.00,C,$1918.41
"Us Bank",,,09/15/2014,"Download from usbank.com. SQWIGGLE INC","Income:Available next month","Income","Available next month",,$0.00,$1965.99,C,$3884.40
"Us Bank",,,09/15/2014,"Download from usbank.com.","Everyday Expenses:Spending Money","Everyday Expenses","Spending Money",,$0.26,$0.00,C,$3884.14
"Us Bank",,,09/15/2014,"Download from usbank.com. PEETS COFFEE SFOSAN FRANCISCCA","Everyday Expenses:Spending Money","Everyday Expenses","Spending Money",,$2.69,$0.00,C,$3881.45
"Us Bank",,,09/15/2014,"Download from usbank.com. GORDON BIERSCH30SAN FRANCISCCA","Everyday Expenses:Spending Money","Everyday Expenses","Spending Money",,$2.74,$0.00,C,$3878.71
"Us Bank",,,09/15/2014,"Download from usbank.com. PEETS COFFEE SFOSAN FRANCISCCA","Everyday Expenses:Spending Money","Everyday Expenses","Spending Money",,$3.86,$0.00,C,$3874.85
"Us Bank",,,09/15/2014,"Download from usbank.com. APL* ITUNES.COM/866-712-7753CA","Everyday Expenses:Spending Money","Everyday Expenses","Spending Money",,$4.99,$0.00,C,$3869.86
"Us Bank",,,09/15/2014,"Download from usbank.com. TROPICAL LIQUEURCOLUMBIA    MO","Everyday Expenses:Spending Money","Everyday Expenses","Spending Money",,$5.25,$0.00,C,$3864.61
"Us Bank",,,09/15/2014,"Download from usbank.com. A & W VANCOUVER RICHMOND    BC","Everyday Expenses:Spending Money","Everyday Expenses","Spending Money",,$8.67,$0.00,C,$3855.94
"Us Bank",,,09/15/2014,"Download from usbank.com. CHICK-FIL-A #026ARNOLD      MO","Everyday Expenses:Spending Money","Everyday Expenses","Spending Money",,$11.08,$0.00,C,$3844.86
"Us Bank",,,09/15/2014,"Download from usbank.com. GAP OUTLET USA  COLUMBIA    MO","Everyday Expenses:Clothing","Everyday Expenses","Clothing",,$13.72,$0.00,C,$3831.14
"Us Bank",,,09/15/2014,"Download from usbank.com. JAPAN KATANA YA SAN FRANCISCCA","Everyday Expenses:Spending Money","Everyday Expenses","Spending Money",,$14.44,$0.00,C,$3816.70
"Us Bank",,,09/15/2014,"Download from usbank.com. HY VEE 1081 COLUCOLUMBIA    MO","Everyday Expenses:Spending Money","Everyday Expenses","Spending Money",,$23.03,$0.00,C,$3793.67
"Us Bank",,,09/15/2014,"Download from usbank.com. Wal-Mart Super CCOLUMBIA    MO","Everyday Expenses:Spending Money","Everyday Expenses","Spending Money",,$24.40,$0.00,C,$3769.27
"Us Bank",,,09/15/2014,"Download from usbank.com. H&M             COLUMBIA    MO","Everyday Expenses:Clothing","Everyday Expenses","Clothing",,$25.93,$0.00,C,$3743.34
"Us Bank",,,09/15/2014,"Download from usbank.com. GAP OUTLET USA  COLUMBIA    MO","Everyday Expenses:Clothing","Everyday Expenses","Clothing",,$26.69,$0.00,C,$3716.65
"Us Bank",,,09/15/2014,"Download from usbank.com. Taxi Terry      Columbia    MO","Everyday Expenses:Spending Money","Everyday Expenses","Spending Money",,$27.30,$0.00,C,$3689.35
"Us Bank",,,09/15/2014,"Download from usbank.com. FIELDHOUSE      COLUMBIA    MO","Everyday Expenses:Spending Money","Everyday Expenses","Spending Money",,$27.50,$0.00,C,$3661.85
"Us Bank",,,09/15/2014,"Download from usbank.com. MACADOODLES     COLUMBIA    MO","Everyday Expenses:Spending Money","Everyday Expenses","Spending Money",,$30.29,$0.00,C,$3631.56
"Us Bank",,,09/15/2014,"Download from usbank.com. GOOGLE*ADWS","Everyday Expenses:Spending Money","Everyday Expenses","Spending Money",,$52.56,$0.00,C,$3579.00
"Us Bank",,,09/15/2014,"Download from usbank.com. HY VEE 1081 COLUCOLUMBIA    MO","Everyday Expenses:Spending Money","Everyday Expenses","Spending Money",,$77.93,$0.00,C,$3501.07
"Us Bank",,,09/15/2014,"Download from usbank.com. BARCLAYS BANK DE","Savings Goals:Savings","Savings Goals","Savings",,$150.00,$0.00,C,$3351.07
"Us Bank",,,09/16/2014,"Download from usbank.com. TROPICAL LIQUEURCOLUMBIA    MO","Everyday Expenses:Spending Money","Everyday Expenses","Spending Money",,$4.00,$0.00,C,$3347.07
"Us Bank",,,09/16/2014,"Download from usbank.com. BARCLAYS BANK DE","Savings Goals:Savings","Savings Goals","Savings",,$150.00,$0.00,C,$3197.07
"Us Bank",,,09/18/2014,"Download from usbank.com. PAYPAL","Everyday Expenses:Spending Money","Everyday Expenses","Spending Money",,$9.99,$0.00,C,$3187.08
"Us Bank",,,09/18/2014,"Download from usbank.com. PAYPAL","Everyday Expenses:Spending Money","Everyday Expenses","Spending Money",,$13.01,$0.00,C,$3174.07
"Us Bank",,,09/18/2014,"Download from usbank.com. HY VEE 1081 COLUCOLUMBIA    MO","Everyday Expenses:Spending Money","Everyday Expenses","Spending Money",,$58.83,$0.00,C,$3115.24
"Us Bank",,,09/19/2014,"Download from usbank.com. HY VEE 1081 COLUCOLUMBIA    MO","Everyday Expenses:Spending Money","Everyday Expenses","Spending Money",,$12.04,$0.00,C,$3103.20
"Us Bank",,,09/19/2014,"Download from usbank.com. SPARKYS HOMEMADECOLUMBIA    MO","Everyday Expenses:Spending Money","Everyday Expenses","Spending Money",,$12.25,$0.00,C,$3090.95
"Us Bank",,,09/19/2014,"Download from usbank.com. HY VEE 1076     COLUMBIA    MO","Everyday Expenses:Spending Money","Everyday Expenses","Spending Money",,$17.28,$0.00,C,$3073.67
"Us Bank",,,09/19/2014,"Download from usbank.com. CNS PACIFIC SUNWCOLUMBIA    MO","Everyday Expenses:Spending Money","Everyday Expenses","Spending Money",,$21.68,$0.00,C,$3051.99
"Us Bank",,,09/19/2014,"Download from usbank.com. ATT","Monthly Bills:Cell Phone","Monthly Bills","Cell Phone",,$225.59,$0.00,C,$2826.40
"Us Bank",,,09/22/2014,"Download from usbank.com. Snappers Bar    COLUMBIA    MO","Everyday Expenses:Spending Money","Everyday Expenses","Spending Money",,$4.25,$0.00,C,$2822.15
"Us Bank",,,09/22/2014,"Download from usbank.com. MCNALLYS        COLUMBIA    MO","Everyday Expenses:Spending Money","Everyday Expenses","Spending Money",,$6.51,$0.00,C,$2815.64
"Us Bank",,,09/22/2014,"Download from usbank.com. NYWW Newport TV2Jersey City NJ","Everyday Expenses:Spending Money","Everyday Expenses","Spending Money",,$8.00,$0.00,C,$2807.64
"Us Bank",,,09/22/2014,"Download from usbank.com. AMC POPLAR BLUFFPOPLAR BLUFFMO","Everyday Expenses:Spending Money","Everyday Expenses","Spending Money",,$8.25,$0.00,C,$2799.39
"Us Bank",,,09/22/2014,"Download from usbank.com. EL RANCHO       COLUMBIA    MO","Everyday Expenses:Spending Money","Everyday Expenses","Spending Money",,$8.97,$0.00,C,$2790.42
"Us Bank",,,09/22/2014,"Download from usbank.com. PAYPAL","Monthly Bills:Web Stuff","Monthly Bills","Web Stuff",,$9.99,$0.00,C,$2780.43
"Us Bank",,,09/22/2014,"Download from usbank.com. BANGKOK GARDENS COLUMBIA    MO","Everyday Expenses:Spending Money","Everyday Expenses","Spending Money",,$10.71,$0.00,C,$2769.72
"Us Bank",,,09/22/2014,"Download from usbank.com. COLUMBIA LOCATIOCOLUMBIA    MO","Everyday Expenses:Spending Money","Everyday Expenses","Spending Money",,$13.00,$0.00,C,$2756.72
"Us Bank",,,09/22/2014,"Download from usbank.com. HUDDLE HOUSE #43POPLAR BLUFFMO","Everyday Expenses:Spending Money","Everyday Expenses","Spending Money",,$13.18,$0.00,C,$2743.54
"Us Bank",,,09/22/2014,"Download from usbank.com. LUTZS FAMOUS BBQCOLUMBIA    MO","Everyday Expenses:Spending Money","Everyday Expenses","Spending Money",,$13.87,$0.00,C,$2729.67
"Us Bank",,,09/22/2014,"Download from usbank.com. HOT BOX COOKIES COLUMBIA    MO","Everyday Expenses:Spending Money","Everyday Expenses","Spending Money",,$14.56,$0.00,C,$2715.11
"Us Bank",,,09/22/2014,"Download from usbank.com. CVS 04958 04958-BROOKLYN    NY","Everyday Expenses:Household Goods","Everyday Expenses","Household Goods",,$18.56,$0.00,C,$2696.55
"Us Bank",,,09/22/2014,"Download from usbank.com. SQ *CANTINA ROYABrooklyn    NY","Everyday Expenses:Spending Money","Everyday Expenses","Spending Money",,$21.05,$0.00,C,$2675.50
"Us Bank",,,09/22/2014,"Download from usbank.com. HUCK'S FOOD & FUPoplar BluffMO","Everyday Expenses:Spending Money","Everyday Expenses","Spending Money",,$30.41,$0.00,C,$2645.09
"Us Bank",,,09/22/2014,"Download from usbank.com. H&M             NEW YORK    NY","Everyday Expenses:Clothing","Everyday Expenses","Clothing",,$42.90,$0.00,C,$2602.19
"Us Bank",,,09/22/2014,"Download from usbank.com. FABBRICA        BROOKLYN    NY","Everyday Expenses:Spending Money","Everyday Expenses","Spending Money",,$47.59,$0.00,C,$2554.60
"Us Bank",,,09/23/2014,"Download from usbank.com.","Everyday Expenses:Spending Money","Everyday Expenses","Spending Money",,$0.00,$6.95,C,$2561.55
"Us Bank",,,09/23/2014,"Download from usbank.com. STUMPTOWN COFFEENEW YORK    NY","Everyday Expenses:Spending Money","Everyday Expenses","Spending Money",,$3.00,$0.00,C,$2558.55
"Us Bank",,,09/23/2014,"Download from usbank.com. STUMPTOWN COFFEENEW YORK    NY","Everyday Expenses:Spending Money","Everyday Expenses","Spending Money",,$3.50,$0.00,C,$2555.05
"Us Bank",,,09/23/2014,"Download from usbank.com.","Everyday Expenses:Spending Money","Everyday Expenses","Spending Money",,$6.95,$0.00,C,$2548.10
"Us Bank",,,09/23/2014,"Download from usbank.com. CHIPOTLE 1962   NEW YORK    NY","Everyday Expenses:Spending Money","Everyday Expenses","Spending Money",,$9.00,$0.00,C,$2539.10
"Us Bank",,,09/23/2014,"Download from usbank.com. PAYPAL","Everyday Expenses:Spending Money","Everyday Expenses","Spending Money",,$9.99,$0.00,C,$2529.11
"Us Bank",,,09/23/2014,"Download from usbank.com. MTA VENDING MACHNEW YORK    NY","Everyday Expenses:Transportation","Everyday Expenses","Transportation",,$10.00,$0.00,C,$2519.11
"Us Bank",,,09/23/2014,"Download from usbank.com. MTA VENDING MACHNEW YORK    NY","Everyday Expenses:Transportation","Everyday Expenses","Transportation",,$10.00,$0.00,C,$2509.11
"Us Bank",,,09/23/2014,"Download from usbank.com. MTA VENDING MACHNEW YORK    NY","Everyday Expenses:Transportation","Everyday Expenses","Transportation",,$10.00,$0.00,C,$2499.11
"Us Bank",,,09/23/2014,"Download from usbank.com. MTA VENDING MACHNEW YORK    NY","Everyday Expenses:Transportation","Everyday Expenses","Transportation",,$10.00,$0.00,C,$2489.11
"Us Bank",,,09/23/2014,"Download from usbank.com. E-18 CPK STL  20ST LOUIS    MO","Everyday Expenses:Spending Money","Everyday Expenses","Spending Money",,$11.25,$0.00,C,$2477.86
"Us Bank",,,09/23/2014,"Download from usbank.com. BROOKLYN HARVESTBROOKLYN    NY","Everyday Expenses:Spending Money","Everyday Expenses","Spending Money",,$14.55,$0.00,C,$2463.31
"Us Bank",,,09/23/2014,"Download from usbank.com. NYC YELLOW CAB  LONG IS CITYNY","Everyday Expenses:Transportation","Everyday Expenses","Transportation",,$29.90,$0.00,C,$2433.41
"Us Bank",,,09/24/2014,"Download from usbank.com. OD FEE SETTLEMEN","Everyday Expenses:Spending Money","Everyday Expenses","Spending Money",,$0.00,$9.03,C,$2442.44
"Us Bank",,,09/24/2014,"Download from usbank.com. CAFFE BENE      NEW YORK    NY","Everyday Expenses:Spending Money","Everyday Expenses","Spending Money",,$4.84,$0.00,C,$2437.60
"Us Bank",,,09/24/2014,"Download from usbank.com. 48 N DELI INC   BROOKLYN    NY","Everyday Expenses:Spending Money","Everyday Expenses","Spending Money",,$9.00,$0.00,C,$2428.60
"Us Bank",,,09/24/2014,"Download from usbank.com. PAYPAL","Everyday Expenses:Transportation","Everyday Expenses","Transportation",,$10.00,$0.00,C,$2418.60
"Us Bank",,,09/24/2014,"Download from usbank.com. EATALY SUPERMARKNEW YORK    NY","Everyday Expenses:Spending Money","Everyday Expenses","Spending Money",,$21.56,$0.00,C,$2397.04
"Us Bank",,,09/24/2014,"Download from usbank.com. THE SMITH MIDTOWNEW YORK    NY","Everyday Expenses:Spending Money","Everyday Expenses","Spending Money",,$60.26,$0.00,C,$2336.78
"Us Bank",,,09/25/2014,"Download from usbank.com. HLU*Hulu 2274453HULU.COM/BILCA","Monthly Bills:Web Stuff","Monthly Bills","Web Stuff",,$7.99,$0.00,C,$2328.79
"Us Bank",,,09/25/2014,"Download from usbank.com. MTA VENDING MACHNEW YORK    NY","Everyday Expenses:Transportation","Everyday Expenses","Transportation",,$10.00,$0.00,C,$2318.79
"Us Bank",,,09/25/2014,"Download from usbank.com. MTA VENDING MACHNEW YORK    NY","Everyday Expenses:Transportation","Everyday Expenses","Transportation",,$10.00,$0.00,C,$2308.79
"Us Bank",,,09/25/2014,"Download from usbank.com. LANDMARK TAVERN NEW YORK    NY","Everyday Expenses:Spending Money","Everyday Expenses","Spending Money",,$35.49,$0.00,C,$2273.30
"Us Bank",,,09/25/2014,"Download from usbank.com. DISTRICT TAP HOUNEW YORK    NY","Everyday Expenses:Spending Money","Everyday Expenses","Spending Money",,$70.06,$0.00,C,$2203.24
"Us Bank",,,09/26/2014,"Download from usbank.com. MODCLOTH INC","Income:Available next month","Income","Available next month",,$0.00,$1522.43,C,$3725.67
"Us Bank",,,09/26/2014,"Download from usbank.com. ROASTING PLANT CNEW YORK    NY","Everyday Expenses:Spending Money","Everyday Expenses","Spending Money",,$4.63,$0.00,C,$3721.04
"Us Bank",,,09/26/2014,"Download from usbank.com. 48 N DELI INC   BROOKLYN    NY","Everyday Expenses:Spending Money","Everyday Expenses","Spending Money",,$11.00,$0.00,C,$3710.04
"Us Bank",,,09/26/2014,"Download from usbank.com. THE RABBIT HOLE BROOKLYN    NY","Everyday Expenses:Spending Money","Everyday Expenses","Spending Money",,$25.00,$0.00,C,$3685.04
"Us Bank",,,09/26/2014,"Download from usbank.com. TINY FORK       NEW YORK    NY","Everyday Expenses:Spending Money","Everyday Expenses","Spending Money",,$75.69,$0.00,C,$3609.35
"Us Bank",,,09/29/2014,"Download from usbank.com. AMAZON DIG531663","Everyday Expenses:Spending Money","Everyday Expenses","Spending Money",,$0.00,$7.70,C,$3617.05
"Us Bank",,,09/29/2014,"Download from usbank.com. MTA VENDING MACHNEW YORK    NY","Everyday Expenses:Transportation","Everyday Expenses","Transportation",,$2.05,$0.00,C,$3615.00
"Us Bank",,,09/29/2014,"Download from usbank.com. 092714PLUSTERM754 METROPOLITANBROOKLYN    NYUS1","Everyday Expenses:Spending Money","Everyday Expenses","Spending Money",,$2.50,$0.00,C,$3612.50
"Us Bank",,,09/29/2014,"Download from usbank.com. CAFE BRAVO      NEW YORK    NY","Everyday Expenses:Spending Money","Everyday Expenses","Spending Money",,$15.59,$0.00,C,$3596.91
"Us Bank",,,09/29/2014,"Download from usbank.com. CHIPOTLE 1230   SAN FRANCISCCA","Everyday Expenses:Spending Money","Everyday Expenses","Spending Money",,$15.88,$0.00,C,$3581.03
"Us Bank",,,09/29/2014,"Download from usbank.com. SQ *ANOTHER CAFESan FranciscCA","Everyday Expenses:Spending Money","Everyday Expenses","Spending Money",,$19.79,$0.00,C,$3561.24
"Us Bank",,,09/29/2014,"Download from usbank.com. MURRAYS BAGEL   NEW YORK    NY","Everyday Expenses:Spending Money","Everyday Expenses","Spending Money",,$23.68,$0.00,C,$3537.56
"Us Bank",,,09/29/2014,"Download from usbank.com. OTG JFK T5 VENTUJAMAICA     NY","Everyday Expenses:Spending Money","Everyday Expenses","Spending Money",,$24.53,$0.00,C,$3513.03
"Us Bank",,,09/29/2014,"Download from usbank.com. ROSARITO RESTAURBROOKLYN    NY","Everyday Expenses:Spending Money","Everyday Expenses","Spending Money",,$31.22,$0.00,C,$3481.81
"Us Bank",,,09/29/2014,"Download from usbank.com. H&M             SAN FRANCISCCA","Everyday Expenses:Clothing","Everyday Expenses","Clothing",,$32.35,$0.00,C,$3449.46
"Us Bank",,,09/29/2014,"Download from usbank.com. 754 METROPOLITANBROOKLYN    NYUS1","Everyday Expenses:Spending Money","Everyday Expenses","Spending Money",,$42.00,$0.00,C,$3407.46
"Us Bank",,,09/29/2014,"Download from usbank.com. SPIKE HILL      BROOKLYN    NY","Everyday Expenses:Spending Money","Everyday Expenses","Spending Money",,$47.00,$0.00,C,$3360.46
"Us Bank",,,09/29/2014,"Download from usbank.com. WALGREENS 1300 BSAN FRANCISCCA","Everyday Expenses:Household Goods","Everyday Expenses","Household Goods",,$49.41,$0.00,C,$3311.05
"Us Bank",,,09/29/2014,"Download from usbank.com. TRADER JOE'S #20SAN FRANCISCCA","Everyday Expenses:Groceries","Everyday Expenses","Groceries",,$60.12,$0.00,C,$3250.93
"Us Bank",,,09/29/2014,"Download from usbank.com. BLUE RIBBON SUSHNEW YORK    NY","Everyday Expenses:Spending Money","Everyday Expenses","Spending Money",,$80.68,$0.00,C,$3170.25
"Us Bank",,,09/29/2014,"Download from usbank.com. BANANA REPUBLIC San FranciscCA","Everyday Expenses:Clothing","Everyday Expenses","Clothing",,$150.73,$0.00,C,$3019.52
"Us Bank",,,09/30/2014,"Download from usbank.com. SQWIGGLE INC","Income:Available next month","Income","Available next month",,$0.00,$1965.99,C,$4985.51
"Us Bank",,,09/30/2014,"Download from usbank.com. STARBUCKS #05404San FranciscCA","Everyday Expenses:Spending Money","Everyday Expenses","Spending Money",,$2.23,$0.00,C,$4983.28
"Us Bank",,,09/30/2014,"Download from usbank.com. SUTTER FINE FOODSAN FRANCISCCA","Everyday Expenses:Groceries","Everyday Expenses","Groceries",,$11.19,$0.00,C,$4972.09
"Us Bank",,,09/30/2014,"Download from usbank.com. DARWIN CAFE LLC SAN FRANCISCCA","Everyday Expenses:Spending Money","Everyday Expenses","Spending Money",,$12.00,$0.00,C,$4960.09
"Us Bank",,,09/30/2014,"Download from usbank.com. AMC VAN NESS 14 SAN FRANCISCCA","Everyday Expenses:Spending Money","Everyday Expenses","Spending Money",,$14.50,$0.00,C,$4945.59
"Us Bank",,,09/30/2014,"Download from usbank.com. JAMBER          SAN FRANCISCCA","Everyday Expenses:Spending Money","Everyday Expenses","Spending Money",,$17.00,$0.00,C,$4928.59
"Us Bank",,,09/30/2014,"Download from usbank.com. CUBANA SOCIAL   BROOKLYN    NY","Everyday Expenses:Spending Money","Everyday Expenses","Spending Money",,$36.03,$0.00,C,$4892.56
"Us Bank",,,09/30/2014,"Download from usbank.com. MARSHALLS MARSHACOLUMBIA    MO","Everyday Expenses:Clothing","Everyday Expenses","Clothing",,$56.37,$0.00,C,$4836.19
"Us Bank",,,09/30/2014,"Download from usbank.com. BARCLAYS BANK DE","Savings Goals:Savings","Savings Goals","Savings",,$150.00,$0.00,C,$4686.19
"Us Bank",,,10/01/2014,"Download from usbank.com. CHIPOTLE 1857   SAN FRANCISCCA","Everyday Expenses:Groceries","Everyday Expenses","Groceries",,$7.56,$0.00,C,$4678.63
"Us Bank",,,10/01/2014,"Download from usbank.com. SLIDERS         SAN FRANCISCCA","Everyday Expenses:Spending Money","Everyday Expenses","Spending Money",,$8.43,$0.00,C,$4670.20
"Us Bank",,,10/01/2014,"Download from usbank.com. Uber Technologie866-5761039 CA","Everyday Expenses:Transportation","Everyday Expenses","Transportation",,$10.74,$0.00,C,$4659.46
"Us Bank",,,10/01/2014,"Download from usbank.com. UTAH SALOON     SAN FRANCISCCA","Everyday Expenses:Spending Money","Everyday Expenses","Spending Money",,$28.00,$0.00,C,$4631.46
"Us Bank",,,10/01/2014,"Download from usbank.com. MET CAS INS CO","Monthly Bills:Car Insurance","Monthly Bills","Car Insurance",,$49.00,$0.00,C,$4582.46
"Us Bank",,,10/01/2014,"Download from usbank.com. BARCLAYS BANK DE","Savings Goals:Savings","Savings Goals","Savings",,$150.00,$0.00,C,$4432.46
"Us Bank",,,10/02/2014,"Download from usbank.com. APL* ITUNES.COM/866-712-7753CA","Everyday Expenses:Spending Money","Everyday Expenses","Spending Money",,$4.99,$0.00,C,$4427.47
"Us Bank",,,10/02/2014,"Download from usbank.com. CHIPOTLE 1857   SAN FRANCISCCA","Everyday Expenses:Groceries","Everyday Expenses","Groceries",,$7.56,$0.00,C,$4419.91
"Us Bank",,,10/02/2014,"Download from usbank.com. DAILYBURN       888-867-8304NY","Monthly Bills:Web Stuff","Monthly Bills","Web Stuff",,$10.00,$0.00,C,$4409.91
"Us Bank",,,10/02/2014,"Download from usbank.com. SQ *FINS ON THE San FranciscCA","Everyday Expenses:Spending Money","Everyday Expenses","Spending Money",,$10.00,$0.00,C,$4399.91
"Us Bank",,,10/02/2014,"Download from usbank.com. Uber Technologie866-5761039 CA","Everyday Expenses:Transportation","Everyday Expenses","Transportation",,$18.72,$0.00,C,$4381.19
"Us Bank",,,10/02/2014,"Download from usbank.com. 7246","Debt:Eric's Credit Card","Debt","Eric's Credit Card",,$500.00,$0.00,C,$3881.19
"Us Bank",,,10/03/2014,"Download from usbank.com. JAMBA JUICE #91 SAN FRANCISCCA","Everyday Expenses:Spending Money","Everyday Expenses","Spending Money",,$6.19,$0.00,C,$3875.00
"Us Bank",,,10/03/2014,"Download from usbank.com. SQ *BBC BARS AT San FranciscCA","Everyday Expenses:Spending Money","Everyday Expenses","Spending Money",,$10.00,$0.00,C,$3865.00
"Us Bank",,,10/03/2014,"Download from usbank.com. STARBUCKS CARD R800-782-7282WA","Everyday Expenses:Spending Money","Everyday Expenses","Spending Money",,$10.00,$0.00,C,$3855.00
"Us Bank",,,10/03/2014,"Download from usbank.com. SPRIG           415-894-5191CA","Everyday Expenses:Groceries","Everyday Expenses","Groceries",,$10.50,$0.00,C,$3844.50
"Us Bank",,,10/03/2014,"Download from usbank.com. SLIDERS DINER   SAN FRANCISCCA","Everyday Expenses:Spending Money","Everyday Expenses","Spending Money",,$11.42,$0.00,C,$3833.08
"Us Bank",,,10/03/2014,"Download from usbank.com. LYFT.COM FRI AT 855-280-0278CA","Everyday Expenses:Transportation","Everyday Expenses","Transportation",,$17.00,$0.00,C,$3816.08
"Us Bank",,,10/03/2014,"Download from usbank.com. TRADER JOE'S #20SAN FRANCISCCA","Everyday Expenses:Groceries","Everyday Expenses","Groceries",,$52.06,$0.00,C,$3764.02
"Us Bank",,,10/03/2014,"Download from usbank.com. CLASSPASS.COM CL8884935953  NY","Everyday Expenses:Spending Money","Everyday Expenses","Spending Money",,$99.00,$0.00,C,$3665.02
"Us Bank",,,10/03/2014,"Download from usbank.com. Mosser Companies","Monthly Bills:Rent","Monthly Bills","Rent",,$1582.72,$0.00,C,$2082.30
"Us Bank",,,10/06/2014,"Download from usbank.com. WALGREENS 1300 BSAN FRANCISCCA","Everyday Expenses:Household Goods","Everyday Expenses","Household Goods",,$1.19,$0.00,C,$2081.11
"Us Bank",,,10/06/2014,"Download from usbank.com. 100414PLUSTERM530 HAIGHT STREESAN FRANCISCCAUS1","Everyday Expenses:Spending Money","Everyday Expenses","Spending Money",,$2.50,$0.00,C,$2078.61
"Us Bank",,,10/06/2014,"Download from usbank.com. LYFT.COM SUN AT 855-280-0278CA","Everyday Expenses:Transportation","Everyday Expenses","Transportation",,$7.00,$0.00,C,$2071.61
"Us Bank",,,10/06/2014,"Download from usbank.com. Uber Technologie866-5761039 CA","Everyday Expenses:Transportation","Everyday Expenses","Transportation",,$7.93,$0.00,C,$2063.68
"Us Bank",,,10/06/2014,"Download from usbank.com. SQ *CURRY UP NOWSan FranciscCA","Everyday Expenses:Spending Money","Everyday Expenses","Spending Money",,$8.70,$0.00,C,$2054.98
"Us Bank",,,10/06/2014,"Download from usbank.com. WHOLE FOODS MARKSan FranciscCA","Everyday Expenses:Groceries","Everyday Expenses","Groceries",,$9.14,$0.00,C,$2045.84
"Us Bank",,,10/06/2014,"Download from usbank.com. PAYPAL","Everyday Expenses:Transportation","Everyday Expenses","Transportation",,$10.00,$0.00,C,$2035.84
"Us Bank",,,10/06/2014,"Download from usbank.com. FRAICHE         SAN FRANCISCCA","Everyday Expenses:Spending Money","Everyday Expenses","Spending Money",,$12.34,$0.00,C,$2023.50
"Us Bank",,,10/06/2014,"Download from usbank.com. BITE            SAN FRANCISCCA","Everyday Expenses:Spending Money","Everyday Expenses","Spending Money",,$12.45,$0.00,C,$2011.05
"Us Bank",,,10/06/2014,"Download from usbank.com. CAL ACADEMY   10SAN FRANCISCCA","Everyday Expenses:Spending Money","Everyday Expenses","Spending Money",,$15.23,$0.00,C,$1995.82
"Us Bank",,,10/06/2014,"Download from usbank.com. TRADER JOE'S #20SAN FRANCISCCA","Everyday Expenses:Groceries","Everyday Expenses","Groceries",,$17.06,$0.00,C,$1978.76
"Us Bank",,,10/06/2014,"Download from usbank.com. WHOLE FOODS MARKSan FranciscCA","Everyday Expenses:Groceries","Everyday Expenses","Groceries",,$17.61,$0.00,C,$1961.15
"Us Bank",,,10/06/2014,"Download from usbank.com. Uber Technologie866-5761039 CA","Everyday Expenses:Transportation","Everyday Expenses","Transportation",,$17.83,$0.00,C,$1943.32
"Us Bank",,,10/06/2014,"Download from usbank.com. CALIFORNIA ACADE415-379-8000CA","Everyday Expenses:Spending Money","Everyday Expenses","Spending Money",,$24.00,$0.00,C,$1919.32
"Us Bank",,,10/06/2014,"Download from usbank.com. SUSHI ROCK      SAN FRANCISCCA","Everyday Expenses:Spending Money","Everyday Expenses","Spending Money",,$25.39,$0.00,C,$1893.93
"Us Bank",,,10/06/2014,"Download from usbank.com. BEVERAGES & MORESAN FRANCISCCA","Everyday Expenses:Spending Money","Everyday Expenses","Spending Money",,$27.00,$0.00,C,$1866.93
"Us Bank",,,10/06/2014,"Download from usbank.com. TARGET T2766    SAN FRANCISCCA","Savings Goals:House Stuff","Savings Goals","House Stuff",,$36.21,$0.00,C,$1830.72
"Us Bank",,,10/06/2014,"Download from usbank.com. 530 HAIGHT STREESAN FRANCISCCAUS1","Everyday Expenses:Spending Money","Everyday Expenses","Spending Money",,$63.00,$0.00,C,$1767.72
"Us Bank",,,10/06/2014,"Download from usbank.com. THE GOLDEN GATE SAN FRANCISCCA","Everyday Expenses:Spending Money","Everyday Expenses","Spending Money",,$64.00,$0.00,C,$1703.72
"Us Bank",,,10/06/2014,"Download from usbank.com. UNITED      0162800-932-2732TX","Savings Goals:Vacation & Travel","Savings Goals","Vacation & Travel",,$308.20,$0.00,C,$1395.52
"Us Bank",,,10/06/2014,"Download from usbank.com. IRS","Everyday Expenses:Spending Money","Everyday Expenses","Spending Money",,$996.44,$0.00,C,$399.08
"Us Bank",,,10/07/2014,"Download from usbank.com. ROAM ARTISAN BURSAN FRANCISCCA","Everyday Expenses:Spending Money","Everyday Expenses","Spending Money",,$13.51,$0.00,C,$385.57
"Us Bank",,,10/07/2014,"Download from usbank.com. ROAM ARTISAN BURSAN FRANCISCCA","Everyday Expenses:Spending Money","Everyday Expenses","Spending Money",,$19.65,$0.00,C,$365.92
"Us Bank",,,10/07/2014,"Download from usbank.com. EAT24.COM       EAT24HOURS.CCA","Everyday Expenses:Spending Money","Everyday Expenses","Spending Money",,$19.68,$0.00,C,$346.24
"Us Bank",,,10/07/2014,"Download from usbank.com. WHOLE FOODS MARKSan FranciscCA","Everyday Expenses:Groceries","Everyday Expenses","Groceries",,$72.18,$0.00,C,$274.06
"Us Bank",,,10/08/2014,"Download from usbank.com. WHOLE FOODS MARKSan FranciscCA","Everyday Expenses:Groceries","Everyday Expenses","Groceries",,$47.66,$0.00,C,$226.40
"Us Bank",,,10/08/2014,"Download from usbank.com. TFI*TICKETFLY EV877-435-9849CA","Everyday Expenses:Spending Money","Everyday Expenses","Spending Money",,$55.62,$0.00,C,$170.78
"Us Bank",,,10/09/2014,"Download from usbank.com. AT&T PARK CONCESSAN FRANCISCCA","Everyday Expenses:Spending Money","Everyday Expenses","Spending Money",,$4.50,$0.00,C,$166.28
"Us Bank",,,10/09/2014,"Download from usbank.com. CHIPOTLE 1857   SAN FRANCISCCA","Everyday Expenses:Groceries","Everyday Expenses","Groceries",,$7.56,$0.00,C,$158.72
"Us Bank",,,10/09/2014,"Download from usbank.com. BEVERAGES & MORESAN FRANCISCCA","Everyday Expenses:Spending Money","Everyday Expenses","Spending Money",,$9.02,$0.00,C,$149.70
"Us Bank",,,10/09/2014,"Download from usbank.com. PAYPAL","Everyday Expenses:Spending Money","Everyday Expenses","Spending Money",,$10.00,$0.00,C,$139.70
"Us Bank",,,10/09/2014,"Download from usbank.com. AT&T PARK CONCESSAN FRANCISCCA","Everyday Expenses:Spending Money","Everyday Expenses","Spending Money",,$19.75,$0.00,C,$119.95
"Us Bank",,,10/10/2014,"Download from usbank.com. MODCLOTH INC","Income:Available this month","Income","Available this month",,$0.00,$1522.43,C,$1642.38
"Us Bank",,,10/10/2014,"Download from usbank.com. BARCLAYS BANK DE","Everyday Expenses:Spending Money","Everyday Expenses","Spending Money",,$0.00,$996.44,C,$2638.82
"Us Bank",,,10/10/2014,"Download from usbank.com. BAL*SpoonRocket 510-9219929 CA","Everyday Expenses:Groceries","Everyday Expenses","Groceries",,$8.70,$0.00,C,$2630.12
"Us Bank",,,10/10/2014,"Download from usbank.com. LYFT.COM THU AT 855-280-0278CA","Everyday Expenses:Transportation","Everyday Expenses","Transportation",,$9.00,$0.00,C,$2621.12
"Us Bank",,,10/10/2014,"Download from usbank.com. SQ *TWOFISH BAKISAN FRANCISCCA","Everyday Expenses:Spending Money","Everyday Expenses","Spending Money",,$13.59,$0.00,C,$2607.53
"Us Bank",,,10/10/2014,"Download from usbank.com. FLY             SAN FRANCISCCA","Everyday Expenses:Spending Money","Everyday Expenses","Spending Money",,$17.94,$0.00,C,$2589.59
"Us Bank",,,10/10/2014,"Download from usbank.com. CARDMEMBER SERV",,,,,$34.00,$0.00,C,$2555.59
"Us Bank",,,10/14/2014,"Download from usbank.com. CLASSPASS.COM   8884935953  NY","Everyday Expenses:Spending Money","Everyday Expenses","Spending Money",,$0.00,$98.00,C,$2653.59
"Us Bank",,,10/14/2014,"Download from usbank.com. SQ *GREENLID    San FranciscCA","Everyday Expenses:Spending Money","Everyday Expenses","Spending Money",,$3.00,$0.00,C,$2650.59
"Us Bank",,,10/14/2014,"Download from usbank.com. SQ *WORKSHOP CAFSan FranciscCA","Everyday Expenses:Spending Money","Everyday Expenses","Spending Money",,$5.00,$0.00,C,$2645.59
"Us Bank",,,10/14/2014,"Download from usbank.com. CVS 10189       SAN FRANCISCCA","Everyday Expenses:Household Goods","Everyday Expenses","Household Goods",,$6.87,$0.00,C,$2638.72
"Us Bank",,,10/14/2014,"Download from usbank.com. SQ *GREENLID    San FranciscCA","Everyday Expenses:Spending Money","Everyday Expenses","Spending Money",,$7.00,$0.00,C,$2631.72
"Us Bank",,,10/14/2014,"Download from usbank.com. CHIPOTLE 1857   SAN FRANCISCCA","Everyday Expenses:Groceries","Everyday Expenses","Groceries",,$7.56,$0.00,C,$2624.16
"Us Bank",,,10/14/2014,"Download from usbank.com. LYFT.COM MON AT 855-280-0278CA","Everyday Expenses:Transportation","Everyday Expenses","Transportation",,$8.00,$0.00,C,$2616.16
"Us Bank",,,10/14/2014,"Download from usbank.com. BEVERAGES & MORESAN FRANCISCCA","Everyday Expenses:Spending Money","Everyday Expenses","Spending Money",,$9.02,$0.00,C,$2607.14
"Us Bank",,,10/14/2014,"Download from usbank.com. EAT24.COM       EAT24HOURS.CCA","Everyday Expenses:Spending Money","Everyday Expenses","Spending Money",,$9.89,$0.00,C,$2597.25
"Us Bank",,,10/14/2014,"Download from usbank.com. PAYPAL","Everyday Expenses:Spending Money","Everyday Expenses","Spending Money",,$10.00,$0.00,C,$2587.25
"Us Bank",,,10/14/2014,"Download from usbank.com. BEAN BAG CAFE   SAN FRANCISCCA","Everyday Expenses:Spending Money","Everyday Expenses","Spending Money",,$15.09,$0.00,C,$2572.16
"Us Bank",,,10/14/2014,"Download from usbank.com. BAR BASIC       SAN FRANCISCCA","Everyday Expenses:Spending Money","Everyday Expenses","Spending Money",,$17.00,$0.00,C,$2555.16
"Us Bank",,,10/14/2014,"Download from usbank.com. CHIPOTLE 1230   SAN FRANCISCCA","Everyday Expenses:Spending Money","Everyday Expenses","Spending Money",,$17.55,$0.00,C,$2537.61
"Us Bank",,,10/14/2014,"Download from usbank.com. AMC VAN NESS 14 SAN FRANCISCCA","Everyday Expenses:Spending Money","Everyday Expenses","Spending Money",,$24.50,$0.00,C,$2513.11
"Us Bank",,,10/14/2014,"Download from usbank.com. TOAST           SAN FRANCISCCA","Everyday Expenses:Spending Money","Everyday Expenses","Spending Money",,$29.64,$0.00,C,$2483.47
"Us Bank",,,10/14/2014,"Download from usbank.com. LELAND TEA COMPASAN FRANCISCCA","Everyday Expenses:Spending Money","Everyday Expenses","Spending Money",,$30.75,$0.00,C,$2452.72
"Us Bank",,,10/14/2014,"Download from usbank.com. WALGREENS 1300 BSAN FRANCISCCA","Everyday Expenses:Household Goods","Everyday Expenses","Household Goods",,$42.36,$0.00,C,$2410.36
"Us Bank",,,10/14/2014,"Download from usbank.com. HYDE STREET STUD415-441-8934CA","Everyday Expenses:Spending Money","Everyday Expenses","Spending Money",,$100.00,$0.00,C,$2310.36
"Us Bank",,,10/14/2014,"Download from usbank.com. US BANK NORTH BESAN FRANCISCCAUS1","Everyday Expenses:Spending Money","Everyday Expenses","Spending Money",,$100.00,$0.00,C,$2210.36
"Us Bank",,,10/14/2014,"Download from usbank.com. GUITAR CENTER #2SAN FRANCISCCA","Everyday Expenses:Spending Money","Everyday Expenses","Spending Money",,$119.63,$0.00,C,$2090.73
"Us Bank",,,10/14/2014,"Download from usbank.com. BARCLAYS BANK DE","Savings Goals:Savings","Savings Goals","Savings",,$150.00,$0.00,C,$1940.73
"Us Bank",,,10/14/2014,"Download from usbank.com. COMCAST","Monthly Bills:Utilities","Monthly Bills","Utilities",,$151.30,$0.00,C,$1789.43
"Us Bank",,,10/15/2014,"Download from usbank.com. SQWIGGLE INC","Income:Available this month","Income","Available this month",,$0.00,$1965.99,C,$3755.42
"Us Bank",,,10/15/2014,"Download from usbank.com. BARRYS BOOTCAMP SAN FRANCISCCA","Everyday Expenses:Spending Money","Everyday Expenses","Spending Money",,$8.00,$0.00,C,$3747.42
"Us Bank",,,10/15/2014,"Download from usbank.com. TACQUERIA DOS AMSAN FRANCISCCA","Everyday Expenses:Spending Money","Everyday Expenses","Spending Money",,$8.66,$0.00,C,$3738.76
"Us Bank",,,10/15/2014,"Download from usbank.com. BAL*SpoonRocket 510-9219929 CA","Everyday Expenses:Groceries","Everyday Expenses","Groceries",,$8.70,$0.00,C,$3730.06
"Us Bank",,,10/15/2014,"Download from usbank.com. SQ *ANOTHER CAFESan FranciscCA","Everyday Expenses:Spending Money","Everyday Expenses","Spending Money",,$11.45,$0.00,C,$3718.61
"Us Bank",,,10/15/2014,"Download from usbank.com. TJ TJ MAXX      SFRANCISO   CA","Everyday Expenses:Clothing","Everyday Expenses","Clothing",,$44.55,$0.00,C,$3674.06
"Us Bank",,,10/15/2014,"Download from usbank.com. WHOLE FOODS MARKSan FranciscCA","Everyday Expenses:Groceries","Everyday Expenses","Groceries",,$106.14,$0.00,C,$3567.92
"Us Bank",,,10/15/2014,"Download from usbank.com. BARCLAYS BANK DE","Savings Goals:Savings","Savings Goals","Savings",,$150.00,$0.00,C,$3417.92
"Us Bank",,,10/16/2014,"Download from usbank.com. WALGREENS 135 POSAN FRANCISCCA","Everyday Expenses:Household Goods","Everyday Expenses","Household Goods",,$7.51,$0.00,C,$3410.41
"Us Bank",,,10/16/2014,"Download from usbank.com. CHILI LEMON GARLSAN FRANCISCCA","Everyday Expenses:Spending Money","Everyday Expenses","Spending Money",,$22.50,$0.00,C,$3387.91
"Us Bank",,,10/17/2014,"Download from usbank.com. BARRYS BOOTCAMP SAN FRANCISCCA","Everyday Expenses:Spending Money","Everyday Expenses","Spending Money",,$8.00,$0.00,C,$3379.91
"Us Bank",,,10/17/2014,"Download from usbank.com. CHIPOTLE 1230   SAN FRANCISCCA","Everyday Expenses:Spending Money","Everyday Expenses","Spending Money",,$9.72,$0.00,C,$3370.19
"Us Bank",,,10/20/2014,"Download from usbank.com. WALGREENS 1300 BSAN FRANCISCCA","Everyday Expenses:Household Goods","Everyday Expenses","Household Goods",,$3.62,$0.00,C,$3366.57
"Us Bank",,,10/20/2014,"Download from usbank.com. SQ *BLUE BOTTLE San FranciscCA","Everyday Expenses:Spending Money","Everyday Expenses","Spending Money",,$3.75,$0.00,C,$3362.82
"Us Bank",,,10/20/2014,"Download from usbank.com. CVS 10189       SAN FRANCISCCA","Everyday Expenses:Household Goods","Everyday Expenses","Household Goods",,$4.29,$0.00,C,$3358.53
"Us Bank",,,10/20/2014,"Download from usbank.com. SQ *GREENLID    San FranciscCA","Everyday Expenses:Spending Money","Everyday Expenses","Spending Money",,$8.00,$0.00,C,$3350.53
"Us Bank",,,10/20/2014,"Download from usbank.com. BAL*SpoonRocket 510-9219929 CA","Everyday Expenses:Groceries","Everyday Expenses","Groceries",,$8.70,$0.00,C,$3341.83
"Us Bank",,,10/20/2014,"Download from usbank.com. CVS 10080       SAN FRANCISCCA","Everyday Expenses:Household Goods","Everyday Expenses","Household Goods",,$9.23,$0.00,C,$3332.60
"Us Bank",,,10/20/2014,"Download from usbank.com. Uber Technologie866-5761039 CA","Everyday Expenses:Transportation","Everyday Expenses","Transportation",,$9.83,$0.00,C,$3322.77
"Us Bank",,,10/20/2014,"Download from usbank.com. PAYPAL","Everyday Expenses:Spending Money","Everyday Expenses","Spending Money",,$9.99,$0.00,C,$3312.78
"Us Bank",,,10/20/2014,"Download from usbank.com. PAYPAL","Everyday Expenses:Spending Money","Everyday Expenses","Spending Money",,$9.99,$0.00,C,$3302.79
"Us Bank",,,10/20/2014,"Download from usbank.com. PAYPAL","Everyday Expenses:Spending Money","Everyday Expenses","Spending Money",,$10.00,$0.00,C,$3292.79
"Us Bank",,,10/20/2014,"Download from usbank.com. FARM FRESH TO YOSAN FRANCISCCA","Everyday Expenses:Spending Money","Everyday Expenses","Spending Money",,$10.40,$0.00,C,$3282.39
"Us Bank",,,10/20/2014,"Download from usbank.com. BITE            SAN FRANCISCCA","Everyday Expenses:Spending Money","Everyday Expenses","Spending Money",,$10.86,$0.00,C,$3271.53
"Us Bank",,,10/20/2014,"Download from usbank.com. WALGREENS 1524 PSAN FRANCISCCA","Everyday Expenses:Household Goods","Everyday Expenses","Household Goods",,$17.60,$0.00,C,$3253.93
"Us Bank",,,10/20/2014,"Download from usbank.com. THE GOLDEN GATE SAN FRANCISCCA","Everyday Expenses:Spending Money","Everyday Expenses","Spending Money",,$19.00,$0.00,C,$3234.93
"Us Bank",,,10/20/2014,"Download from usbank.com. VENMO           855-812-4430NY","Everyday Expenses:Spending Money","Everyday Expenses","Spending Money",,$20.00,$0.00,C,$3214.93
"Us Bank",,,10/20/2014,"Download from usbank.com. JAPAN KATANA YA SAN FRANCISCCA","Everyday Expenses:Spending Money","Everyday Expenses","Spending Money",,$25.00,$0.00,C,$3189.93
"Us Bank",,,10/20/2014,"Download from usbank.com. MOULIN CAFE/887 SAN FRANCISCCA","Everyday Expenses:Spending Money","Everyday Expenses","Spending Money",,$25.00,$0.00,C,$3164.93
"Us Bank",,,10/20/2014,"Download from usbank.com. Mars Bar & RestaSan FranciscCA","Everyday Expenses:Spending Money","Everyday Expenses","Spending Money",,$26.00,$0.00,C,$3138.93
"Us Bank",,,10/20/2014,"Download from usbank.com. TRADER JOE'S #20SAN FRANCISCCA","Everyday Expenses:Groceries","Everyday Expenses","Groceries",,$28.25,$0.00,C,$3110.68
"Us Bank",,,10/20/2014,"Download from usbank.com. UMAMI SOMA      SANFRANCISCOCA","Everyday Expenses:Spending Money","Everyday Expenses","Spending Money",,$28.37,$0.00,C,$3082.31
"Us Bank",,,10/20/2014,"Download from usbank.com. WALGREENS 1300 BSAN FRANCISCCA","Everyday Expenses:Household Goods","Everyday Expenses","Household Goods",,$29.65,$0.00,C,$3052.66
"Us Bank",,,10/20/2014,"Download from usbank.com. 5A5 STEAK LOUNGESAN FRANCISCCA","Everyday Expenses:Spending Money","Everyday Expenses","Spending Money",,$33.72,$0.00,C,$3018.94
"Us Bank",,,10/20/2014,"Download from usbank.com. URBAN-OUTFITTERS972-550-2751PA","Everyday Expenses:Clothing","Everyday Expenses","Clothing",,$37.58,$0.00,C,$2981.36
"Us Bank",,,10/20/2014,"Download from usbank.com. SUSHI ROCK      SAN FRANCISCCA","Everyday Expenses:Spending Money","Everyday Expenses","Spending Money",,$43.59,$0.00,C,$2937.77
"Us Bank",,,10/20/2014,"Download from usbank.com. AMZ*Beautifi4157SAN FRANCISCCA","Everyday Expenses:Spending Money","Everyday Expenses","Spending Money",,$64.90,$0.00,C,$2872.87
"Us Bank",,,10/20/2014,"Download from usbank.com. MODCLOTH INC.   888-4959699 CA","Everyday Expenses:Clothing","Everyday Expenses","Clothing",,$102.84,$0.00,C,$2770.03
"Us Bank",,,10/20/2014,"Download from usbank.com. SQ *JON KERTZMANSAN FRANCISCCA","Everyday Expenses:Misc","Everyday Expenses","Misc",,$162.50,$0.00,C,$2607.53
"Us Bank",,,10/20/2014,"Download from usbank.com. ATT","Monthly Bills:Cell Phone","Monthly Bills","Cell Phone",,$246.14,$0.00,C,$2361.39
"Us Bank",,,10/20/2014,"Download from usbank.com. HYDE STREET STUDSAN FRANCISCCA","Everyday Expenses:Misc","Everyday Expenses","Misc",,$275.00,$0.00,C,$2086.39
"Us Bank",,,10/21/2014,"Download from usbank.com. VENMO","Everyday Expenses:Spending Money","Everyday Expenses","Spending Money",,$0.00,$102.00,C,$2188.39
"Us Bank",,,10/21/2014,"Download from usbank.com. PANDA EXPRESS #1SAN FRANCISCCA","Everyday Expenses:Spending Money","Everyday Expenses","Spending Money",,$8.81,$0.00,C,$2179.58
"Us Bank",,,10/21/2014,"Download from usbank.com. TRADER JOE'S #20SAN FRANCISCCA","Everyday Expenses:Groceries","Everyday Expenses","Groceries",,$47.77,$0.00,C,$2131.81
"Us Bank",,,10/21/2014,"Download from usbank.com. VENMO","Everyday Expenses:Spending Money","Everyday Expenses","Spending Money",,$116.98,$0.00,C,$2014.83
"Us Bank",,,10/22/2014,"Download from usbank.com. WORKING GIRLS CASAN FRANCISCCA","Everyday Expenses:Spending Money","Everyday Expenses","Spending Money",,$10.73,$0.00,C,$2004.10
"Us Bank",,,10/22/2014,"Download from usbank.com. EAT24.COM       EAT24HOURS.CCA","Everyday Expenses:Spending Money","Everyday Expenses","Spending Money",,$10.98,$0.00,C,$1993.12
"Us Bank",,,10/22/2014,"Download from usbank.com. BART-CIVIC CENTESAN FRANCISCCA","Everyday Expenses:Transportation","Everyday Expenses","Transportation",,$17.30,$0.00,C,$1975.82
"Us Bank",,,10/22/2014,"Download from usbank.com. TRADER JOE'S #20SAN FRANCISCCA","Everyday Expenses:Groceries","Everyday Expenses","Groceries",,$33.24,$0.00,C,$1942.58
"Us Bank",,,10/23/2014,"Download from usbank.com.","Everyday Expenses:Spending Money","Everyday Expenses","Spending Money",,$0.00,$6.95,C,$1949.53
"Us Bank",,,10/23/2014,"Download from usbank.com.","Everyday Expenses:Spending Money","Everyday Expenses","Spending Money",,$6.95,$0.00,C,$1942.58
"Us Bank",,,10/23/2014,"Download from usbank.com. SUPER DUPER BURGSAN FRANCISCCA","Everyday Expenses:Spending Money","Everyday Expenses","Spending Money",,$8.16,$0.00,C,$1934.42
"Us Bank",,,10/23/2014,"Download from usbank.com. PAYPAL","Everyday Expenses:Spending Money","Everyday Expenses","Spending Money",,$9.99,$0.00,C,$1924.43
"Us Bank",,,10/23/2014,"Download from usbank.com. LYFT.COM WED AT 855-280-0278CA","Everyday Expenses:Transportation","Everyday Expenses","Transportation",,$14.00,$0.00,C,$1910.43
"Us Bank",,,10/24/2014,"Download from usbank.com. MODCLOTH INC","Income:Available this month","Income","Available this month",,$0.00,$1522.44,C,$3432.87
"Us Bank",,,10/24/2014,"Download from usbank.com. BAL*SpoonRocket 510-9219929 CA","Everyday Expenses:Groceries","Everyday Expenses","Groceries",,$8.70,$0.00,C,$3424.17
"Us Bank",,,10/24/2014,"Download from usbank.com. Spotify USA     877-778-1161NY","Monthly Bills:Web Stuff","Monthly Bills","Web Stuff",,$9.99,$0.00,C,$3414.18
"Us Bank",,,10/24/2014,"Download from usbank.com. SUTTER FINE FOODSAN FRANCISCCA","Everyday Expenses:Groceries","Everyday Expenses","Groceries",,$21.82,$0.00,C,$3392.36
"Us Bank",,,10/24/2014,"Download from usbank.com. RHODES 101 STOPSFARMINGTON  MO","Everyday Expenses:Spending Money","Everyday Expenses","Spending Money",,$31.98,$0.00,C,$3360.38
"Us Bank",,,10/27/2014,"Download from usbank.com. DOMINOS 7764    SAN FRANCISCCA","Everyday Expenses:Spending Money","Everyday Expenses","Spending Money",,$5.19,$0.00,C,$3355.19
"Us Bank",,,10/27/2014,"Download from usbank.com. THE CREPE HOUSE SAN FRANCISCCA","Everyday Expenses:Spending Money","Everyday Expenses","Spending Money",,$5.98,$0.00,C,$3349.21
"Us Bank",,,10/27/2014,"Download from usbank.com. WOERNER'S LIQUORSAN FRANCISCCA","Everyday Expenses:Spending Money","Everyday Expenses","Spending Money",,$7.60,$0.00,C,$3341.61
"Us Bank",,,10/27/2014,"Download from usbank.com. HLU*Hulu 2274453HULU.COM/BILCA","Monthly Bills:Web Stuff","Monthly Bills","Web Stuff",,$7.99,$0.00,C,$3333.62
"Us Bank",,,10/27/2014,"Download from usbank.com. SLIDERS DINER   SAN FRANCISCCA","Everyday Expenses:Spending Money","Everyday Expenses","Spending Money",,$11.42,$0.00,C,$3322.20
"Us Bank",,,10/27/2014,"Download from usbank.com. UNITED      0162800-932-2732TX","Savings Goals:Vacation & Travel","Savings Goals","Vacation & Travel",,$13.48,$0.00,C,$3308.72
"Us Bank",,,10/27/2014,"Download from usbank.com. THE OWL TREE    SAN FRANCISCCA","Everyday Expenses:Spending Money","Everyday Expenses","Spending Money",,$14.05,$0.00,C,$3294.67
"Us Bank",,,10/27/2014,"Download from usbank.com. TRADER JOE'S #20SAN FRANCISCCA","Everyday Expenses:Groceries","Everyday Expenses","Groceries",,$15.25,$0.00,C,$3279.42
"Us Bank",,,10/27/2014,"Download from usbank.com. BAL*SpoonRocket 510-9219929 CA","Everyday Expenses:Groceries","Everyday Expenses","Groceries",,$17.40,$0.00,C,$3262.02
"Us Bank",,,10/27/2014,"Download from usbank.com. WALGREENS 1300 BSAN FRANCISCCA","Everyday Expenses:Household Goods","Everyday Expenses","Household Goods",,$17.48,$0.00,C,$3244.54
"Us Bank",,,10/27/2014,"Download from usbank.com. AMC POPLAR BLUFFPOPLAR BLUFFMO","Everyday Expenses:Spending Money","Everyday Expenses","Spending Money",,$18.48,$0.00,C,$3226.06
"Us Bank",,,10/27/2014,"Download from usbank.com. US BANK POPLAR BPOPLAR BLUFFMOUS1","Everyday Expenses:Spending Money","Everyday Expenses","Spending Money",,$20.00,$0.00,C,$3206.06
"Us Bank",,,10/27/2014,"Download from usbank.com. WALGREENS 1300 BSAN FRANCISCCA","Everyday Expenses:Household Goods","Everyday Expenses","Household Goods",,$20.27,$0.00,C,$3185.79
"Us Bank",,,10/27/2014,"Download from usbank.com. US BANK POPLAR BPOPLAR BLUFFMOUS1","Everyday Expenses:Spending Money","Everyday Expenses","Spending Money",,$40.00,$0.00,C,$3145.79
"Us Bank",,,10/27/2014,"Download from usbank.com. MODCLOTH INC.   888-4959699 CA","Everyday Expenses:Clothing","Everyday Expenses","Clothing",,$53.64,$0.00,C,$3092.15
"Us Bank",,,10/27/2014,"Download from usbank.com. 7246","Debt:Eric's Credit Card","Debt","Eric's Credit Card",,$1000.00,$0.00,C,$2092.15
"Us Bank",,,10/28/2014,"Download from usbank.com. AMAZON DIG540703","Everyday Expenses:Spending Money","Everyday Expenses","Spending Money",,$0.00,$3.50,C,$2095.65
"Us Bank",,,10/28/2014,"Download from usbank.com. CHIPOTLE 1857   SAN FRANCISCCA","Everyday Expenses:Groceries","Everyday Expenses","Groceries",,$7.56,$0.00,C,$2088.09
"Us Bank",,,10/28/2014,"Download from usbank.com. FLY             SAN FRANCISCCA","Everyday Expenses:Spending Money","Everyday Expenses","Spending Money",,$8.97,$0.00,C,$2079.12
"Us Bank",,,10/28/2014,"Download from usbank.com. STARBUCKS CARD R800-782-7282WA","Everyday Expenses:Spending Money","Everyday Expenses","Spending Money",,$20.00,$0.00,C,$2059.12
"Us Bank",,,10/28/2014,"Download from usbank.com. BARCLAYS BANK DE","Savings Goals:Savings","Savings Goals","Savings",,$150.00,$0.00,C,$1909.12
"Us Bank",,,10/29/2014,"Download from usbank.com. WORKING GIRLS CASAN FRANCISCCA","Everyday Expenses:Spending Money","Everyday Expenses","Spending Money",,$10.73,$0.00,C,$1898.39
"Us Bank",,,10/29/2014,"Download from usbank.com. Amazon.com      AMZN.COM/BILWA","Everyday Expenses:Spending Money","Everyday Expenses","Spending Money",,$10.82,$0.00,C,$1887.57
"Us Bank",,,10/29/2014,"Download from usbank.com. SUTTER FINE FOODSAN FRANCISCCA","Everyday Expenses:Groceries","Everyday Expenses","Groceries",,$11.19,$0.00,C,$1876.38
"Us Bank",,,10/29/2014,"Download from usbank.com. AMAZON MKTPLACE AMZN.COM/BILWA","Everyday Expenses:Spending Money","Everyday Expenses","Spending Money",,$13.25,$0.00,C,$1863.13
"Us Bank",,,10/29/2014,"Download from usbank.com. MAURICES 1035 MAPOPLAR BLUFFMO","Everyday Expenses:Clothing","Everyday Expenses","Clothing",,$40.87,$0.00,C,$1822.26
"Us Bank",,,10/30/2014,"Download from usbank.com. AMAZON MKTPLACE AMZN.COM/BILWA","Everyday Expenses:Spending Money","Everyday Expenses","Spending Money",,$4.92,$0.00,C,$1817.34
"Us Bank",,,10/30/2014,"Download from usbank.com. Amazon.com      AMZN.COM/BILWA","Everyday Expenses:Spending Money","Everyday Expenses","Spending Money",,$9.40,$0.00,C,$1807.94
"Us Bank",,,10/30/2014,"Download from usbank.com. WALGREENS 1300 BSAN FRANCISCCA","Everyday Expenses:Household Goods","Everyday Expenses","Household Goods",,$15.44,$0.00,C,$1792.50
"Us Bank",,,10/30/2014,"Download from usbank.com. GULF OIL 9205456DE SOTO     MO","Everyday Expenses:Spending Money","Everyday Expenses","Spending Money",,$24.17,$0.00,C,$1768.33
"Us Bank",,,10/30/2014,"Download from usbank.com. AMAZON MKTPLACE AMZN.COM/BILWA","Everyday Expenses:Spending Money","Everyday Expenses","Spending Money",,$50.40,$0.00,C,$1717.93
"Us Bank",,,10/30/2014,"Download from usbank.com. MODCLOTH INC.   888-4959699 CA","Everyday Expenses:Clothing","Everyday Expenses","Clothing",,$110.97,$0.00,C,$1606.96
"Us Bank",,,10/30/2014,"Download from usbank.com. MODCLOTH INC.   888-4959699 CA","Everyday Expenses:Clothing","Everyday Expenses","Clothing",,$112.82,$0.00,C,$1494.14
"Us Bank",,,10/31/2014,"Download from usbank.com. SQWIGGLE INC","Income:Available next month","Income","Available next month",,$0.00,$1965.99,C,$3460.13
"Us Bank",,,10/31/2014,"Download from usbank.com. VENMO","Everyday Expenses:Clothing","Everyday Expenses","Clothing",,$0.00,$106.16,C,$3566.29
"Us Bank",,,10/31/2014,"Download from usbank.com.","Everyday Expenses:Spending Money","Everyday Expenses","Spending Money",,$2.50,$0.00,C,$3563.79
"Us Bank",,,10/31/2014,"Download from usbank.com. 103114PLUSTERM475 3RD ST      SAN FRANCISCCAUS1","Everyday Expenses:Spending Money","Everyday Expenses","Spending Money",,$2.50,$0.00,C,$3561.29
"Us Bank",,,10/31/2014,"Download from usbank.com. WALGREENS 459 POSAN FRANCISCCA","Everyday Expenses:Household Goods","Everyday Expenses","Household Goods",,$9.64,$0.00,C,$3551.65
"Us Bank",,,10/31/2014,"Download from usbank.com. SLIDERS DINER   SAN FRANCISCCA","Everyday Expenses:Spending Money","Everyday Expenses","Spending Money",,$11.42,$0.00,C,$3540.23
"Us Bank",,,10/31/2014,"Download from usbank.com. WICHCRAFT SAN FRSAN FRANCISCCA","Everyday Expenses:Spending Money","Everyday Expenses","Spending Money",,$11.50,$0.00,C,$3528.73
"Us Bank",,,10/31/2014,"Download from usbank.com. A-9 INTERNAL B20SAINT LOUIS MO","Everyday Expenses:Spending Money","Everyday Expenses","Spending Money",,$12.40,$0.00,C,$3516.33
"Us Bank",,,10/31/2014,"Download from usbank.com. BAL*SpoonRocket 510-9219929 CA","Everyday Expenses:Groceries","Everyday Expenses","Groceries",,$17.40,$0.00,C,$3498.93
"Us Bank",,,10/31/2014,"Download from usbank.com. CHIPOTLE 1230   SAN FRANCISCCA","Everyday Expenses:Spending Money","Everyday Expenses","Spending Money",,$18.37,$0.00,C,$3480.56
"Us Bank",,,10/31/2014,"Download from usbank.com. 475 3RD ST      SAN FRANCISCCAUS1","Everyday Expenses:Spending Money","Everyday Expenses","Spending Money",,$62.00,$0.00,C,$3418.56
"Us Bank",,,11/03/2014,"Download from usbank.com. VENMO","Everyday Expenses:Clothing","Everyday Expenses","Clothing",,$0.00,$16.00,C,$3434.56
"Us Bank",,,11/03/2014,"Download from usbank.com. CUP A JOES COFFESAN FRANCISCCA","Everyday Expenses:Spending Money","Everyday Expenses","Spending Money",,$5.25,$0.00,C,$3429.31
"Us Bank",,,11/03/2014,"Download from usbank.com. SUTTER FINE FOODSAN FRANCISCCA","Everyday Expenses:Groceries","Everyday Expenses","Groceries",,$7.93,$0.00,C,$3421.38
"Us Bank",,,11/03/2014,"Download from usbank.com. BITE            SAN FRANCISCCA","Everyday Expenses:Spending Money","Everyday Expenses","Spending Money",,$9.23,$0.00,C,$3412.15
"Us Bank",,,11/03/2014,"Download from usbank.com. BAMBOO ASIA     SAN FRANCISCCA","Everyday Expenses:Spending Money","Everyday Expenses","Spending Money",,$9.73,$0.00,C,$3402.42
"Us Bank",,,11/03/2014,"Download from usbank.com. FLY             SAN FRANCISCCA","Everyday Expenses:Spending Money","Everyday Expenses","Spending Money",,$11.00,$0.00,C,$3391.42
"Us Bank",,,11/03/2014,"Download from usbank.com. SQ *CAFE BEAN   San FranciscCA","Everyday Expenses:Spending Money","Everyday Expenses","Spending Money",,$15.94,$0.00,C,$3375.48
"Us Bank",,,11/03/2014,"Download from usbank.com. ANGRAY FANTASTICSAN FRANCISCCA","Everyday Expenses:Spending Money","Everyday Expenses","Spending Money",,$16.20,$0.00,C,$3359.28
"Us Bank",,,11/03/2014,"Download from usbank.com. WALGREENS 1300 BSAN FRANCISCCA","Everyday Expenses:Household Goods","Everyday Expenses","Household Goods",,$16.30,$0.00,C,$3342.98
"Us Bank",,,11/03/2014,"Download from usbank.com. Wal-Mart Store  UKIAH       CA","Everyday Expenses:Household Goods","Everyday Expenses","Household Goods",,$17.74,$0.00,C,$3325.24
"Us Bank",,,11/03/2014,"Download from usbank.com. SUSHI ROCK      SAN FRANCISCCA","Everyday Expenses:Spending Money","Everyday Expenses","Spending Money",,$25.74,$0.00,C,$3299.50
"Us Bank",,,11/03/2014,"Download from usbank.com. FLY             SAN FRANCISCCA","Everyday Expenses:Spending Money","Everyday Expenses","Spending Money",,$44.96,$0.00,C,$3254.54
"Us Bank",,,11/03/2014,"Download from usbank.com. MET CAS INS CO","Monthly Bills:Car Insurance","Monthly Bills","Car Insurance",,$49.00,$0.00,C,$3205.54
"Us Bank",,,11/03/2014,"Download from usbank.com. CLASSPASS.COM CL888-493-5953NY","Everyday Expenses:Spending Money","Everyday Expenses","Spending Money",,$99.00,$0.00,C,$3106.54
"Us Bank",,,11/03/2014,"Download from usbank.com. TRADER JOE'S #20SAN FRANCISCCA","Everyday Expenses:Groceries","Everyday Expenses","Groceries",,$111.01,$0.00,C,$2995.53
"Us Bank",,,11/03/2014,"Download from usbank.com. SFMTA CIT PYMNT 415-7013000 CA","Everyday Expenses:Spending Money","Everyday Expenses","Spending Money",,$111.50,$0.00,C,$2884.03
"Us Bank",,,11/03/2014,"Download from usbank.com. BARCLAYS BANK DE","Savings Goals:Savings","Savings Goals","Savings",,$150.00,$0.00,C,$2734.03
"Us Bank",,,11/04/2014,"Download from usbank.com. EAT24.COM       866-3281123 CA","Everyday Expenses:Spending Money","Everyday Expenses","Spending Money",,$3.00,$0.00,C,$2731.03
"Us Bank",,,11/04/2014,"Download from usbank.com. BART-POWELL     SAN FRANCISCCA","Everyday Expenses:Transportation","Everyday Expenses","Transportation",,$4.00,$0.00,C,$2727.03
"Us Bank",,,11/04/2014,"Download from usbank.com. STARBUCKS CARD R800-782-7282WA","Everyday Expenses:Spending Money","Everyday Expenses","Spending Money",,$10.00,$0.00,C,$2717.03
"Us Bank",,,11/04/2014,"Download from usbank.com. WALGREENS 2690 MSAN FRANCISCCA","Everyday Expenses:Household Goods","Everyday Expenses","Household Goods",,$13.69,$0.00,C,$2703.34
"Us Bank",,,11/04/2014,"Download from usbank.com. S AND N FASHIONSSAN FRANCISCCA","Everyday Expenses:Clothing","Everyday Expenses","Clothing",,$14.24,$0.00,C,$2689.10
"Us Bank",,,11/04/2014,"Download from usbank.com. EAT24.COM       EAT24HOURS.CCA","Everyday Expenses:Spending Money","Everyday Expenses","Spending Money",,$29.04,$0.00,C,$2660.06
"Us Bank",,,11/04/2014,"Download from usbank.com. GUITAR CENTER #2SAN FRANCISCCA","Everyday Expenses:Spending Money","Everyday Expenses","Spending Money",,$488.29,$0.00,C,$2171.77
"Us Bank",,,11/04/2014,"Download from usbank.com. Mosser Companies","Monthly Bills:Rent","Monthly Bills","Rent",,$1582.72,$0.00,C,$589.05
"Us Bank",,,11/05/2014,"Download from usbank.com. PAYPAL","Everyday Expenses:Clothing","Everyday Expenses","Clothing",,$0.00,$295.66,C,$884.71
"Us Bank",,,11/05/2014,"Download from usbank.com. VENMO","Everyday Expenses:Clothing","Everyday Expenses","Clothing",,$0.00,$125.12,C,$1009.83
"Us Bank",,,11/05/2014,"Download from usbank.com. DOLCE GELATO    SAN FRANCISCCA","Everyday Expenses:Spending Money","Everyday Expenses","Spending Money",,$2.45,$0.00,C,$1007.38
"Us Bank",,,11/05/2014,"Download from usbank.com. CHIPOTLE 1857   SAN FRANCISCCA","Everyday Expenses:Spending Money","Everyday Expenses","Spending Money",,$7.56,$0.00,C,$999.82
"Us Bank",,,11/06/2014,"Download from usbank.com. LIVINGSOCIAL*   202-695-8945DC","Everyday Expenses:Spending Money","Everyday Expenses","Spending Money",,$6.00,$0.00,C,$993.82
"Us Bank",,,11/06/2014,"Download from usbank.com. DUC LOI SUPERMARSAN FRANCISCCA","Everyday Expenses:Spending Money","Everyday Expenses","Spending Money",,$8.52,$0.00,C,$985.30
"Us Bank",,,11/06/2014,"Download from usbank.com. JAPAN KATANA YA SAN FRANCISCCA","Everyday Expenses:Spending Money","Everyday Expenses","Spending Money",,$17.48,$0.00,C,$967.82
"Us Bank",,,11/06/2014,"Download from usbank.com. VENMO           855-812-4430NY","Everyday Expenses:Spending Money","Everyday Expenses","Spending Money",,$20.00,$0.00,C,$947.82
"Us Bank",,,11/06/2014,"Download from usbank.com. MODCLOTH INC.   888-4959699 CA","Everyday Expenses:Clothing","Everyday Expenses","Clothing",,$182.01,$0.00,C,$765.81
"Us Bank",,,11/07/2014,"Download from usbank.com. MODCLOTH INC","Income:Available this month","Income","Available this month",,$0.00,$1522.43,C,$2288.24
"Us Bank",,,11/07/2014,"Download from usbank.com. MODCLOTH INC.   888-4959699 CA","Everyday Expenses:Clothing","Everyday Expenses","Clothing",,$80.26,$0.00,C,$2207.98
"Us Bank",,,11/07/2014,"Download from usbank.com. MODCLOTH INC.   888-4959699 CA","Everyday Expenses:Clothing","Everyday Expenses","Clothing",,$193.83,$0.00,C,$2014.15
"Us Bank",,,11/10/2014,"Download from usbank.com. PAYPAL","Everyday Expenses:Clothing","Everyday Expenses","Clothing",,$0.00,$96.80,C,$2110.95
"Us Bank",,,11/10/2014,"Download from usbank.com. TJ MAXX #1109   SAN FRANCISCCA","Everyday Expenses:Clothing","Everyday Expenses","Clothing",,$0.00,$8.69,C,$2119.64
"Us Bank",,,11/10/2014,"Download from usbank.com. CVS 10189       SAN FRANCISCCA","Everyday Expenses:Household Goods","Everyday Expenses","Household Goods",,$5.80,$0.00,C,$2113.84
"Us Bank",,,11/10/2014,"Download from usbank.com. UBER TECHNOLOGIE866-576-1039CA","Everyday Expenses:Transportation","Everyday Expenses","Transportation",,$8.67,$0.00,C,$2105.17
"Us Bank",,,11/10/2014,"Download from usbank.com. SQ *FRANCE DELICSan FranciscCA","Everyday Expenses:Spending Money","Everyday Expenses","Spending Money",,$9.24,$0.00,C,$2095.93
"Us Bank",,,11/10/2014,"Download from usbank.com. AMC THEATRES ONL888-440-4262KS","Everyday Expenses:Spending Money","Everyday Expenses","Spending Money",,$10.98,$0.00,C,$2084.95
"Us Bank",,,11/10/2014,"Download from usbank.com. DOLCE GELATO    SAN FRANCISCCA","Everyday Expenses:Spending Money","Everyday Expenses","Spending Money",,$13.10,$0.00,C,$2071.85
"Us Bank",,,11/10/2014,"Download from usbank.com. BAL*SpoonRocket 510-9219929 CA","Everyday Expenses:Groceries","Everyday Expenses","Groceries",,$17.40,$0.00,C,$2054.45
"Us Bank",,,11/10/2014,"Download from usbank.com. POSTMATES.COM   8008826106  CA","Everyday Expenses:Spending Money","Everyday Expenses","Spending Money",,$26.01,$0.00,C,$2028.44
"Us Bank",,,11/10/2014,"Download from usbank.com. WALGREENS 1300 BSAN FRANCISCCA","Everyday Expenses:Household Goods","Everyday Expenses","Household Goods",,$26.17,$0.00,C,$2002.27
"Us Bank",,,11/10/2014,"Download from usbank.com. CARDMEMBER SERV",,,,,$34.00,$0.00,C,$1968.27
"Us Bank",,,11/10/2014,"Download from usbank.com. WHOLEFDS FRK 100San FranciscCA","Everyday Expenses:Groceries","Everyday Expenses","Groceries",,$38.98,$0.00,C,$1929.29
"Us Bank",,,11/10/2014,"Download from usbank.com. OLD NAVY USA    San FranciscCA","Everyday Expenses:Clothing","Everyday Expenses","Clothing",,$71.24,$0.00,C,$1858.05
"Us Bank",,,11/10/2014,"Download from usbank.com. MODCLOTH INC.   888-4959699 CA","Everyday Expenses:Clothing","Everyday Expenses","Clothing",,$79.56,$0.00,C,$1778.49
"Us Bank",,,11/12/2014,"Download from usbank.com. PAYPAL","Everyday Expenses:Clothing","Everyday Expenses","Clothing",,$0.00,$80.26,C,$1858.75
"Us Bank",,,11/12/2014,"Download from usbank.com. LIVINGSOCIAL*   202-695-8945DC","Everyday Expenses:Spending Money","Everyday Expenses","Spending Money",,$0.00,$6.00,C,$1864.75
"Us Bank",,,11/12/2014,"Download from usbank.com. LYFT.COM TUE AT 855-280-0278CA","Everyday Expenses:Transportation","Everyday Expenses","Transportation",,$7.50,$0.00,C,$1857.25
"Us Bank",,,11/12/2014,"Download from usbank.com. BROWNIES HARDWARSAN FRANCISCCA","Everyday Expenses:Household Goods","Everyday Expenses","Household Goods",,$8.13,$0.00,C,$1849.12
"Us Bank",,,11/12/2014,"Download from usbank.com. PAYPAL","Everyday Expenses:Spending Money","Everyday Expenses","Spending Money",,$10.00,$0.00,C,$1839.12
"Us Bank",,,11/12/2014,"Download from usbank.com. SUGAR CAFE      SAN FRANCISCCA","Everyday Expenses:Spending Money","Everyday Expenses","Spending Money",,$10.24,$0.00,C,$1828.88
"Us Bank",,,11/12/2014,"Download from usbank.com. WORKING GIRLS CASAN FRANCISCCA","Everyday Expenses:Spending Money","Everyday Expenses","Spending Money",,$10.95,$0.00,C,$1817.93
"Us Bank",,,11/12/2014,"Download from usbank.com. MODCLOTH INC.   888-4959699 CA","Everyday Expenses:Clothing","Everyday Expenses","Clothing",,$11.96,$0.00,C,$1805.97
"Us Bank",,,11/12/2014,"Download from usbank.com. SUGAR CAFE      SAN FRANCISCCA","Everyday Expenses:Spending Money","Everyday Expenses","Spending Money",,$17.00,$0.00,C,$1788.97
"Us Bank",,,11/12/2014,"Download from usbank.com. NARA SUSHI      SAN FRANCISCCA","Everyday Expenses:Spending Money","Everyday Expenses","Spending Money",,$25.78,$0.00,C,$1763.19
"Us Bank",,,11/12/2014,"Download from usbank.com. BARCLAYS BANK DE","Savings Goals:Savings","Savings Goals","Savings",,$150.00,$0.00,C,$1613.19
"Us Bank",,,11/13/2014,"Download from usbank.com. BARRYS BOOTCAMP SAN FRANCISCCA","Everyday Expenses:Spending Money","Everyday Expenses","Spending Money",,$2.00,$0.00,C,$1611.19
"Us Bank",,,11/13/2014,"Download from usbank.com. BARRYS BOOTCAMP SAN FRANCISCCA","Everyday Expenses:Spending Money","Everyday Expenses","Spending Money",,$8.00,$0.00,C,$1603.19
"Us Bank",,,11/13/2014,"Download from usbank.com. SQ *RS MEATBALLSSan FranciscCA","Everyday Expenses:Spending Money","Everyday Expenses","Spending Money",,$10.00,$0.00,C,$1593.19
"Us Bank",,,11/13/2014,"Download from usbank.com. WALGREENS 459 POSAN FRANCISCCA","Everyday Expenses:Household Goods","Everyday Expenses","Household Goods",,$16.92,$0.00,C,$1576.27
"Us Bank",,,11/13/2014,"Download from usbank.com. BAL*SpoonRocket 510-9219929 CA","Everyday Expenses:Groceries","Everyday Expenses","Groceries",,$17.40,$0.00,C,$1558.87
"Us Bank",,,11/13/2014,"Download from usbank.com. WALGREENS 500 GESAN FRANCISCCA","Everyday Expenses:Household Goods","Everyday Expenses","Household Goods",,$27.06,$0.00,C,$1531.81
"Us Bank",,,11/14/2014,"Download from usbank.com. SQWIGGLE INC","Income:Available this month","Income","Available this month",,$0.00,$1965.99,C,$3497.80
"Us Bank",,,11/14/2014,"Download from usbank.com. MODCLOTH INC.   888-4959699 CA","Everyday Expenses:Clothing","Everyday Expenses","Clothing",,$0.00,$25.46,C,$3523.26
"Us Bank",,,11/14/2014,"Download from usbank.com. CHIPOTLE 1857   SAN FRANCISCCA","Everyday Expenses:Spending Money","Everyday Expenses","Spending Money",,$7.56,$0.00,C,$3515.70
"Us Bank",,,11/14/2014,"Download from usbank.com. WALGREENS 141 KESAN FRANCISCCA","Everyday Expenses:Household Goods","Everyday Expenses","Household Goods",,$9.19,$0.00,C,$3506.51
"Us Bank",,,11/14/2014,"Download from usbank.com. SPOONROCKET.COM 510-921-9929CA","Everyday Expenses:Spending Money","Everyday Expenses","Spending Money",,$9.57,$0.00,C,$3496.94
"Us Bank",,,11/14/2014,"Download from usbank.com. EAT24.COM       EAT24HOURS.CCA","Everyday Expenses:Spending Money","Everyday Expenses","Spending Money",,$27.03,$0.00,C,$3469.91
"Us Bank",,,11/14/2014,"Download from usbank.com. EB *RAVE OF THRO888-810-2063CA","Everyday Expenses:Spending Money","Everyday Expenses","Spending Money",,$56.74,$0.00,C,$3413.17
"Us Bank",,,11/14/2014,"Download from usbank.com. VENMO           855-812-4430NY","Everyday Expenses:Spending Money","Everyday Expenses","Spending Money",,$65.00,$0.00,C,$3348.17
"Us Bank",,,11/14/2014,"Download from usbank.com. TRADER JOE'S #20SAN FRANCISCCA","Everyday Expenses:Groceries","Everyday Expenses","Groceries",,$75.21,$0.00,C,$3272.96
"Us Bank",,,11/17/2014,"Download from usbank.com. GUITAR CENTER #2SAN FRANCISCCA","Everyday Expenses:Misc","Everyday Expenses","Misc",,$0.00,$488.29,C,$3761.25
"Us Bank",,,11/17/2014,"Download from usbank.com. 111714PLUSTERM475 3RD ST      SAN FRANCISCCAUS1","Everyday Expenses:Spending Money","Everyday Expenses","Spending Money",,$2.50,$0.00,C,$3758.75
"Us Bank",,,11/17/2014,"Download from usbank.com. JAMBA JUICE #91 SAN FRANCISCCA","Everyday Expenses:Spending Money","Everyday Expenses","Spending Money",,$5.69,$0.00,C,$3753.06
"Us Bank",,,11/17/2014,"Download from usbank.com. WALGREENS 901 HYSAN FRANCISCCA","Everyday Expenses:Household Goods","Everyday Expenses","Household Goods",,$7.95,$0.00,C,$3745.11
"Us Bank",,,11/17/2014,"Download from usbank.com. SUBWAY # 6625   SAN FRANCISCCA","Everyday Expenses:Spending Money","Everyday Expenses","Spending Money",,$9.84,$0.00,C,$3735.27
"Us Bank",,,11/17/2014,"Download from usbank.com. PAYPAL","Everyday Expenses:Spending Money","Everyday Expenses","Spending Money",,$10.00,$0.00,C,$3725.27
"Us Bank",,,11/17/2014,"Download from usbank.com. SUTTER FINE FOODSAN FRANCISCCA","Everyday Expenses:Groceries","Everyday Expenses","Groceries",,$10.58,$0.00,C,$3714.69
"Us Bank",,,11/17/2014,"Download from usbank.com. NNT VILLAGE PETSSAN FRANCISCCA","Everyday Expenses:Household Goods","Everyday Expenses","Household Goods",,$10.86,$0.00,C,$3703.83
"Us Bank",,,11/17/2014,"Download from usbank.com. SAFEWAY STORE  2SAN FRANCISCCA","Everyday Expenses:Groceries","Everyday Expenses","Groceries",,$18.11,$0.00,C,$3685.72
"Us Bank",,,11/17/2014,"Download from usbank.com. FAIRMONT HOTELS SAN FRANCISCCA","Everyday Expenses:Spending Money","Everyday Expenses","Spending Money",,$24.81,$0.00,C,$3660.91
"Us Bank",,,11/17/2014,"Download from usbank.com. FAIRMONT HOTELS SAN FRANCISCCA","Everyday Expenses:Spending Money","Everyday Expenses","Spending Money",,$36.54,$0.00,C,$3624.37
"Us Bank",,,11/17/2014,"Download from usbank.com. 475 3RD ST      SAN FRANCISCCAUS1","Everyday Expenses:Spending Money","Everyday Expenses","Spending Money",,$42.00,$0.00,C,$3582.37
"Us Bank",,,11/17/2014,"Download from usbank.com. INDIEGOGO 866-64INDIEGOGO.COCA","Rainy Day Funds:Gifts","Rainy Day Funds","Gifts",,$50.00,$0.00,C,$3532.37
"Us Bank",,,11/17/2014,"Download from usbank.com. TRADER JOE'S #20SAN FRANCISCCA","Everyday Expenses:Groceries","Everyday Expenses","Groceries",,$50.65,$0.00,C,$3481.72
"Us Bank",,,11/17/2014,"Download from usbank.com. COMCAST","Monthly Bills:Utilities","Monthly Bills","Utilities",,$75.65,$0.00,C,$3406.07
"Us Bank",,,11/17/2014,"Download from usbank.com. MODCLOTH INC.   888-4959699 CA","Everyday Expenses:Clothing","Everyday Expenses","Clothing",,$123.91,$0.00,C,$3282.16
"Us Bank",,,11/17/2014,"Download from usbank.com. BARCLAYS BANK DE","Savings Goals:Savings","Savings Goals","Savings",,$150.00,$0.00,C,$3132.16
"Us Bank",,,11/17/2014,"Download from usbank.com. 6703",,,,,$367.82,$0.00,C,$2764.34
"Us Bank",,,11/18/2014,"Download from usbank.com. AMAZON MKTPLACE AMZN.COM/BILWA","Everyday Expenses:Spending Money","Everyday Expenses","Spending Money",,$0.00,$42.45,C,$2806.79
"Us Bank",,,11/18/2014,"Download from usbank.com. AMAZON MKTPLACE AMZN.COM/BILWA","Everyday Expenses:Spending Money","Everyday Expenses","Spending Money",,$0.00,$7.89,C,$2814.68
"Us Bank",,,11/18/2014,"Download from usbank.com. Amazon.com      AMZN.COM/BILWA","Everyday Expenses:Spending Money","Everyday Expenses","Spending Money",,$0.00,$7.11,C,$2821.79
"Us Bank",,,11/18/2014,"Download from usbank.com. PAYPAL","Everyday Expenses:Spending Money","Everyday Expenses","Spending Money",,$9.99,$0.00,C,$2811.80
"Us Bank",,,11/18/2014,"Download from usbank.com. PAYPAL","Everyday Expenses:Spending Money","Everyday Expenses","Spending Money",,$20.00,$0.00,C,$2791.80
"Us Bank",,,11/18/2014,"Download from usbank.com. AMC VAN NESS 14 SAN FRANCISCCA","Everyday Expenses:Spending Money","Everyday Expenses","Spending Money",,$20.98,$0.00,C,$2770.82
"Us Bank",,,11/18/2014,"Download from usbank.com. SUTTER FINE FOODSAN FRANCISCCA","Everyday Expenses:Groceries","Everyday Expenses","Groceries",,$25.15,$0.00,C,$2745.67
"Us Bank",,,11/18/2014,"Download from usbank.com. PGANDE","Monthly Bills:Utilities","Monthly Bills","Utilities",,$59.86,$0.00,C,$2685.81
"Us Bank",,,11/18/2014,"Download from usbank.com. Amazon.com      AMZN.COM/BILWA","Everyday Expenses:Spending Money","Everyday Expenses","Spending Money",,$204.82,$0.00,C,$2480.99
"Us Bank",,,11/19/2014,"Download from usbank.com. BARRYS BOOTCAMP SAN FRANCISCCA","Everyday Expenses:Spending Money","Everyday Expenses","Spending Money",,$8.00,$0.00,C,$2472.99
"Us Bank",,,11/19/2014,"Download from usbank.com. LYFT.COM MON AT 855-280-0278CA","Everyday Expenses:Transportation","Everyday Expenses","Transportation",,$12.41,$0.00,C,$2460.58
"Us Bank",,,11/19/2014,"Download from usbank.com. Audible US      888-283-5051NJ","Monthly Bills:Web Stuff","Monthly Bills","Web Stuff",,$14.55,$0.00,C,$2446.03
"Us Bank",,,11/19/2014,"Download from usbank.com. ATT","Monthly Bills:Cell Phone","Monthly Bills","Cell Phone",,$225.93,$0.00,C,$2220.10
"Us Bank",,,11/20/2014,"Download from usbank.com. Amazon.com      AMZN.COM/BILWA","Everyday Expenses:Spending Money","Everyday Expenses","Spending Money",,$0.00,$10.82,C,$2230.92
"Us Bank",,,11/20/2014,"Download from usbank.com. WALGREENS 1300 BSAN FRANCISCCA","Everyday Expenses:Household Goods","Everyday Expenses","Household Goods",,$9.78,$0.00,C,$2221.14
"Us Bank",,,11/20/2014,"Download from usbank.com. PAYPAL","Everyday Expenses:Spending Money","Everyday Expenses","Spending Money",,$9.99,$0.00,C,$2211.15
"Us Bank",,,11/20/2014,"Download from usbank.com. SQ *HIYAAA      San FranciscCA","Everyday Expenses:Spending Money","Everyday Expenses","Spending Money",,$10.00,$0.00,C,$2201.15
"Us Bank",,,11/20/2014,"Download from usbank.com. SPOONROCKET.COM 510-921-9929CA","Everyday Expenses:Spending Money","Everyday Expenses","Spending Money",,$17.40,$0.00,C,$2183.75
"Us Bank",,,11/20/2014,"Download from usbank.com. TRADER JOE'S #20SAN FRANCISCCA","Everyday Expenses:Groceries","Everyday Expenses","Groceries",,$30.50,$0.00,C,$2153.25
"Us Bank",,,11/21/2014,"Download from usbank.com. MODCLOTH INC","Income:Available this month","Income","Available this month",,$0.00,$1522.43,C,$3675.68
"Us Bank",,,11/21/2014,"Download from usbank.com. LYFT.COM THU AT 855-280-0278CA","Everyday Expenses:Transportation","Everyday Expenses","Transportation",,$7.58,$0.00,C,$3668.10
"Us Bank",,,11/21/2014,"Download from usbank.com. BAL*SpoonRocket 510-9219929 CA","Everyday Expenses:Groceries","Everyday Expenses","Groceries",,$8.70,$0.00,C,$3659.40
"Us Bank",,,11/21/2014,"Download from usbank.com. VENMO           855-812-4430NY","Everyday Expenses:Spending Money","Everyday Expenses","Spending Money",,$9.00,$0.00,C,$3650.40
"Us Bank",,,11/21/2014,"Download from usbank.com. EAT24.COM       866-3281123 CA","Everyday Expenses:Spending Money","Everyday Expenses","Spending Money",,$9.89,$0.00,C,$3640.51
"Us Bank",,,11/21/2014,"Download from usbank.com. SUTTER FINE FOODSAN FRANCISCCA","Everyday Expenses:Groceries","Everyday Expenses","Groceries",,$19.55,$0.00,C,$3620.96
"Us Bank",,,11/21/2014,"Download from usbank.com. WALGREENS 1300 BSAN FRANCISCCA","Everyday Expenses:Household Goods","Everyday Expenses","Household Goods",,$21.99,$0.00,C,$3598.97
"Us Bank",,,11/21/2014,"Download from usbank.com. WALGREENS 500 GESAN FRANCISCCA","Everyday Expenses:Household Goods","Everyday Expenses","Household Goods",,$22.04,$0.00,C,$3576.93
"Us Bank",,,11/24/2014,"Download from usbank.com. PAYPAL","Everyday Expenses:Spending Money","Everyday Expenses","Spending Money",,$4.65,$0.00,C,$3572.28
"Us Bank",,,11/24/2014,"Download from usbank.com. SQ *BLUE BOTTLE San FranciscCA","Everyday Expenses:Spending Money","Everyday Expenses","Spending Money",,$5.00,$0.00,C,$3567.28
"Us Bank",,,11/24/2014,"Download from usbank.com. CHIPOTLE 1857   SAN FRANCISCCA","Everyday Expenses:Spending Money","Everyday Expenses","Spending Money",,$7.56,$0.00,C,$3559.72
"Us Bank",,,11/24/2014,"Download from usbank.com. LYFT.COM SAT AT 855-280-0278CA","Everyday Expenses:Transportation","Everyday Expenses","Transportation",,$8.03,$0.00,C,$3551.69
"Us Bank",,,11/24/2014,"Download from usbank.com. PAYPAL","Everyday Expenses:Spending Money","Everyday Expenses","Spending Money",,$9.99,$0.00,C,$3541.70
"Us Bank",,,11/24/2014,"Download from usbank.com. Spotify USA     877-778-1161NY","Monthly Bills:Web Stuff","Monthly Bills","Web Stuff",,$9.99,$0.00,C,$3531.71
"Us Bank",,,11/24/2014,"Download from usbank.com. PAYPAL","Everyday Expenses:Spending Money","Everyday Expenses","Spending Money",,$10.00,$0.00,C,$3521.71
"Us Bank",,,11/24/2014,"Download from usbank.com. LYFT.COM SAT AT 855-280-0278CA","Everyday Expenses:Transportation","Everyday Expenses","Transportation",,$10.30,$0.00,C,$3511.41
"Us Bank",,,11/24/2014,"Download from usbank.com. BITE            SAN FRANCISCCA","Everyday Expenses:Spending Money","Everyday Expenses","Spending Money",,$12.66,$0.00,C,$3498.75
"Us Bank",,,11/24/2014,"Download from usbank.com. LYFT.COM SAT AT 855-280-0278CA","Everyday Expenses:Transportation","Everyday Expenses","Transportation",,$13.17,$0.00,C,$3485.58
"Us Bank",,,11/24/2014,"Download from usbank.com. PAYPAL","Everyday Expenses:Spending Money","Everyday Expenses","Spending Money",,$15.00,$0.00,C,$3470.58
"Us Bank",,,11/24/2014,"Download from usbank.com. TWENTY FIVE LUSKSAN FRANCISCCA","Everyday Expenses:Spending Money","Everyday Expenses","Spending Money",,$16.83,$0.00,C,$3453.75
"Us Bank",,,11/24/2014,"Download from usbank.com. BOUDIN MACYS 424SAN FRANCISCCA","Everyday Expenses:Spending Money","Everyday Expenses","Spending Money",,$20.21,$0.00,C,$3433.54
"Us Bank",,,11/24/2014,"Download from usbank.com. BITE            SAN FRANCISCCA","Everyday Expenses:Spending Money","Everyday Expenses","Spending Money",,$20.35,$0.00,C,$3413.19
"Us Bank",,,11/24/2014,"Download from usbank.com. BAR BASIC       SAN FRANCISCCA","Everyday Expenses:Spending Money","Everyday Expenses","Spending Money",,$31.00,$0.00,C,$3382.19
"Us Bank",,,11/24/2014,"Download from usbank.com. WALGREENS 1300 BSAN FRANCISCCA","Everyday Expenses:Household Goods","Everyday Expenses","Household Goods",,$36.95,$0.00,C,$3345.24
"Us Bank",,,11/24/2014,"Download from usbank.com. URBAN OUTFITTER SAN FRANCISCCA","Everyday Expenses:Clothing","Everyday Expenses","Clothing",,$43.49,$0.00,C,$3301.75
"Us Bank",,,11/24/2014,"Download from usbank.com. TRADER JOE'S #20SAN FRANCISCCA","Everyday Expenses:Groceries","Everyday Expenses","Groceries",,$82.57,$0.00,C,$3219.18
"Us Bank",,,11/24/2014,"Download from usbank.com. MODCLOTH INC.   888-4959699 CA","Everyday Expenses:Clothing","Everyday Expenses","Clothing",,$83.54,$0.00,C,$3135.64
"Us Bank",,,11/24/2014,"Download from usbank.com. TARGET T2766    SAN FRANCISCCA","Savings Goals:House Stuff","Savings Goals","House Stuff",,$85.95,$0.00,C,$3049.69
"Us Bank",,,11/24/2014,"Download from usbank.com. NOB HILL CAT CLISAN FRANCISCCA","Everyday Expenses:Misc","Everyday Expenses","Misc",,$361.28,$0.00,C,$2688.41
"Us Bank",,,11/24/2014,"Download from usbank.com. SOUTHWES    5262800-435-9792TX","Savings Goals:Vacation & Travel","Savings Goals","Vacation & Travel",,$808.40,$0.00,C,$1880.01
"Us Bank",,,11/25/2014,"Download from usbank.com.","Everyday Expenses:Spending Money","Everyday Expenses","Spending Money",,$0.00,$6.95,C,$1886.96
"Us Bank",,,11/25/2014,"Download from usbank.com.","Everyday Expenses:Spending Money","Everyday Expenses","Spending Money",,$6.95,$0.00,C,$1880.01
"Us Bank",,,11/25/2014,"Download from usbank.com. LYFT.COM MON AT 855-280-0278CA","Everyday Expenses:Transportation","Everyday Expenses","Transportation",,$6.99,$0.00,C,$1873.02
"Us Bank",,,11/25/2014,"Download from usbank.com. HLU*Hulu 2274453HULU.COM/BILCA","Monthly Bills:Web Stuff","Monthly Bills","Web Stuff",,$7.99,$0.00,C,$1865.03
"Us Bank",,,11/25/2014,"Download from usbank.com. AMC THEATRES ONL888-440-4262KS","Everyday Expenses:Spending Money","Everyday Expenses","Spending Money",,$24.58,$0.00,C,$1840.45
"Us Bank",,,11/26/2014,"Download from usbank.com. TACQUERIA DOS AMSAN FRANCISCCA","Everyday Expenses:Spending Money","Everyday Expenses","Spending Money",,$17.39,$0.00,C,$1823.06
"Us Bank",,,11/26/2014,"Download from usbank.com. WHOLEFDS FRK 100San FranciscCA","Everyday Expenses:Groceries","Everyday Expenses","Groceries",,$28.89,$0.00,C,$1794.17
"Us Bank",,,11/26/2014,"Download from usbank.com. SAFEWAY STORE  2SAN FRANCISCCA","Everyday Expenses:Groceries","Everyday Expenses","Groceries",,$33.30,$0.00,C,$1760.87
"Us Bank",,,11/26/2014,"Download from usbank.com. TRADER JOE'S #20SAN FRANCISCCA","Everyday Expenses:Groceries","Everyday Expenses","Groceries",,$64.56,$0.00,C,$1696.31
"Us Bank",,,11/26/2014,"Download from usbank.com. BARCLAYS BANK DE","Savings Goals:Savings","Savings Goals","Savings",,$150.00,$0.00,C,$1546.31
"Us Bank",,,11/28/2014,"Download from usbank.com. SQWIGGLE INC","Income:Available this month","Income","Available this month",,$0.00,$1965.99,C,$3512.30
"Us Bank",,,11/28/2014,"Download from usbank.com. AMAZON DIG551469","Everyday Expenses:Spending Money","Everyday Expenses","Spending Money",,$0.00,$1.40,C,$3513.70
"Us Bank",,,11/28/2014,"Download from usbank.com. SUTTER FINE FOODSAN FRANCISCCA","Everyday Expenses:Groceries","Everyday Expenses","Groceries",,$7.93,$0.00,C,$3505.77
"Us Bank",,,11/28/2014,"Download from usbank.com. PAYPAL","Everyday Expenses:Spending Money","Everyday Expenses","Spending Money",,$10.00,$0.00,C,$3495.77
"Us Bank",,,11/28/2014,"Download from usbank.com. PAYPAL",,,,,$16.75,$0.00,C,$3479.02
"Us Bank",,,11/28/2014,"Download from usbank.com. PAYPAL",,,,,$16.75,$0.00,C,$3462.27
"Us Bank",,,11/28/2014,"Download from usbank.com. THE OWL TREE    SAN FRANCISCCA","Everyday Expenses:Spending Money","Everyday Expenses","Spending Money",,$24.75,$0.00,C,$3437.52
"Us Bank",,,11/28/2014,"Download from usbank.com. VENMO           855-812-4430NY","Everyday Expenses:Spending Money","Everyday Expenses","Spending Money",,$27.85,$0.00,C,$3409.67
"Us Bank",,,11/28/2014,"Download from usbank.com. EAT24.COM       EAT24HOURS.CCA","Everyday Expenses:Spending Money","Everyday Expenses","Spending Money",,$29.46,$0.00,C,$3380.21
"Us Bank",,,11/28/2014,"Download from usbank.com. WALGREENS 1300 BSAN FRANCISCCA","Everyday Expenses:Household Goods","Everyday Expenses","Household Goods",,$38.31,$0.00,C,$3341.90
"Us Bank",,,11/28/2014,"Download from usbank.com. MODCLOTH INC.   888-4959699 CA","Everyday Expenses:Clothing","Everyday Expenses","Clothing",,$263.71,$0.00,C,$3078.19
"Us Bank",,,12/01/2014,"Download from usbank.com. SQ *BOB'S DONUTSSan FranciscCA","Everyday Expenses:Spending Money","Everyday Expenses","Spending Money",,$2.70,$0.00,C,$3075.49
"Us Bank",,,12/01/2014,"Download from usbank.com. KOZY KAR        SAN FRANCISCCA","Everyday Expenses:Spending Money","Everyday Expenses","Spending Money",,$3.00,$0.00,C,$3072.49
"Us Bank",,,12/01/2014,"Download from usbank.com. BART-POWELL     SAN FRANCISCCA","Everyday Expenses:Transportation","Everyday Expenses","Transportation",,$4.45,$0.00,C,$3068.04
"Us Bank",,,12/01/2014,"Download from usbank.com. Acorns Investmen","Savings Goals:Savings","Savings Goals","Savings",,$5.00,$0.00,C,$3063.04
"Us Bank",,,12/01/2014,"Download from usbank.com. Audible US      888-283-5051NJ","Monthly Bills:Web Stuff","Monthly Bills","Web Stuff",,$6.85,$0.00,C,$3056.19
"Us Bank",,,12/01/2014,"Download from usbank.com. PAYPAL",,,,,$16.75,$0.00,C,$3039.44
"Us Bank",,,12/01/2014,"Download from usbank.com. KOZY KAR        SAN FRANCISCCA","Everyday Expenses:Spending Money","Everyday Expenses","Spending Money",,$17.00,$0.00,C,$3022.44
"Us Bank",,,12/01/2014,"Download from usbank.com. SQ *ANOTHER CAFESan FranciscCA","Everyday Expenses:Spending Money","Everyday Expenses","Spending Money",,$21.24,$0.00,C,$3001.20
"Us Bank",,,12/01/2014,"Download from usbank.com. LYFT.COM SAT AT 855-280-0278CA","Everyday Expenses:Transportation","Everyday Expenses","Transportation",,$29.69,$0.00,C,$2971.51
"Us Bank",,,12/01/2014,"Download from usbank.com. MET CAS INS CO","Monthly Bills:Car Insurance","Monthly Bills","Car Insurance",,$49.00,$0.00,C,$2922.51
"Us Bank",,,12/01/2014,"Download from usbank.com. SUSHI ROCK      SAN FRANCISCCA","Everyday Expenses:Spending Money","Everyday Expenses","Spending Money",,$58.26,$0.00,C,$2864.25
"Us Bank",,,12/01/2014,"Download from usbank.com. TRADER JOE'S #20SAN FRANCISCCA","Everyday Expenses:Groceries","Everyday Expenses","Groceries",,$70.41,$0.00,C,$2793.84
"Us Bank",,,12/01/2014,"Download from usbank.com. BARCLAYS BANK DE","Savings Goals:Savings","Savings Goals","Savings",,$150.00,$0.00,C,$2643.84
"Us Bank",,,12/01/2014,"Download from usbank.com. 7246","Debt:Eric's Credit Card","Debt","Eric's Credit Card",,$1000.00,$0.00,C,$1643.84
"Us Bank",,,12/02/2014,"Download from usbank.com.","Income:Available this month","Income","Available this month",,$0.00,$250.00,C,$1893.84
"Us Bank",,,12/02/2014,"Download from usbank.com. CHIPOTLE 1857   SAN FRANCISCCA","Everyday Expenses:Spending Money","Everyday Expenses","Spending Money",,$7.56,$0.00,C,$1886.28
"Us Bank",,,12/02/2014,"Download from usbank.com. TENDER GREENS   SAN FRANCISCCA","Everyday Expenses:Spending Money","Everyday Expenses","Spending Money",,$11.31,$0.00,C,$1874.97
"Us Bank",,,12/02/2014,"Download from usbank.com.","Everyday Expenses:Spending Money","Everyday Expenses","Spending Money",,$12.50,$0.00,C,$1862.47
"Us Bank",,,12/02/2014,"Download from usbank.com. THE GROVE-HAYES SAN FRANCISCCA","Everyday Expenses:Spending Money","Everyday Expenses","Spending Money",,$15.27,$0.00,C,$1847.20
"Us Bank",,,12/02/2014,"Download from usbank.com. Mosser Companies","Monthly Bills:Rent","Monthly Bills","Rent",,$1582.72,$0.00,C,$264.48
"Us Bank",,,12/03/2014,"Download from usbank.com. PAYPAL","Income:Available this month","Income","Available this month",,$0.00,$387.62,C,$652.10
"Us Bank",,,12/03/2014,"Download from usbank.com. BARRY`S BOOTCAMP415-546-3996CA","Everyday Expenses:Spending Money","Everyday Expenses","Spending Money",,$2.00,$0.00,C,$650.10
"Us Bank",,,12/03/2014,"Download from usbank.com. BOURBON AND BRANSAN FRANCISCCA","Everyday Expenses:Spending Money","Everyday Expenses","Spending Money",,$44.47,$0.00,C,$605.63
"Us Bank",,,12/03/2014,"Download from usbank.com. HOG ISLAND OYSTESAN FRANCISCCA","Everyday Expenses:Spending Money","Everyday Expenses","Spending Money",,$52.93,$0.00,C,$552.70
"Us Bank",,,12/03/2014,"Download from usbank.com. CLASSPASS.COM CL888-493-5953NY","Everyday Expenses:Spending Money","Everyday Expenses","Spending Money",,$99.00,$0.00,C,$453.70
"Us Bank",,,12/04/2014,"Download from usbank.com. Apple","Everyday Expenses:Spending Money","Everyday Expenses","Spending Money",,$0.00,$12.60,C,$466.30
"Us Bank",,,12/04/2014,"Download from usbank.com. SQ *BLUE BOTTLE San FranciscCA","Everyday Expenses:Spending Money","Everyday Expenses","Spending Money",,$5.00,$0.00,C,$461.30
"Us Bank",,,12/04/2014,"Download from usbank.com. THE MELT-NEW MONSAN FRANCISCCA","Everyday Expenses:Spending Money","Everyday Expenses","Spending Money",,$8.30,$0.00,C,$453.00
"Us Bank",,,12/04/2014,"Download from usbank.com. Acorns Investmen","Savings Goals:Savings","Savings Goals","Savings",,$11.89,$0.00,C,$441.11
"Us Bank",,,12/04/2014,"Download from usbank.com. Audible US      888-283-5051NJ","Monthly Bills:Web Stuff","Monthly Bills","Web Stuff",,$17.15,$0.00,C,$423.96
"Us Bank",,,12/04/2014,"Download from usbank.com. AMAZON MKTPLACE AMZN.COM/BILWA","Everyday Expenses:Spending Money","Everyday Expenses","Spending Money",,$23.33,$0.00,C,$400.63
"Us Bank",,,12/05/2014,"Download from usbank.com. MODCLOTH INC","Income:Available this month","Income","Available this month",,$0.00,$1522.44,C,$1923.07
"Us Bank",,,12/05/2014,"Download from usbank.com. 120514PLUSTERM1015 Folsom St  San FranciscCAUS1","Everyday Expenses:Spending Money","Everyday Expenses","Spending Money",,$2.50,$0.00,C,$1920.57
"Us Bank",,,12/05/2014,"Download from usbank.com. SQ *GREENLID    San FranciscCA","Everyday Expenses:Spending Money","Everyday Expenses","Spending Money",,$7.00,$0.00,C,$1913.57
"Us Bank",,,12/05/2014,"Download from usbank.com. CHIPOTLE 1857   SAN FRANCISCCA","Everyday Expenses:Spending Money","Everyday Expenses","Spending Money",,$7.56,$0.00,C,$1906.01
"Us Bank",,,12/05/2014,"Download from usbank.com. BITE            SAN FRANCISCCA","Everyday Expenses:Spending Money","Everyday Expenses","Spending Money",,$20.53,$0.00,C,$1885.48
"Us Bank",,,12/05/2014,"Download from usbank.com. THE GOLDEN GATE SAN FRANCISCCA","Everyday Expenses:Spending Money","Everyday Expenses","Spending Money",,$48.00,$0.00,C,$1837.48
"Us Bank",,,12/05/2014,"Download from usbank.com. 1015 Folsom St  San FranciscCAUS1","Everyday Expenses:Spending Money","Everyday Expenses","Spending Money",,$63.50,$0.00,C,$1773.98
"Us Bank",,,12/08/2014,"Download from usbank.com.","Income:Available this month","Income","Available this month",,$0.20,$0.00,C,$1773.78
"Us Bank",,,12/08/2014,"Download from usbank.com. WALGREENS 141 KESAN FRANCISCCA","Everyday Expenses:Household Goods","Everyday Expenses","Household Goods",,$1.29,$0.00,C,$1772.49
"Us Bank",,,12/08/2014,"Download from usbank.com. 120714PLUSTERM801 BUSH STREET SAN FRANCISCCAUS1","Everyday Expenses:Spending Money","Everyday Expenses","Spending Money",,$2.50,$0.00,C,$1769.99
"Us Bank",,,12/08/2014,"Download from usbank.com. WHOLEFDS FRK 100San FranciscCA","Everyday Expenses:Groceries","Everyday Expenses","Groceries",,$4.33,$0.00,C,$1765.66
"Us Bank",,,12/08/2014,"Download from usbank.com. Acorns Investmen","Savings Goals:Savings","Savings Goals","Savings",,$5.24,$0.00,C,$1760.42
"Us Bank",,,12/08/2014,"Download from usbank.com. SQ *CAT TOWN CAFOAKLAND     CA","Everyday Expenses:Spending Money","Everyday Expenses","Spending Money",,$5.50,$0.00,C,$1754.92
"Us Bank",,,12/08/2014,"Download from usbank.com. AMC METREON 16 #SAN FRANCISCCA","Everyday Expenses:Spending Money","Everyday Expenses","Spending Money",,$5.79,$0.00,C,$1749.13
"Us Bank",,,12/08/2014,"Download from usbank.com. BART-POWELL     SAN FRANCISCCA","Everyday Expenses:Transportation","Everyday Expenses","Transportation",,$6.60,$0.00,C,$1742.53
"Us Bank",,,12/08/2014,"Download from usbank.com. UBER            866-576-1039CA","Everyday Expenses:Transportation","Everyday Expenses","Transportation",,$7.42,$0.00,C,$1735.11
"Us Bank",,,12/08/2014,"Download from usbank.com. CHIPOTLE 1857   SAN FRANCISCCA","Everyday Expenses:Spending Money","Everyday Expenses","Spending Money",,$7.56,$0.00,C,$1727.55
"Us Bank",,,12/08/2014,"Download from usbank.com. LYFT.COM FRI AT 855-280-0278CA","Everyday Expenses:Transportation","Everyday Expenses","Transportation",,$8.15,$0.00,C,$1719.40
"Us Bank",,,12/08/2014,"Download from usbank.com. BITE            SAN FRANCISCCA","Everyday Expenses:Spending Money","Everyday Expenses","Spending Money",,$9.23,$0.00,C,$1710.17
"Us Bank",,,12/08/2014,"Download from usbank.com. BAMBOO ASIA     SAN FRANCISCCA","Everyday Expenses:Spending Money","Everyday Expenses","Spending Money",,$9.73,$0.00,C,$1700.44
"Us Bank",,,12/08/2014,"Download from usbank.com. GHOST.ORGCHARGE +44207224282","Monthly Bills:Web Stuff","Monthly Bills","Web Stuff",,$10.00,$0.00,C,$1690.44
"Us Bank",,,12/08/2014,"Download from usbank.com. BRICK HOUSE CAFESAN FRANCISCCA","Everyday Expenses:Spending Money","Everyday Expenses","Spending Money",,$10.88,$0.00,C,$1679.56
"Us Bank",,,12/08/2014,"Download from usbank.com. AMAZON MKTPLACE AMZN.COM/BILWA","Everyday Expenses:Spending Money","Everyday Expenses","Spending Money",,$11.84,$0.00,C,$1667.72
"Us Bank",,,12/08/2014,"Download from usbank.com. DOLCE GELATO    SAN FRANCISCCA","Everyday Expenses:Spending Money","Everyday Expenses","Spending Money",,$13.03,$0.00,C,$1654.69
"Us Bank",,,12/08/2014,"Download from usbank.com. ETSY.COM        888-961-4798NY","Everyday Expenses:Spending Money","Everyday Expenses","Spending Money",,$16.00,$0.00,C,$1638.69
"Us Bank",,,12/08/2014,"Download from usbank.com. SQ *ANOTHER CAFESan FranciscCA","Everyday Expenses:Spending Money","Everyday Expenses","Spending Money",,$18.38,$0.00,C,$1620.31
"Us Bank",,,12/08/2014,"Download from usbank.com. WALGREENS 1300 BSAN FRANCISCCA","Everyday Expenses:Household Goods","Everyday Expenses","Household Goods",,$23.35,$0.00,C,$1596.96
"Us Bank",,,12/08/2014,"Download from usbank.com. SHOWDOWN - SF   SAN FRANCISCCA","Everyday Expenses:Spending Money","Everyday Expenses","Spending Money",,$29.00,$0.00,C,$1567.96
"Us Bank",,,12/08/2014,"Download from usbank.com. GCI*MSCN-FRND-WB800-776-5173CA","Rainy Day Funds:Gifts","Rainy Day Funds","Gifts",,$29.02,$0.00,C,$1538.94
"Us Bank",,,12/08/2014,"Download from usbank.com. JAPAN KATANA YA SAN FRANCISCCA","Everyday Expenses:Spending Money","Everyday Expenses","Spending Money",,$30.10,$0.00,C,$1508.84
"Us Bank",,,12/08/2014,"Download from usbank.com. NOB HILL CAT CLISAN FRANCISCCA","Everyday Expenses:Household Goods","Everyday Expenses","Household Goods",,$35.28,$0.00,C,$1473.56
"Us Bank",,,12/08/2014,"Download from usbank.com. 801 BUSH STREET SAN FRANCISCCAUS1","Everyday Expenses:Spending Money","Everyday Expenses","Spending Money",,$42.75,$0.00,C,$1430.81
"Us Bank",,,12/08/2014,"Download from usbank.com. TRADER JOE'S #20SAN FRANCISCCA","Everyday Expenses:Groceries","Everyday Expenses","Groceries",,$61.76,$0.00,C,$1369.05
"Us Bank",,,12/08/2014,"Download from usbank.com. WALGREENS 1300 BSAN FRANCISCCA","Everyday Expenses:Household Goods","Everyday Expenses","Household Goods",,$66.54,$0.00,C,$1302.51
"Us Bank",,,12/08/2014,"Download from usbank.com. EYEEXAM       30SAN FRANCISCCA","Everyday Expenses:Medical","Everyday Expenses","Medical",,$104.00,$0.00,C,$1198.51
"Us Bank",,,12/08/2014,"Download from usbank.com. PAYPAL","Everyday Expenses:Misc","Everyday Expenses","Misc",,$125.00,$0.00,C,$1073.51
"Us Bank",,,12/08/2014,"Download from usbank.com. GUITAR CENTER #2SAN FRANCISCCA","Everyday Expenses:Misc","Everyday Expenses","Misc",,$300.12,$0.00,C,$773.39
"Us Bank",,,12/09/2014,"Download from usbank.com. Acorns Investmen","Savings Goals:Savings","Savings Goals","Savings",,$7.13,$0.00,C,$766.26
"Us Bank",,,12/09/2014,"Download from usbank.com. DARWIN CAFE LLC SAN FRANCISCCA","Everyday Expenses:Spending Money","Everyday Expenses","Spending Money",,$13.00,$0.00,C,$753.26
"Us Bank",,,12/10/2014,"Download from usbank.com. VENMO           855-812-4430NY","Everyday Expenses:Spending Money","Everyday Expenses","Spending Money",,$12.00,$0.00,C,$741.26
"Us Bank",,,12/10/2014,"Download from usbank.com. FLY             SAN FRANCISCCA","Everyday Expenses:Spending Money","Everyday Expenses","Spending Money",,$30.00,$0.00,C,$711.26
"Us Bank",,,12/10/2014,"Download from usbank.com. TRADER JOE'S #20SAN FRANCISCCA","Everyday Expenses:Groceries","Everyday Expenses","Groceries",,$65.37,$0.00,C,$645.89
"Us Bank",,,12/10/2014,"Download from usbank.com. AMZ*Beautifi4157SAN FRANCISCCA","Everyday Expenses:Spending Money","Everyday Expenses","Spending Money",,$70.00,$0.00,C,$575.89
"Us Bank",,,12/10/2014,"Download from usbank.com. BARCLAYS BANK DE","Savings Goals:Savings","Savings Goals","Savings",,$150.00,$0.00,C,$425.89
"Us Bank",,,12/11/2014,"Download from usbank.com. CHRONICLE BOOKS SAN FRANCISCCA","Everyday Expenses:Spending Money","Everyday Expenses","Spending Money",,$5.00,$0.00,C,$420.89
"Us Bank",,,12/11/2014,"Download from usbank.com. Acorns Investmen","Savings Goals:Savings","Savings Goals","Savings",,$9.71,$0.00,C,$411.18
"Us Bank",,,12/11/2014,"Download from usbank.com. SQ *RS MEATBALLSSan FranciscCA","Everyday Expenses:Spending Money","Everyday Expenses","Spending Money",,$13.00,$0.00,C,$398.18
"Us Bank",,,12/11/2014,"Download from usbank.com. WALGREENS 500 GESAN FRANCISCCA","Everyday Expenses:Household Goods","Everyday Expenses","Household Goods",,$28.15,$0.00,C,$370.03
"Us Bank",,,12/12/2014,"Download from usbank.com. APL* ITUNES.COM/866-712-7753CA","Everyday Expenses:Spending Money","Everyday Expenses","Spending Money",,$6.93,$0.00,C,$363.10
"Us Bank",,,12/12/2014,"Download from usbank.com. MODCLOTH INC.   888-4959699 CA","Rainy Day Funds:Gifts","Rainy Day Funds","Gifts",,$111.38,$0.00,C,$251.72
"Us Bank",,,12/15/2014,"Download from usbank.com. SQWIGGLE INC","Income:Available this month","Income","Available this month",,$0.00,$1965.99,C,$2217.71
"Us Bank",,,12/15/2014,"Download from usbank.com. LYFT.COM FRI AT 855-280-0278CA","Everyday Expenses:Transportation","Everyday Expenses","Transportation",,$13.00,$0.00,C,$2204.71
"Us Bank",,,12/15/2014,"Download from usbank.com. LYFT.COM SUN AT 855-280-0278CA","Everyday Expenses:Transportation","Everyday Expenses","Transportation",,$14.47,$0.00,C,$2190.24
"Us Bank",,,12/15/2014,"Download from usbank.com. UBER            866-576-1039CA","Everyday Expenses:Transportation","Everyday Expenses","Transportation",,$17.03,$0.00,C,$2173.21
"Us Bank",,,12/15/2014,"Download from usbank.com. SQ *ANOTHER CAFESan FranciscCA","Everyday Expenses:Spending Money","Everyday Expenses","Spending Money",,$17.29,$0.00,C,$2155.92
"Us Bank",,,12/15/2014,"Download from usbank.com. SQ *ELLIE YELDINSan FranciscCA","Everyday Expenses:Spending Money","Everyday Expenses","Spending Money",,$25.00,$0.00,C,$2130.92
"Us Bank",,,12/15/2014,"Download from usbank.com. VESUVIO         SAN FRANCISCCA","Rainy Day Funds:Gifts","Rainy Day Funds","Gifts",,$30.00,$0.00,C,$2100.92
"Us Bank",,,12/15/2014,"Download from usbank.com. Mars Bar & RestaSan FranciscCA","Everyday Expenses:Spending Money","Everyday Expenses","Spending Money",,$42.16,$0.00,C,$2058.76
"Us Bank",,,12/15/2014,"Download from usbank.com. COMSTOCK SALOON SAN FRANCISCCA","Everyday Expenses:Spending Money","Everyday Expenses","Spending Money",,$52.78,$0.00,C,$2005.98
"Us Bank",,,12/15/2014,"Download from usbank.com. VENMO","Everyday Expenses:Spending Money","Everyday Expenses","Spending Money",,$57.00,$0.00,C,$1948.98
"Us Bank",,,12/15/2014,"Download from usbank.com. WALGREENS 1300 BSAN FRANCISCCA","Everyday Expenses:Household Goods","Everyday Expenses","Household Goods",,$58.84,$0.00,C,$1890.14
"Us Bank",,,12/15/2014,"Download from usbank.com. VENMO           855-812-4430NY","Everyday Expenses:Spending Money","Everyday Expenses","Spending Money",,$60.00,$0.00,C,$1830.14
"Us Bank",,,12/15/2014,"Download from usbank.com. BARCLAYS BANK DE","Savings Goals:Savings","Savings Goals","Savings",,$150.00,$0.00,C,$1680.14
"Us Bank",,,12/16/2014,"Download from usbank.com. TJ TJ MAXX      SFRANCISO   CA","Everyday Expenses:Clothing","Everyday Expenses","Clothing",,$8.13,$0.00,C,$1672.01
"Us Bank",,,12/16/2014,"Download from usbank.com. SUTTER FINE FOODSAN FRANCISCCA","Everyday Expenses:Groceries","Everyday Expenses","Groceries",,$25.88,$0.00,C,$1646.13
"Us Bank",,,12/16/2014,"Download from usbank.com. WHOLEFDS SOM 101San FranciscCA","Everyday Expenses:Groceries","Everyday Expenses","Groceries",,$33.21,$0.00,C,$1612.92
"Us Bank",,,12/16/2014,"Download from usbank.com. CITY CHOPSTICKS SAN FRANCISCCA","Everyday Expenses:Spending Money","Everyday Expenses","Spending Money",,$38.91,$0.00,C,$1574.01
"Us Bank",,,12/16/2014,"Download from usbank.com. ROSS STORES #125SAN FRANCISCCA","Everyday Expenses:Clothing","Everyday Expenses","Clothing",,$44.65,$0.00,C,$1529.36
"Us Bank",,,12/17/2014,"Download from usbank.com. STARBUCKS CARD R800-782-7282WA","Everyday Expenses:Spending Money","Everyday Expenses","Spending Money",,$10.00,$0.00,C,$1519.36
"Us Bank",,,12/17/2014,"Download from usbank.com. LYFT.COM TUE AT 855-280-0278CA","Everyday Expenses:Transportation","Everyday Expenses","Transportation",,$15.88,$0.00,C,$1503.48
"Us Bank",,,12/17/2014,"Download from usbank.com. WICHCRAFT SAN FRSAN FRANCISCCA","Everyday Expenses:Spending Money","Everyday Expenses","Spending Money",,$26.25,$0.00,C,$1477.23
"Us Bank",,,12/18/2014,"Download from usbank.com. 121814PLUSTERM896 SUTTER ST   SAN FRANCISCCAUS1","Everyday Expenses:Spending Money","Everyday Expenses","Spending Money",,$2.50,$0.00,C,$1474.73
"Us Bank",,,12/18/2014,"Download from usbank.com. SPRIG           415-894-5191CA","Everyday Expenses:Groceries","Everyday Expenses","Groceries",,$24.74,$0.00,C,$1449.99
"Us Bank",,,12/18/2014,"Download from usbank.com. MOMO'S          SAN FRANCISCCA","Everyday Expenses:Spending Money","Everyday Expenses","Spending Money",,$33.10,$0.00,C,$1416.89
"Us Bank",,,12/18/2014,"Download from usbank.com. MODCLOTH INC.   888-4959699 CA","Rainy Day Funds:Gifts","Rainy Day Funds","Gifts",,$39.88,$0.00,C,$1377.01
"Us Bank",,,12/18/2014,"Download from usbank.com. SF Muni SFMTA   San FranciscCA","Everyday Expenses:Transportation","Everyday Expenses","Transportation",,$43.00,$0.00,C,$1334.01
"Us Bank",,,12/18/2014,"Download from usbank.com. WALGREENS 1300 BSAN FRANCISCCA","Everyday Expenses:Household Goods","Everyday Expenses","Household Goods",,$69.19,$0.00,C,$1264.82
"Us Bank",,,12/18/2014,"Download from usbank.com. MODCLOTH INC.   888-4959699 CA","Everyday Expenses:Clothing","Everyday Expenses","Clothing",,$88.33,$0.00,C,$1176.49
"Us Bank",,,12/18/2014,"Download from usbank.com. 896 SUTTER ST   SAN FRANCISCCAUS1","Everyday Expenses:Misc","Everyday Expenses","Misc",,$142.50,$0.00,C,$1033.99
"Us Bank",,,12/19/2014,"Download from usbank.com. MODCLOTH INC","Income:Available this month","Income","Available this month",,$0.00,$1467.43,C,$2501.42
"Us Bank",,,12/19/2014,"Download from usbank.com. BOUDIN MACYS 424SAN FRANCISCCA","Everyday Expenses:Spending Money","Everyday Expenses","Spending Money",,$6.16,$0.00,C,$2495.26
"Us Bank",,,12/19/2014,"Download from usbank.com. Acorns Investmen","Savings Goals:Savings","Savings Goals","Savings",,$12.97,$0.00,C,$2482.29
"Us Bank",,,12/19/2014,"Download from usbank.com. ATT","Monthly Bills:Cell Phone","Monthly Bills","Cell Phone",,$63.57,$0.00,C,$2418.72
"Us Bank",,,12/19/2014,"Download from usbank.com. MODCLOTH INC.   888-4959699 CA","Everyday Expenses:Clothing","Everyday Expenses","Clothing",,$85.83,$0.00,C,$2332.89
"Us Bank",,,12/19/2014,"Download from usbank.com. WAL-MART #0069  FESTUS      MO","Rainy Day Funds:Gifts","Rainy Day Funds","Gifts",,$106.63,$0.00,C,$2226.26
"Us Bank",,,12/19/2014,"Download from usbank.com. 1271","Debt:Eric's Credit Card","Debt","Eric's Credit Card",,$252.55,$0.00,C,$1973.71
"Us Bank",,,12/22/2014,"Download from usbank.com.","Income:Available this month","Income","Available this month",,$0.00,$6.95,C,$1980.66
"Us Bank",,,12/22/2014,"Download from usbank.com.","Income:Available this month","Income","Available this month",,$6.95,$0.00,C,$1973.71
"Us Bank",,,12/22/2014,"Download from usbank.com. PHX NOCAWICH S3-PHOENIX     AZ","Everyday Expenses:Spending Money","Everyday Expenses","Spending Money",,$10.83,$0.00,C,$1962.88
"Us Bank",,,12/22/2014,"Download from usbank.com. AMAZON MKTPLACE AMZN.COM/BILWA","Everyday Expenses:Spending Money","Everyday Expenses","Spending Money",,$11.59,$0.00,C,$1951.29
"Us Bank",,,12/22/2014,"Download from usbank.com. PANERA BREAD # 6FARMINGTON  MO","Everyday Expenses:Spending Money","Everyday Expenses","Spending Money",,$12.70,$0.00,C,$1938.59
"Us Bank",,,12/22/2014,"Download from usbank.com. GULF OIL 9205456DE SOTO     MO","Everyday Expenses:Spending Money","Everyday Expenses","Spending Money",,$17.20,$0.00,C,$1921.39
"Us Bank",,,12/22/2014,"Download from usbank.com. PHX LOS TAQUITOSPHOENIX     AZ","Everyday Expenses:Spending Money","Everyday Expenses","Spending Money",,$18.60,$0.00,C,$1902.79
"Us Bank",,,12/22/2014,"Download from usbank.com. PANERA BREAD #10FESTUS      MO","Everyday Expenses:Spending Money","Everyday Expenses","Spending Money",,$24.31,$0.00,C,$1878.48
"Us Bank",,,12/22/2014,"Download from usbank.com. Amazon.com      AMZN.COM/BILWA","Everyday Expenses:Spending Money","Everyday Expenses","Spending Money",,$24.55,$0.00,C,$1853.93
"Us Bank",,,12/22/2014,"Download from usbank.com. FOX CONCESSIONS SAINT LOUIS MO","Everyday Expenses:Spending Money","Everyday Expenses","Spending Money",,$33.00,$0.00,C,$1820.93
"Us Bank",,,12/22/2014,"Download from usbank.com. WAL-MART #0069  FESTUS      MO","Rainy Day Funds:Gifts","Rainy Day Funds","Gifts",,$33.76,$0.00,C,$1787.17
"Us Bank",,,12/22/2014,"Download from usbank.com. KROGER 2770 N. WPOPLAR BLUFFMO","Everyday Expenses:Groceries","Everyday Expenses","Groceries",,$35.37,$0.00,C,$1751.80
"Us Bank",,,12/22/2014,"Download from usbank.com. Amazon.com      AMZN.COM/BILWA","Everyday Expenses:Spending Money","Everyday Expenses","Spending Money",,$36.00,$0.00,C,$1715.80
"Us Bank",,,12/22/2014,"Download from usbank.com. FOX CONCESSIONS SAINT LOUIS MO","Everyday Expenses:Spending Money","Everyday Expenses","Spending Money",,$42.00,$0.00,C,$1673.80
"Us Bank",,,12/23/2014,"Download from usbank.com. Acorns Investmen","Savings Goals:Savings","Savings Goals","Savings",,$5.21,$0.00,C,$1668.59
"Us Bank",,,12/23/2014,"Download from usbank.com. Spotify USA     877-778-1161NY","Monthly Bills:Web Stuff","Monthly Bills","Web Stuff",,$9.99,$0.00,C,$1658.60
"Us Bank",,,12/23/2014,"Download from usbank.com. Audible         888-283-5051NJ","Monthly Bills:Web Stuff","Monthly Bills","Web Stuff",,$14.95,$0.00,C,$1643.65
"Us Bank",,,12/23/2014,"Download from usbank.com. KROGER 2770 N. WPOPLAR BLUFFMO","Everyday Expenses:Groceries","Everyday Expenses","Groceries",,$24.14,$0.00,C,$1619.51
"Us Bank",,,12/24/2014,"Download from usbank.com. THE WINE RACK JAPOPLAR BLUFFMO","Everyday Expenses:Spending Money","Everyday Expenses","Spending Money",,$8.69,$0.00,C,$1610.82
"Us Bank",,,12/24/2014,"Download from usbank.com. APL* ITUNES.COM/866-712-7753CA","Everyday Expenses:Spending Money","Everyday Expenses","Spending Money",,$14.99,$0.00,C,$1595.83
"Us Bank",,,12/24/2014,"Download from usbank.com. LAS MARGARITAS  POPLAR BLUFFMO","Everyday Expenses:Spending Money","Everyday Expenses","Spending Money",,$41.02,$0.00,C,$1554.81
"Us Bank",,,12/24/2014,"Download from usbank.com. WAL Wal-Mart SupPOPLAR BLUFFMO","Everyday Expenses:Spending Money","Everyday Expenses","Spending Money",,$86.41,$0.00,C,$1468.40
"Us Bank",,,12/24/2014,"Download from usbank.com. BARCLAYS BANK DE","Savings Goals:Savings","Savings Goals","Savings",,$150.00,$0.00,C,$1318.40
"Us Bank",,,12/26/2014,"Download from usbank.com. PAYPAL","Everyday Expenses:Misc","Everyday Expenses","Misc",,$5.99,$0.00,C,$1312.41
"Us Bank",,,12/26/2014,"Download from usbank.com. HLU*Hulu 2274453HULU.COM/BILCA","Monthly Bills:Web Stuff","Monthly Bills","Web Stuff",,$7.99,$0.00,C,$1304.42
"Us Bank",,,12/26/2014,"Download from usbank.com. BOOMLAND        CHARLESTON  MO","Everyday Expenses:Spending Money","Everyday Expenses","Spending Money",,$10.43,$0.00,C,$1293.99
"Us Bank",,,12/26/2014,"Download from usbank.com. PAYPAL","Everyday Expenses:Misc","Everyday Expenses","Misc",,$15.20,$0.00,C,$1278.79
"Us Bank",,,12/26/2014,"Download from usbank.com. BREAK TIME 3125 POPLAR BLUFFMO","Everyday Expenses:Spending Money","Everyday Expenses","Spending Money",,$15.21,$0.00,C,$1263.58
"Us Bank",,,12/26/2014,"Download from usbank.com. WALGREENS 110 N POPLAR BLUFFMO","Everyday Expenses:Groceries","Everyday Expenses","Groceries",,$23.44,$0.00,C,$1240.14
"Us Bank",,,12/26/2014,"Download from usbank.com. MODCLOTH INC.   888-4959699 CA","Everyday Expenses:Clothing","Everyday Expenses","Clothing",,$45.45,$0.00,C,$1194.69
"Us Bank",,,12/29/2014,"Download from usbank.com. AMAZON DIG562687","Everyday Expenses:Spending Money","Everyday Expenses","Spending Money",,$0.00,$1.40,C,$1196.09
"Us Bank",,,12/29/2014,"Download from usbank.com. THE WINE RACK JAPOPLAR BLUFFMO","Everyday Expenses:Spending Money","Everyday Expenses","Spending Money",,$8.61,$0.00,C,$1187.48
"Us Bank",,,12/29/2014,"Download from usbank.com. Acorns Investmen","Savings Goals:Savings","Savings Goals","Savings",,$8.90,$0.00,C,$1178.58
"Us Bank",,,12/29/2014,"Download from usbank.com. PAYPAL","Monthly Bills:Web Stuff","Monthly Bills","Web Stuff",,$9.84,$0.00,C,$1168.74
"Us Bank",,,12/29/2014,"Download from usbank.com. BLUFF BURGER ANDPOPLAR BLUFFMO","Everyday Expenses:Spending Money","Everyday Expenses","Spending Money",,$19.00,$0.00,C,$1149.74
"Us Bank",,,12/29/2014,"Download from usbank.com. COLTONS - POPLARPOPLAR BLUFFMO","Everyday Expenses:Spending Money","Everyday Expenses","Spending Money",,$22.62,$0.00,C,$1127.12
"Us Bank",,,12/29/2014,"Download from usbank.com. GYFT            855-290-7261CA","Rainy Day Funds:Gifts","Rainy Day Funds","Gifts",,$25.00,$0.00,C,$1102.12
"Us Bank",,,12/29/2014,"Download from usbank.com. SKECHERS.COM #60310-318-3100CA","Rainy Day Funds:Gifts","Rainy Day Funds","Gifts",,$50.00,$0.00,C,$1052.12
"Us Bank",,,12/29/2014,"Download from usbank.com. JCPENNEY STORE 2POPLAR BLUFFMO","Everyday Expenses:Clothing","Everyday Expenses","Clothing",,$86.96,$0.00,C,$965.16
"Us Bank",,,12/30/2014,"Download from usbank.com. BARCLAYS BANK DE","Savings Goals:Savings","Savings Goals","Savings",,$0.00,$2006.66,C,$2971.82
"Us Bank",,,12/30/2014,"Download from usbank.com. Acorns Investmen","Savings Goals:Savings","Savings Goals","Savings",,$7.15,$0.00,C,$2964.67
"Us Bank",,,12/30/2014,"Download from usbank.com. THE BREAD COMPANPOPLAR BLUFFMO","Everyday Expenses:Spending Money","Everyday Expenses","Spending Money",,$7.80,$0.00,C,$2956.87
"Us Bank",,,12/30/2014,"Download from usbank.com. MAILCHIMP       MAILCHIMP.COGA","Monthly Bills:Web Stuff","Monthly Bills","Web Stuff",,$10.00,$0.00,C,$2946.87
"Us Bank",,,12/30/2014,"Download from usbank.com. BREAK TIME 3125 POPLAR BLUFFMO","Everyday Expenses:Spending Money","Everyday Expenses","Spending Money",,$10.96,$0.00,C,$2935.91
"Us Bank",,,12/30/2014,"Download from usbank.com. GTHEME","Monthly Bills:Web Stuff","Monthly Bills","Web Stuff",,$18.00,$0.00,C,$2917.91
"Us Bank",,,12/30/2014,"Download from usbank.com. BREAK TIME 3125 POPLAR BLUFFMO","Everyday Expenses:Transportation","Everyday Expenses","Transportation",,$22.10,$0.00,C,$2895.81
"Us Bank",,,12/30/2014,"Download from usbank.com. LAS MARGARITAS  POPLAR BLUFFMO","Everyday Expenses:Spending Money","Everyday Expenses","Spending Money",,$36.96,$0.00,C,$2858.85
"Us Bank",,,12/31/2014,"Download from usbank.com. SQWIGGLE INC","Income:Available this month","Income","Available this month",,$0.00,$1965.99,C,$4824.84
"Us Bank",,,12/31/2014,"Download from usbank.com. LYFT.COM TUE AT 855-280-0278CA","Everyday Expenses:Transportation","Everyday Expenses","Transportation",,$10.00,$0.00,C,$4814.84
"Us Bank",,,12/31/2014,"Download from usbank.com. KROGER LIMITED PNASHVILLE   TN","Everyday Expenses:Groceries","Everyday Expenses","Groceries",,$31.92,$0.00,C,$4782.92
"Us Bank",,,12/31/2014,"Download from usbank.com. ZAP*6PM.COM     888-676-2660NV","Rainy Day Funds:Gifts","Rainy Day Funds","Gifts",,$56.54,$0.00,C,$4726.38
"Us Bank",,,12/31/2014,"Download from usbank.com. 7246","Savings Goals:Savings","Savings Goals","Savings",,$2006.66,$0.00,C,$2719.72
"Us Bank",,,01/02/2015,"Download from usbank.com. MODCLOTH INC","Income:Available this month","Income","Available this month",,$0.00,$1527.11,C,$4246.83
"Us Bank",,,01/02/2015,"Download from usbank.com. CHICK-FIL-A #021PADUCAH     KY","Everyday Expenses:Spending Money","Everyday Expenses","Spending Money",,$7.58,$0.00,C,$4239.25
"Us Bank",,,01/02/2015,"Download from usbank.com. FIDO            NASHVILLE   TN","Everyday Expenses:Spending Money","Everyday Expenses","Spending Money",,$11.74,$0.00,C,$4227.51
"Us Bank",,,01/02/2015,"Download from usbank.com. CIRCLE K 08311  NASHVILLE   TN","Everyday Expenses:Transportation","Everyday Expenses","Transportation",,$17.80,$0.00,C,$4209.71
"Us Bank",,,01/02/2015,"Download from usbank.com. BARRY`S BOOTCAMP615-457-1571TN","Everyday Expenses:Spending Money","Everyday Expenses","Spending Money",,$22.00,$0.00,C,$4187.71
"Us Bank",,,01/02/2015,"Download from usbank.com. REGAL CINEMAS GRNASHVILLE   TN","Everyday Expenses:Spending Money","Everyday Expenses","Spending Money",,$23.50,$0.00,C,$4164.21
"Us Bank",,,01/02/2015,"Download from usbank.com. JACKSONS BAR & BNASHVILLE   TN","Everyday Expenses:Spending Money","Everyday Expenses","Spending Money",,$23.76,$0.00,C,$4140.45
"Us Bank",,,01/02/2015,"Download from usbank.com. NOLENSVILLE ROADNASHVILLE   TN","Everyday Expenses:Spending Money","Everyday Expenses","Spending Money",,$27.58,$0.00,C,$4112.87
"Us Bank",,,01/02/2015,"Download from usbank.com. PM CAFE         NASHVILLE   TN","Everyday Expenses:Spending Money","Everyday Expenses","Spending Money",,$39.57,$0.00,C,$4073.30
"Us Bank",,,01/02/2015,"Download from usbank.com. EXPRESS LLC     NASHVILLE   TN","Everyday Expenses:Spending Money","Everyday Expenses","Spending Money",,$48.05,$0.00,C,$4025.25
"Us Bank",,,01/02/2015,"Download from usbank.com. MET CAS INS CO","Monthly Bills:Car Insurance","Monthly Bills","Car Insurance",,$49.00,$0.00,C,$3976.25
"Us Bank",,,01/02/2015,"Download from usbank.com. BARCLAYS BANK DE","Savings Goals:Savings","Savings Goals","Savings",,$150.00,$0.00,C,$3826.25
"Us Bank",,,01/05/2015,"Download from usbank.com. FIVE STAR # 7625PADUCAH     KY","Everyday Expenses:Spending Money","Everyday Expenses","Spending Money",,$5.22,$0.00,C,$3821.03
"Us Bank",,,01/05/2015,"Download from usbank.com. Acorns Investmen","Savings Goals:Savings","Savings Goals","Savings",,$7.49,$0.00,C,$3813.54
"Us Bank",,,01/05/2015,"Download from usbank.com. REGAL CINEMAS GRNASHVILLE   TN","Everyday Expenses:Spending Money","Everyday Expenses","Spending Money",,$10.00,$0.00,C,$3803.54
"Us Bank",,,01/05/2015,"Download from usbank.com. STARBUCKS CARD R800-782-7282WA","Everyday Expenses:Spending Money","Everyday Expenses","Spending Money",,$10.00,$0.00,C,$3793.54
"Us Bank",,,01/05/2015,"Download from usbank.com. KROGER 2770 N. WPOPLAR BLUFFMO","Everyday Expenses:Groceries","Everyday Expenses","Groceries",,$11.49,$0.00,C,$3782.05
"Us Bank",,,01/05/2015,"Download from usbank.com. FIVE STAR # 7625PADUCAH     KY","Everyday Expenses:Transportation","Everyday Expenses","Transportation",,$14.85,$0.00,C,$3767.20
"Us Bank",,,01/05/2015,"Download from usbank.com. BONGO JAVA      NASHVILLE   TN","Everyday Expenses:Spending Money","Everyday Expenses","Spending Money",,$18.14,$0.00,C,$3749.06
"Us Bank",,,01/05/2015,"Download from usbank.com. US BANK POPLAR BPOPLAR BLUFFMOUS1","Everyday Expenses:Spending Money","Everyday Expenses","Spending Money",,$20.00,$0.00,C,$3729.06
"Us Bank",,,01/05/2015,"Download from usbank.com. SOUTH STREET 2 INASHVILLE   TN","Everyday Expenses:Spending Money","Everyday Expenses","Spending Money",,$23.74,$0.00,C,$3705.32
"Us Bank",,,01/05/2015,"Download from usbank.com. ATHENS FAMILY RENASHVILLE   TN","Everyday Expenses:Spending Money","Everyday Expenses","Spending Money",,$24.28,$0.00,C,$3681.04
"Us Bank",,,01/05/2015,"Download from usbank.com. DEXTER BAR B QUEPOPLAR BLUFFMO","Everyday Expenses:Spending Money","Everyday Expenses","Spending Money",,$24.52,$0.00,C,$3656.52
"Us Bank",,,01/05/2015,"Download from usbank.com. SAN ANTONIO TACONASHVILLE   TN","Everyday Expenses:Spending Money","Everyday Expenses","Spending Money",,$25.43,$0.00,C,$3631.09
"Us Bank",,,01/05/2015,"Download from usbank.com. KROGER 2770 N. WPOPLAR BLUFFMO","Everyday Expenses:Groceries","Everyday Expenses","Groceries",,$28.26,$0.00,C,$3602.83
"Us Bank",,,01/05/2015,"Download from usbank.com. GOOGLE*ADWS","Monthly Bills:Web Stuff","Monthly Bills","Web Stuff",,$28.39,$0.00,C,$3574.44
"Us Bank",,,01/05/2015,"Download from usbank.com. CLASSPASS       888-493-5953NY","Everyday Expenses:Spending Money","Everyday Expenses","Spending Money",,$99.00,$0.00,C,$3475.44
"Us Bank",,,01/05/2015,"Download from usbank.com. PAYPAL *MICHELLE402-935-7733CA","Everyday Expenses:Misc","Everyday Expenses","Misc",,$182.00,$0.00,C,$3293.44
"Us Bank",,,01/05/2015,"Download from usbank.com. US BANK 101 CALISAN FRANCISCCAUS1","Debt:Eric's Credit Card","Debt","Eric's Credit Card",,$300.00,$0.00,C,$2993.44
"Us Bank",,,01/06/2015,"Download from usbank.com. PANERA BREAD #10FESTUS      MO","Everyday Expenses:Spending Money","Everyday Expenses","Spending Money",,$6.49,$0.00,C,$2986.95
"Us Bank",,,01/06/2015,"Download from usbank.com. SUBWAY        00POPLAR BLUFFMO","Everyday Expenses:Spending Money","Everyday Expenses","Spending Money",,$13.86,$0.00,C,$2973.09
"Us Bank",,,01/06/2015,"Download from usbank.com. PANERA BREAD #10FESTUS      MO","Everyday Expenses:Spending Money","Everyday Expenses","Spending Money",,$23.98,$0.00,C,$2949.11
"Us Bank",,,01/06/2015,"Download from usbank.com. PGANDE","Monthly Bills:Utilities","Monthly Bills","Utilities",,$25.46,$0.00,C,$2923.65
"Us Bank",,,01/06/2015,"Download from usbank.com. 7246","Rainy Day Funds:Gifts","Rainy Day Funds","Gifts",,$49.00,$0.00,C,$2874.65
"Us Bank",,,01/06/2015,"Download from usbank.com. RUBY TUESDAY #74FESTUS      MO","Everyday Expenses:Spending Money","Everyday Expenses","Spending Money",,$61.68,$0.00,C,$2812.97
"Us Bank",,,01/07/2015,"Download from usbank.com.","Income:Available this month","Income","Available this month",,$0.20,$0.00,C,$2812.77
"Us Bank",,,01/07/2015,"Download from usbank.com. Acorns Investmen","Savings Goals:Savings","Savings Goals","Savings",,$6.96,$0.00,C,$2805.81
"Us Bank",,,01/07/2015,"Download from usbank.com. GHOST.ORGCHARGE +44207224282","Monthly Bills:Web Stuff","Monthly Bills","Web Stuff",,$10.00,$0.00,C,$2795.81
"Us Bank",,,01/07/2015,"Download from usbank.com. PAYPAL","Everyday Expenses:Spending Money","Everyday Expenses","Spending Money",,$10.00,$0.00,C,$2785.81
"Us Bank",,,01/07/2015,"Download from usbank.com. GULF OIL 9205456DE SOTO     MO","Everyday Expenses:Transportation","Everyday Expenses","Transportation",,$20.61,$0.00,C,$2765.20
"Us Bank",,,01/08/2015,"Download from usbank.com. 010815PLUSTERM1316 CASTRO ST. SAN FRANCISCCAUS1","Everyday Expenses:Spending Money","Everyday Expenses","Spending Money",,$2.50,$0.00,C,$2762.70
"Us Bank",,,01/08/2015,"Download from usbank.com. AMAZON MKTPLACE AMZN.COM/BILWA","Everyday Expenses:Spending Money","Everyday Expenses","Spending Money",,$8.49,$0.00,C,$2754.21
"Us Bank",,,01/08/2015,"Download from usbank.com. Acorns Investmen","Savings Goals:Savings","Savings Goals","Savings",,$9.82,$0.00,C,$2744.39
"Us Bank",,,01/08/2015,"Download from usbank.com. SOUTHWESTAIR*INFDALLAS      TX","Everyday Expenses:Spending Money","Everyday Expenses","Spending Money",,$10.00,$0.00,C,$2734.39
"Us Bank",,,01/08/2015,"Download from usbank.com. DNC TRAVEL HOSPIDENVER      CO","Everyday Expenses:Spending Money","Everyday Expenses","Spending Money",,$26.46,$0.00,C,$2707.93
"Us Bank",,,01/08/2015,"Download from usbank.com. PAYPAL","Everyday Expenses:Transportation","Everyday Expenses","Transportation",,$30.04,$0.00,C,$2677.89
"Us Bank",,,01/08/2015,"Download from usbank.com. 1316 CASTRO ST. SAN FRANCISCCAUS1","Everyday Expenses:Spending Money","Everyday Expenses","Spending Money",,$42.25,$0.00,C,$2635.64
"Us Bank",,,01/08/2015,"Download from usbank.com. TRADER JOE'S #20SAN FRANCISCCA","Everyday Expenses:Groceries","Everyday Expenses","Groceries",,$56.22,$0.00,C,$2579.42
"Us Bank",,,01/08/2015,"Download from usbank.com. 7246","Debt:Eric's Credit Card","Debt","Eric's Credit Card",,$450.00,$0.00,C,$2129.42
"Us Bank",,,01/09/2015,"Download from usbank.com. LYFT.COM THU AT 855-280-0278CA","Everyday Expenses:Transportation","Everyday Expenses","Transportation",,$10.49,$0.00,C,$2118.93
"Us Bank",,,01/12/2015,"Download from usbank.com.","Income:Available this month","Income","Available this month",,$0.00,$50.00,C,$2168.93
"Us Bank",,,01/12/2015,"Download from usbank.com. SQ *QUETZAL RESTSan FranciscCA","Everyday Expenses:Spending Money","Everyday Expenses","Spending Money",,$5.50,$0.00,C,$2163.43
"Us Bank",,,01/12/2015,"Download from usbank.com. LYFT.COM SAT AT 855-280-0278CA","Everyday Expenses:Transportation","Everyday Expenses","Transportation",,$7.32,$0.00,C,$2156.11
"Us Bank",,,01/12/2015,"Download from usbank.com. LYFT.COM SAT AT 855-280-0278CA","Everyday Expenses:Transportation","Everyday Expenses","Transportation",,$8.87,$0.00,C,$2147.24
"Us Bank",,,01/12/2015,"Download from usbank.com. SQ *GREENLID    San FranciscCA","Everyday Expenses:Spending Money","Everyday Expenses","Spending Money",,$9.00,$0.00,C,$2138.24
"Us Bank",,,01/12/2015,"Download from usbank.com. ORDERAHEAD AYOLA650-503-3279CA","Everyday Expenses:Spending Money","Everyday Expenses","Spending Money",,$10.06,$0.00,C,$2128.18
"Us Bank",,,01/12/2015,"Download from usbank.com. MURACCI'S JAPANESAN FRANCISCCA","Everyday Expenses:Spending Money","Everyday Expenses","Spending Money",,$10.55,$0.00,C,$2117.63
"Us Bank",,,01/12/2015,"Download from usbank.com. LYFT.COM SUN AT LYFT.ME     CA","Everyday Expenses:Transportation","Everyday Expenses","Transportation",,$10.87,$0.00,C,$2106.76
"Us Bank",,,01/12/2015,"Download from usbank.com.","Income:Available this month","Income","Available this month",,$12.50,$0.00,C,$2094.26
"Us Bank",,,01/12/2015,"Download from usbank.com. CHIPOTLE 1857   SAN FRANCISCCA","Everyday Expenses:Spending Money","Everyday Expenses","Spending Money",,$13.49,$0.00,C,$2080.77
"Us Bank",,,01/12/2015,"Download from usbank.com. MURPHYS         SAN FRANCISCCA","Everyday Expenses:Spending Money","Everyday Expenses","Spending Money",,$22.00,$0.00,C,$2058.77
"Us Bank",,,01/12/2015,"Download from usbank.com. VENMO","Everyday Expenses:Spending Money","Everyday Expenses","Spending Money",,$25.00,$0.00,C,$2033.77
"Us Bank",,,01/12/2015,"Download from usbank.com. PAYPAL","Monthly Bills:Web Stuff","Monthly Bills","Web Stuff",,$32.88,$0.00,C,$2000.89
"Us Bank",,,01/12/2015,"Download from usbank.com. MEL'S DRIVE-IN #SAN FRANCISCCA","Everyday Expenses:Spending Money","Everyday Expenses","Spending Money",,$34.06,$0.00,C,$1966.83
"Us Bank",,,01/12/2015,"Download from usbank.com. FLY             SAN FRANCISCCA","Everyday Expenses:Spending Money","Everyday Expenses","Spending Money",,$36.94,$0.00,C,$1929.89
"Us Bank",,,01/12/2015,"Download from usbank.com. PER DIEM        SAN FRANCISCCA","Everyday Expenses:Spending Money","Everyday Expenses","Spending Money",,$37.83,$0.00,C,$1892.06
"Us Bank",,,01/12/2015,"Download from usbank.com. WALGREENS 1300 BSAN FRANCISCCA","Everyday Expenses:Household Goods","Everyday Expenses","Household Goods",,$39.85,$0.00,C,$1852.21
"Us Bank",,,01/12/2015,"Download from usbank.com. WHOLEFDS FRK 100San FranciscCA","Everyday Expenses:Groceries","Everyday Expenses","Groceries",,$85.05,$0.00,C,$1767.16
"Us Bank",,,01/12/2015,"Download from usbank.com. Mosser Companies","Monthly Bills:Rent","Monthly Bills","Rent",,$1582.72,$0.00,C,$184.44
"Us Bank",,,01/13/2015,"Download from usbank.com.","Income:Available this month","Income","Available this month",,$0.00,$100.00,C,$284.44
"Us Bank",,,01/13/2015,"Download from usbank.com. AMC VAN NESS 14 SAN FRANCISCCA","Everyday Expenses:Spending Money","Everyday Expenses","Spending Money",,$3.99,$0.00,C,$280.45
"Us Bank",,,01/13/2015,"Download from usbank.com. Acorns Investmen","Savings Goals:Savings","Savings Goals","Savings",,$6.55,$0.00,C,$273.90
"Us Bank",,,01/13/2015,"Download from usbank.com. STARBUCKS CARD R800-782-7282WA","Everyday Expenses:Spending Money","Everyday Expenses","Spending Money",,$10.00,$0.00,C,$263.90
"Us Bank",,,01/13/2015,"Download from usbank.com.","Income:Available this month","Income","Available this month",,$12.50,$0.00,C,$251.40
"Us Bank",,,01/13/2015,"Download from usbank.com. Audible         888-283-5051NJ","Monthly Bills:Web Stuff","Monthly Bills","Web Stuff",,$14.95,$0.00,C,$236.45
"Us Bank",,,01/13/2015,"Download from usbank.com. AMC VAN NESS 14 SAN FRANCISCCA","Everyday Expenses:Spending Money","Everyday Expenses","Spending Money",,$20.98,$0.00,C,$215.47
"Us Bank",,,01/14/2015,"Download from usbank.com.","Income:Available this month","Income","Available this month",,$0.00,$150.00,C,$365.47
"Us Bank",,,01/14/2015,"Download from usbank.com.","Income:Available this month","Income","Available this month",,$12.50,$0.00,C,$352.97
"Us Bank",,,01/14/2015,"Download from usbank.com. HOPS & HOMINY   SAN FRANCISCCA","Everyday Expenses:Spending Money","Everyday Expenses","Spending Money",,$27.10,$0.00,C,$325.87
"Us Bank",,,01/14/2015,"Download from usbank.com. HOPS & HOMINY   SAN FRANCISCCA","Everyday Expenses:Spending Money","Everyday Expenses","Spending Money",,$69.46,$0.00,C,$256.41
"Us Bank",,,01/15/2015,"Download from usbank.com. SQWIGGLE INC","Income:Available next month","Income","Available next month",,$0.00,$1971.49,C,$2227.90
"Us Bank",,,01/15/2015,"Download from usbank.com. VENMO","Everyday Expenses:Spending Money","Everyday Expenses","Spending Money",,$0.00,$21.50,C,$2249.40
"Us Bank",,,01/15/2015,"Download from usbank.com. KASA INDIAN EATESAN FRANCISCCA","Everyday Expenses:Spending Money","Everyday Expenses","Spending Money",,$13.50,$0.00,C,$2235.90
"Us Bank",,,01/15/2015,"Download from usbank.com. TOPSYS FUNHOUSE SAN FRANCISCCA","Everyday Expenses:Spending Money","Everyday Expenses","Spending Money",,$18.40,$0.00,C,$2217.50
"Us Bank",,,01/15/2015,"Download from usbank.com. AMZ*Beautifi4157SAN FRANCISCCA","Everyday Expenses:Spending Money","Everyday Expenses","Spending Money",,$56.10,$0.00,C,$2161.40
"Us Bank",,,01/15/2015,"Download from usbank.com. ASOS US SALES LLWWW.ASOS.COMDE","Everyday Expenses:Clothing","Everyday Expenses","Clothing",,$60.85,$0.00,C,$2100.55
"Us Bank",,,01/15/2015,"Download from usbank.com. PARAGON RESTAURASAN FRANCISCCA","Everyday Expenses:Spending Money","Everyday Expenses","Spending Money",,$80.00,$0.00,C,$2020.55
"Us Bank",,,01/15/2015,"Download from usbank.com. 1271","Income:Available this month","Income","Available this month",,$300.30,$0.00,C,$1720.25
"Us Bank",,,01/16/2015,"Download from usbank.com. MODCLOTH INC","Income:Available this month","Income","Available this month",,$0.00,$1527.12,C,$3247.37
"Us Bank",,,01/16/2015,"Download from usbank.com. SQ *WORKSHOP CAFSan FranciscCA","Everyday Expenses:Spending Money","Everyday Expenses","Spending Money",,$4.00,$0.00,C,$3243.37
"Us Bank",,,01/16/2015,"Download from usbank.com. WWW.WORKSHOPCAFE4153221048  CA","Everyday Expenses:Spending Money","Everyday Expenses","Spending Money",,$10.00,$0.00,C,$3233.37
"Us Bank",,,01/16/2015,"Download from usbank.com. WWW.WORKSHOPCAFE4153221048  CA","Everyday Expenses:Spending Money","Everyday Expenses","Spending Money",,$10.00,$0.00,C,$3223.37
"Us Bank",,,01/16/2015,"Download from usbank.com. GROUPON INC     877-788-7858IL","Everyday Expenses:Spending Money","Everyday Expenses","Spending Money",,$12.00,$0.00,C,$3211.37
"Us Bank",,,01/16/2015,"Download from usbank.com. COMCAST","Monthly Bills:Internet","Monthly Bills","Internet",,$151.30,$0.00,C,$3060.07
"Us Bank",,,01/20/2015,"Download from usbank.com. PAPA JOHN'S #043415-440-7272CA","Everyday Expenses:Spending Money","Everyday Expenses","Spending Money",,$2.16,$0.00,C,$3057.91
"Us Bank",,,01/20/2015,"Download from usbank.com. CVS 10189       SAN FRANCISCCA","Everyday Expenses:Household Goods","Everyday Expenses","Household Goods",,$2.69,$0.00,C,$3055.22
"Us Bank",,,01/20/2015,"Download from usbank.com. SQ *THE POSH BAGSAN FRANCISCCA","Everyday Expenses:Spending Money","Everyday Expenses","Spending Money",,$8.20,$0.00,C,$3047.02
"Us Bank",,,01/20/2015,"Download from usbank.com. BLUE FOG MARKETSSAN FRANCISCCA","Everyday Expenses:Groceries","Everyday Expenses","Groceries",,$8.78,$0.00,C,$3038.24
"Us Bank",,,01/20/2015,"Download from usbank.com. PAYPAL","Monthly Bills:Web Stuff","Monthly Bills","Web Stuff",,$9.99,$0.00,C,$3028.25
"Us Bank",,,01/20/2015,"Download from usbank.com. PAYPAL","Monthly Bills:Web Stuff","Monthly Bills","Web Stuff",,$9.99,$0.00,C,$3018.26
"Us Bank",,,01/20/2015,"Download from usbank.com. PAYPAL","Everyday Expenses:Spending Money","Everyday Expenses","Spending Money",,$10.00,$0.00,C,$3008.26
"Us Bank",,,01/20/2015,"Download from usbank.com. STARBUCKS CARD R800-782-7282WA","Everyday Expenses:Spending Money","Everyday Expenses","Spending Money",,$10.00,$0.00,C,$2998.26
"Us Bank",,,01/20/2015,"Download from usbank.com. TAQUERIA EL SOL/SAN FRANCISCCA","Everyday Expenses:Spending Money","Everyday Expenses","Spending Money",,$15.13,$0.00,C,$2983.13
"Us Bank",,,01/20/2015,"Download from usbank.com. CHIPOTLE 1230   SAN FRANCISCCA","Everyday Expenses:Spending Money","Everyday Expenses","Spending Money",,$18.27,$0.00,C,$2964.86
"Us Bank",,,01/20/2015,"Download from usbank.com. THE CREPE HOUSE SAN FRANCISCCA","Everyday Expenses:Spending Money","Everyday Expenses","Spending Money",,$20.49,$0.00,C,$2944.37
"Us Bank",,,01/20/2015,"Download from usbank.com. FLY             SAN FRANCISCCA","Everyday Expenses:Spending Money","Everyday Expenses","Spending Money",,$22.00,$0.00,C,$2922.37
"Us Bank",,,01/20/2015,"Download from usbank.com. Bread and Cocoa San FranciscCA","Everyday Expenses:Spending Money","Everyday Expenses","Spending Money",,$24.32,$0.00,C,$2898.05
"Us Bank",,,01/20/2015,"Download from usbank.com. AMC VAN NESS 14 SAN FRANCISCCA","Everyday Expenses:Spending Money","Everyday Expenses","Spending Money",,$24.58,$0.00,C,$2873.47
"Us Bank",,,01/20/2015,"Download from usbank.com. PAYPAL","Monthly Bills:Web Stuff","Monthly Bills","Web Stuff",,$25.42,$0.00,C,$2848.05
"Us Bank",,,01/20/2015,"Download from usbank.com.","Income:Available this month","Income","Available this month",,$50.36,$0.00,C,$2797.69
"Us Bank",,,01/20/2015,"Download from usbank.com. MARU SUSHI      SAN FRANCISCCA","Everyday Expenses:Spending Money","Everyday Expenses","Spending Money",,$50.48,$0.00,C,$2747.21
"Us Bank",,,01/20/2015,"Download from usbank.com. TOPSYS FUNHOUSE SAN FRANCISCCA","Everyday Expenses:Spending Money","Everyday Expenses","Spending Money",,$60.29,$0.00,C,$2686.92
"Us Bank",,,01/20/2015,"Download from usbank.com. WALGREENS 1300 BSAN FRANCISCCA","Everyday Expenses:Household Goods","Everyday Expenses","Household Goods",,$63.66,$0.00,C,$2623.26
"Us Bank",,,01/20/2015,"Download from usbank.com. 7246","Debt:Eric's Credit Card","Debt","Eric's Credit Card",,$100.00,$0.00,C,$2523.26
"Us Bank",,,01/20/2015,"Download from usbank.com. ATT","Monthly Bills:Cell Phone","Monthly Bills","Cell Phone",,$141.63,$0.00,C,$2381.63
"Us Bank",,,01/21/2015,"Download from usbank.com. LYFT.COM TUE AT 855-280-0278CA","Everyday Expenses:Transportation","Everyday Expenses","Transportation",,$10.71,$0.00,C,$2370.92
"Us Bank",,,01/21/2015,"Download from usbank.com. SUTTER FINE FOODSAN FRANCISCCA","Everyday Expenses:Groceries","Everyday Expenses","Groceries",,$13.80,$0.00,C,$2357.12
"Us Bank",,,01/21/2015,"Download from usbank.com. AMAZON MKTPLACE AMZN.COM/BILWA","Everyday Expenses:Spending Money","Everyday Expenses","Spending Money",,$17.99,$0.00,C,$2339.13
"Us Bank",,,01/21/2015,"Download from usbank.com. UTAH SALOON     SAN FRANCISCCA","Everyday Expenses:Spending Money","Everyday Expenses","Spending Money",,$50.00,$0.00,C,$2289.13
"Us Bank",,,01/21/2015,"Download from usbank.com. AMAZON MKTPLACE AMZN.COM/BILWA","Everyday Expenses:Misc","Everyday Expenses","Misc",,$74.37,$0.00,C,$2214.76
"Us Bank",,,01/22/2015,"Download from usbank.com. ADJUSTMENT","Debt:Eric's Credit Card","Debt","Eric's Credit Card",,$0.00,$300.00,C,$2514.76
"Us Bank",,,01/22/2015,"Download from usbank.com.","Debt:Eric's Credit Card","Debt","Eric's Credit Card",,$0.00,$12.50,C,$2527.26
"Us Bank",,,01/22/2015,"Download from usbank.com.","Debt:Eric's Credit Card","Debt","Eric's Credit Card",,$0.00,$12.50,C,$2539.76
"Us Bank",,,01/22/2015,"Download from usbank.com.","Debt:Eric's Credit Card","Debt","Eric's Credit Card",,$0.00,$12.50,C,$2552.26
"Us Bank",,,01/22/2015,"Download from usbank.com. DARN GOOD FOOD  SAN FRANCISCCA","Everyday Expenses:Spending Money","Everyday Expenses","Spending Money",,$9.73,$0.00,C,$2542.53
"Us Bank",,,01/22/2015,"Download from usbank.com. LYFT.COM WED AT 855-280-0278CA","Everyday Expenses:Transportation","Everyday Expenses","Transportation",,$11.08,$0.00,C,$2531.45
"Us Bank",,,01/22/2015,"Download from usbank.com. SUTTER FINE FOODSAN FRANCISCCA","Everyday Expenses:Groceries","Everyday Expenses","Groceries",,$12.19,$0.00,C,$2519.26
"Us Bank",,,01/22/2015,"Download from usbank.com. PAYPAL","Monthly Bills:Web Stuff","Monthly Bills","Web Stuff",,$39.99,$0.00,C,$2479.27
"Us Bank",,,01/23/2015,"Download from usbank.com. SF SOUP CO BATTESAN FRANCISCCA","Everyday Expenses:Spending Money","Everyday Expenses","Spending Money",,$8.87,$0.00,C,$2470.40
"Us Bank",,,01/23/2015,"Download from usbank.com. PAYPAL","Monthly Bills:Web Stuff","Monthly Bills","Web Stuff",,$9.99,$0.00,C,$2460.41
"Us Bank",,,01/23/2015,"Download from usbank.com. Spotify USA     877-778-1161NY","Monthly Bills:Web Stuff","Monthly Bills","Web Stuff",,$9.99,$0.00,C,$2450.42
"Us Bank",,,01/23/2015,"Download from usbank.com. SPRIG           4158945191  CA","Everyday Expenses:Groceries","Everyday Expenses","Groceries",,$16.92,$0.00,C,$2433.50
"Us Bank",,,01/23/2015,"Download from usbank.com. VENMO           855-812-4430NY","Everyday Expenses:Misc","Everyday Expenses","Misc",,$182.00,$0.00,C,$2251.50
"Us Bank",,,01/26/2015,"Download from usbank.com.","Debt:Eric's Credit Card","Debt","Eric's Credit Card",,$0.00,$6.95,C,$2258.45
"Us Bank",,,01/26/2015,"Download from usbank.com. MOXIE YOGA AND FSAN FRANCISCCA","Everyday Expenses:Spending Money","Everyday Expenses","Spending Money",,$3.00,$0.00,C,$2255.45
"Us Bank",,,01/26/2015,"Download from usbank.com.","Debt:Eric's Credit Card","Debt","Eric's Credit Card",,$6.95,$0.00,C,$2248.50
"Us Bank",,,01/26/2015,"Download from usbank.com. HLU*Hulu 2274453HULU.COM/BILCA","Monthly Bills:Web Stuff","Monthly Bills","Web Stuff",,$7.99,$0.00,C,$2240.51
"Us Bank",,,01/26/2015,"Download from usbank.com. SF SOUP CO MONTGSAN FRANCISCCA","Everyday Expenses:Spending Money","Everyday Expenses","Spending Money",,$8.87,$0.00,C,$2231.64
"Us Bank",,,01/26/2015,"Download from usbank.com. SQ *PHILZ COFFEESan FranciscCA","Everyday Expenses:Spending Money","Everyday Expenses","Spending Money",,$9.00,$0.00,C,$2222.64
"Us Bank",,,01/26/2015,"Download from usbank.com. CHIPOTLE 1857   SAN FRANCISCCA","Everyday Expenses:Spending Money","Everyday Expenses","Spending Money",,$9.14,$0.00,C,$2213.50
"Us Bank",,,01/26/2015,"Download from usbank.com. BAMBOO ASIA     SAN FRANCISCCA","Everyday Expenses:Spending Money","Everyday Expenses","Spending Money",,$9.73,$0.00,C,$2203.77
"Us Bank",,,01/26/2015,"Download from usbank.com. CVS 07657       SAN FRANCISCCA","Everyday Expenses:Household Goods","Everyday Expenses","Household Goods",,$9.78,$0.00,C,$2193.99
"Us Bank",,,01/26/2015,"Download from usbank.com. IDEAL BAR & GRILSANTA CRUZ  CA","Everyday Expenses:Spending Money","Everyday Expenses","Spending Money",,$12.27,$0.00,C,$2181.72
"Us Bank",,,01/26/2015,"Download from usbank.com. SQ *COMPANION BASanta Cruz  CA","Everyday Expenses:Spending Money","Everyday Expenses","Spending Money",,$13.85,$0.00,C,$2167.87
"Us Bank",,,01/26/2015,"Download from usbank.com. SQ *DELISH DELI San FranciscCA","Everyday Expenses:Spending Money","Everyday Expenses","Spending Money",,$15.77,$0.00,C,$2152.10
"Us Bank",,,01/26/2015,"Download from usbank.com. CAPTAIN'S GALLEYSANTA CRUZ  CA","Everyday Expenses:Spending Money","Everyday Expenses","Spending Money",,$16.51,$0.00,C,$2135.59
"Us Bank",,,01/26/2015,"Download from usbank.com. DARN GOOD FOOD  SAN FRANCISCCA","Everyday Expenses:Spending Money","Everyday Expenses","Spending Money",,$18.71,$0.00,C,$2116.88
"Us Bank",,,01/26/2015,"Download from usbank.com. BITE            SAN FRANCISCCA","Everyday Expenses:Spending Money","Everyday Expenses","Spending Money",,$21.51,$0.00,C,$2095.37
"Us Bank",,,01/26/2015,"Download from usbank.com. AIRPORT BLVD GASS SAN FRANCICA","Everyday Expenses:Spending Money","Everyday Expenses","Spending Money",,$23.64,$0.00,C,$2071.73
"Us Bank",,,01/26/2015,"Download from usbank.com. IDEAL BAR & GRILSANTA CRUZ  CA","Everyday Expenses:Spending Money","Everyday Expenses","Spending Money",,$24.00,$0.00,C,$2047.73
"Us Bank",,,01/26/2015,"Download from usbank.com. TRADER JOE'S #20SAN FRANCISCCA","Everyday Expenses:Groceries","Everyday Expenses","Groceries",,$66.84,$0.00,C,$1980.89
"Us Bank",,,01/26/2015,"Download from usbank.com. AIRBNB INC      415-800-5959CA","Savings Goals:Vacation & Travel","Savings Goals","Vacation & Travel",,$118.00,$0.00,C,$1862.89
"Us Bank",,,01/26/2015,"Download from usbank.com. GETAROUND       8664382768  CA","Everyday Expenses:Transportation","Everyday Expenses","Transportation",,$131.00,$0.00,C,$1731.89
"Us Bank",,,01/27/2015,"Download from usbank.com. CITY OF CAPITOLACAPITOLA    CA","Everyday Expenses:Spending Money","Everyday Expenses","Spending Money",,$2.00,$0.00,C,$1729.89
"Us Bank",,,01/27/2015,"Download from usbank.com. CHIPOTLE 1857   SAN FRANCISCCA","Everyday Expenses:Spending Money","Everyday Expenses","Spending Money",,$7.56,$0.00,C,$1722.33
"Us Bank",,,01/27/2015,"Download from usbank.com. SUTTER FINE FOODSAN FRANCISCCA","Everyday Expenses:Groceries","Everyday Expenses","Groceries",,$7.93,$0.00,C,$1714.40
"Us Bank",,,01/27/2015,"Download from usbank.com. CHIPOTLE 1857   SAN FRANCISCCA","Everyday Expenses:Spending Money","Everyday Expenses","Spending Money",,$10.05,$0.00,C,$1704.35
"Us Bank",,,01/27/2015,"Download from usbank.com. JAMBA JUICE     SANTA CRUZ  CA","Everyday Expenses:Spending Money","Everyday Expenses","Spending Money",,$10.78,$0.00,C,$1693.57
"Us Bank",,,01/27/2015,"Download from usbank.com. ZELDAS          CAPITOLA    CA","Everyday Expenses:Spending Money","Everyday Expenses","Spending Money",,$11.00,$0.00,C,$1682.57
"Us Bank",,,01/27/2015,"Download from usbank.com. QUICKMVP.COM QUI6032891339  NY","Monthly Bills:Web Stuff","Monthly Bills","Web Stuff",,$29.99,$0.00,C,$1652.58
"Us Bank",,,01/27/2015,"Download from usbank.com. VINO PRIMA      SANTA CRUZ  CA","Everyday Expenses:Spending Money","Everyday Expenses","Spending Money",,$33.00,$0.00,C,$1619.58
"Us Bank",,,01/27/2015,"Download from usbank.com. ASOS US SALES LLWWW.ASOS.COMDE","Everyday Expenses:Clothing","Everyday Expenses","Clothing",,$46.11,$0.00,C,$1573.47
"Us Bank",,,01/27/2015,"Download from usbank.com. QUICKMVP.COM    603-289-1339NY","Monthly Bills:Web Stuff","Monthly Bills","Web Stuff",,$50.00,$0.00,C,$1523.47
"Us Bank",,,01/27/2015,"Download from usbank.com. ZELDAS          CAPITOLA    CA","Everyday Expenses:Spending Money","Everyday Expenses","Spending Money",,$52.65,$0.00,C,$1470.82
"Us Bank",,,01/28/2015,"Download from usbank.com. AMAZON DIG572529","Everyday Expenses:Spending Money","Everyday Expenses","Spending Money",,$0.00,$0.70,C,$1471.52
"Us Bank",,,01/28/2015,"Download from usbank.com. PAYPAL","Monthly Bills:Web Stuff","Monthly Bills","Web Stuff",,$26.02,$0.00,C,$1445.50
"Us Bank",,,01/29/2015,"Download from usbank.com. Apple","Everyday Expenses:Spending Money","Everyday Expenses","Spending Money",,$0.00,$19.02,C,$1464.52
"Us Bank",,,01/29/2015,"Download from usbank.com. COFFEE CULTURES SAN FRANCISCCA","Everyday Expenses:Spending Money","Everyday Expenses","Spending Money",,$7.50,$0.00,C,$1457.02
"Us Bank",,,01/29/2015,"Download from usbank.com. CHIPOTLE 1857   SAN FRANCISCCA","Everyday Expenses:Spending Money","Everyday Expenses","Spending Money",,$7.56,$0.00,C,$1449.46
"Us Bank",,,01/29/2015,"Download from usbank.com. WALGREENS 459 POSAN FRANCISCCA","Everyday Expenses:Household Goods","Everyday Expenses","Household Goods",,$9.23,$0.00,C,$1440.23
"Us Bank",,,01/29/2015,"Download from usbank.com. FEDEX 7801704954800-4633339 TN","Everyday Expenses:Spending Money","Everyday Expenses","Spending Money",,$15.79,$0.00,C,$1424.44
"Us Bank",,,01/29/2015,"Download from usbank.com. MIXT GREENS     SAN FRANCISCCA","Everyday Expenses:Spending Money","Everyday Expenses","Spending Money",,$26.75,$0.00,C,$1397.69
"Us Bank",,,01/29/2015,"Download from usbank.com. JAPAN KATANA YA SAN FRANCISCCA","Everyday Expenses:Spending Money","Everyday Expenses","Spending Money",,$40.16,$0.00,C,$1357.53
"Us Bank",,,01/29/2015,"Download from usbank.com. THE OWL TREE    SAN FRANCISCCA","Everyday Expenses:Spending Money","Everyday Expenses","Spending Money",,$43.06,$0.00,C,$1314.47
"Us Bank",,,01/30/2015,"Download from usbank.com. SQWIGGLE INC","Income:Available this month","Income","Available this month",,$0.00,$1971.49,C,$3285.96
"Us Bank",,,01/30/2015,"Download from usbank.com. MODCLOTH INC","Income:Available next month","Income","Available next month",,$0.00,$1527.10,C,$4813.06
"Us Bank",,,01/30/2015,"Download from usbank.com. ASOS US SALES LLWWW.ASOS.COMDE","Everyday Expenses:Clothing","Everyday Expenses","Clothing",,$0.00,$12.00,C,$4825.06
"Us Bank",,,01/30/2015,"Download from usbank.com. SQ *WORKSHOP CAFSan FranciscCA","Everyday Expenses:Spending Money","Everyday Expenses","Spending Money",,$4.50,$0.00,C,$4820.56
"Us Bank",,,01/30/2015,"Download from usbank.com. APL* ITUNES.COM/866-712-7753CA","Everyday Expenses:Spending Money","Everyday Expenses","Spending Money",,$4.99,$0.00,C,$4815.57
"Us Bank",,,01/30/2015,"Download from usbank.com. MAILCHIMP       MAILCHIMP.COGA","Monthly Bills:Web Stuff","Monthly Bills","Web Stuff",,$10.00,$0.00,C,$4805.57
"Us Bank",,,01/30/2015,"Download from usbank.com. SQ *BBC BARS AT Brisbane    CA","Everyday Expenses:Spending Money","Everyday Expenses","Spending Money",,$15.00,$0.00,C,$4790.57
"Us Bank",,,01/30/2015,"Download from usbank.com. PAYPAL","Monthly Bills:Web Stuff","Monthly Bills","Web Stuff",,$18.82,$0.00,C,$4771.75
"Us Bank",,,01/30/2015,"Download from usbank.com. Audible US      888-283-5051NJ","Monthly Bills:Web Stuff","Monthly Bills","Web Stuff",,$19.60,$0.00,C,$4752.15
"Us Bank",,,01/30/2015,"Download from usbank.com. SQ *BBC BARS AT San FranciscCA","Everyday Expenses:Spending Money","Everyday Expenses","Spending Money",,$21.00,$0.00,C,$4731.15
"Us Bank",,,01/30/2015,"Download from usbank.com. SQ *BBC BARS AT San FranciscCA","Everyday Expenses:Spending Money","Everyday Expenses","Spending Money",,$22.00,$0.00,C,$4709.15
"Us Bank",,,01/30/2015,"Download from usbank.com. SUTTER FINE FOODSAN FRANCISCCA","Everyday Expenses:Groceries","Everyday Expenses","Groceries",,$30.44,$0.00,C,$4678.71
"Us Bank",,,01/30/2015,"Download from usbank.com. 7246","Debt:Eric's Credit Card","Debt","Eric's Credit Card",,$1000.00,$0.00,C,$3678.71
"Us Bank",,,02/02/2015,"Download from usbank.com. ZAP*6PM.COM     888-676-2660NV","Everyday Expenses:Spending Money","Everyday Expenses","Spending Money",,$0.00,$56.54,C,$3735.25
"Us Bank",,,02/02/2015,"Download from usbank.com. QUICKMVP.COM    6032891339  NY","Monthly Bills:Web Stuff","Monthly Bills","Web Stuff",,$0.00,$29.99,C,$3765.24
"Us Bank",,,02/02/2015,"Download from usbank.com. BELLISSIMO PIZZASAN FRANCISCCA","Everyday Expenses:Spending Money","Everyday Expenses","Spending Money",,$7.00,$0.00,C,$3758.24
"Us Bank",,,02/02/2015,"Download from usbank.com. JOHNNY FOLEYS IRSAN FRANCISCCA","Everyday Expenses:Spending Money","Everyday Expenses","Spending Money",,$9.25,$0.00,C,$3748.99
"Us Bank",,,02/02/2015,"Download from usbank.com. WORKING GIRLS CASAN FRANCISCCA","Everyday Expenses:Spending Money","Everyday Expenses","Spending Money",,$9.95,$0.00,C,$3739.04
"Us Bank",,,02/02/2015,"Download from usbank.com. LYFT.COM SUN AT 855-280-0278CA","Everyday Expenses:Transportation","Everyday Expenses","Transportation",,$10.25,$0.00,C,$3728.79
"Us Bank",,,02/02/2015,"Download from usbank.com. SF WRAPS        SAN FRANCISCCA","Everyday Expenses:Spending Money","Everyday Expenses","Spending Money",,$10.33,$0.00,C,$3718.46
"Us Bank",,,02/02/2015,"Download from usbank.com. PAYPAL","Everyday Expenses:Transportation","Everyday Expenses","Transportation",,$10.42,$0.00,C,$3708.04
"Us Bank",,,02/02/2015,"Download from usbank.com. CAL ACADEMY   10SAN FRANCISCCA","Everyday Expenses:Spending Money","Everyday Expenses","Spending Money",,$10.60,$0.00,C,$3697.44
"Us Bank",,,02/02/2015,"Download from usbank.com. APL* ITUNES.COM/866-712-7753CA","Everyday Expenses:Spending Money","Everyday Expenses","Spending Money",,$11.98,$0.00,C,$3685.46
"Us Bank",,,02/02/2015,"Download from usbank.com. LYFT.COM SAT AT 855-280-0278CA","Everyday Expenses:Transportation","Everyday Expenses","Transportation",,$12.61,$0.00,C,$3672.85
"Us Bank",,,02/02/2015,"Download from usbank.com. MIXT GREENS     SAN FRANCISCCA","Everyday Expenses:Spending Money","Everyday Expenses","Spending Money",,$13.38,$0.00,C,$3659.47
"Us Bank",,,02/02/2015,"Download from usbank.com. SPRIG           415-894-5191CA","Everyday Expenses:Groceries","Everyday Expenses","Groceries",,$16.92,$0.00,C,$3642.55
"Us Bank",,,02/02/2015,"Download from usbank.com. CALIFORNIA ACADE415-379-8000CA","Everyday Expenses:Spending Money","Everyday Expenses","Spending Money",,$24.00,$0.00,C,$3618.55
"Us Bank",,,02/02/2015,"Download from usbank.com. BLUE FOG MARKETSSAN FRANCISCCA","Everyday Expenses:Groceries","Everyday Expenses","Groceries",,$26.44,$0.00,C,$3592.11
"Us Bank",,,02/02/2015,"Download from usbank.com. PAYPAL","Monthly Bills:Web Stuff","Monthly Bills","Web Stuff",,$28.73,$0.00,C,$3563.38
"Us Bank",,,02/02/2015,"Download from usbank.com. WALGREENS 500 GESAN FRANCISCCA","Everyday Expenses:Household Goods","Everyday Expenses","Household Goods",,$31.45,$0.00,C,$3531.93
"Us Bank",,,02/02/2015,"Download from usbank.com. WALGREENS 1300 BSAN FRANCISCCA","Everyday Expenses:Household Goods","Everyday Expenses","Household Goods",,$37.25,$0.00,C,$3494.68
"Us Bank",,,02/02/2015,"Download from usbank.com. SUTTER FINE FOODSAN FRANCISCCA","Everyday Expenses:Groceries","Everyday Expenses","Groceries",,$38.23,$0.00,C,$3456.45
"Us Bank",,,02/02/2015,"Download from usbank.com. MET CAS INS CO","Monthly Bills:Car Insurance","Monthly Bills","Car Insurance",,$49.00,$0.00,C,$3407.45
"Us Bank",,,02/02/2015,"Download from usbank.com. SALON MIEL      SAN FRANCISCCA","Everyday Expenses:Spending Money","Everyday Expenses","Spending Money",,$55.00,$0.00,C,$3352.45
"Us Bank",,,02/02/2015,"Download from usbank.com. GOOGLE*ADWS","Monthly Bills:Web Stuff","Monthly Bills","Web Stuff",,$65.97,$0.00,C,$3286.48
"Us Bank",,,02/02/2015,"Download from usbank.com. COMCAST","Monthly Bills:Internet","Monthly Bills","Internet",,$82.58,$0.00,C,$3203.90
"Us Bank",,,02/02/2015,"Download from usbank.com. ALDO US #2165     SAN FRANCICA","Everyday Expenses:Clothing","Everyday Expenses","Clothing",,$98.41,$0.00,C,$3105.49
"Us Bank",,,02/02/2015,"Download from usbank.com. H&M             SAN FRANCISCCA","Everyday Expenses:Clothing","Everyday Expenses","Clothing",,$127.73,$0.00,C,$2977.76
"Us Bank",,,02/03/2015,"Download from usbank.com. CAFE VENUE      SAN FRANCISCCA","Everyday Expenses:Spending Money","Everyday Expenses","Spending Money",,$10.01,$0.00,C,$2967.75
"Us Bank",,,02/03/2015,"Download from usbank.com. WHOLEFDS FRK 100San FranciscCA","Everyday Expenses:Groceries","Everyday Expenses","Groceries",,$80.26,$0.00,C,$2887.49
"Us Bank",,,02/03/2015,"Download from usbank.com. CLASSPASS.COM CL888-493-5953NY","Everyday Expenses:Spending Money","Everyday Expenses","Spending Money",,$99.00,$0.00,C,$2788.49
"Us Bank",,,02/03/2015,"Download from usbank.com. Mosser Companies","Monthly Bills:Rent","Monthly Bills","Rent",,$1582.72,$0.00,C,$1205.77
"Us Bank",,,02/04/2015,"Download from usbank.com. LYFT.COM        8552800278  CA","Everyday Expenses:Transportation","Everyday Expenses","Transportation",,$0.00,$10.25,C,$1216.02
"Us Bank",,,02/04/2015,"Download from usbank.com. SQ *ANOTHER CAFESan FranciscCA","Everyday Expenses:Spending Money","Everyday Expenses","Spending Money",,$8.65,$0.00,C,$1207.37
"Us Bank",,,02/04/2015,"Download from usbank.com. MIXT GREENS     SAN FRANCISCCA","Everyday Expenses:Spending Money","Everyday Expenses","Spending Money",,$12.30,$0.00,C,$1195.07
"Us Bank",,,02/04/2015,"Download from usbank.com. MODCLOTH INC.   888-4959699 CA","Everyday Expenses:Clothing","Everyday Expenses","Clothing",,$62.01,$0.00,C,$1133.06
"Us Bank",,,02/04/2015,"Download from usbank.com. WHOLEFDS FRK 100San FranciscCA","Everyday Expenses:Groceries","Everyday Expenses","Groceries",,$122.65,$0.00,C,$1010.41
"Us Bank",,,02/05/2015,"Download from usbank.com. APL* ITUNES.COM/866-712-7753CA","Everyday Expenses:Spending Money","Everyday Expenses","Spending Money",,$4.98,$0.00,C,$1005.43
"Us Bank",,,02/05/2015,"Download from usbank.com. SUGAR CAFE      SAN FRANCISCCA","Everyday Expenses:Spending Money","Everyday Expenses","Spending Money",,$5.00,$0.00,C,$1000.43
"Us Bank",,,02/06/2015,"Download from usbank.com.","Debt:Eric's Credit Card","Debt","Eric's Credit Card",,$0.20,$0.00,C,$1000.23
"Us Bank",,,02/06/2015,"Download from usbank.com. COFFEE CULTURES SAN FRANCISCCA","Everyday Expenses:Spending Money","Everyday Expenses","Spending Money",,$4.00,$0.00,C,$996.23
"Us Bank",,,02/06/2015,"Download from usbank.com. CHIPOTLE 1857   SAN FRANCISCCA","Everyday Expenses:Spending Money","Everyday Expenses","Spending Money",,$7.56,$0.00,C,$988.67
"Us Bank",,,02/06/2015,"Download from usbank.com. GHOST.ORGCHARGE +44207224282","Monthly Bills:Web Stuff","Monthly Bills","Web Stuff",,$10.00,$0.00,C,$978.67
"Us Bank",,,02/06/2015,"Download from usbank.com. BLUE FOG MARKETSSAN FRANCISCCA","Everyday Expenses:Groceries","Everyday Expenses","Groceries",,$12.13,$0.00,C,$966.54
"Us Bank",,,02/06/2015,"Download from usbank.com. SUTTER FINE FOODSAN FRANCISCCA","Everyday Expenses:Groceries","Everyday Expenses","Groceries",,$13.69,$0.00,C,$952.85
"Us Bank",,,02/09/2015,"Download from usbank.com. SF SOUP CO BATTESAN FRANCISCCA","Everyday Expenses:Spending Money","Everyday Expenses","Spending Money",,$3.74,$0.00,C,$949.11
"Us Bank",,,02/09/2015,"Download from usbank.com. BROWNIES HARDWARSAN FRANCISCCA","Everyday Expenses:Household Goods","Everyday Expenses","Household Goods",,$7.59,$0.00,C,$941.52
"Us Bank",,,02/09/2015,"Download from usbank.com. PAYPAL","Everyday Expenses:Spending Money","Everyday Expenses","Spending Money",,$10.00,$0.00,C,$931.52
"Us Bank",,,02/09/2015,"Download from usbank.com. MURACCI'S JAPANESAN FRANCISCCA","Everyday Expenses:Spending Money","Everyday Expenses","Spending Money",,$10.55,$0.00,C,$920.97
"Us Bank",,,02/09/2015,"Download from usbank.com. BLUE FOG MARKETSSAN FRANCISCCA","Everyday Expenses:Groceries","Everyday Expenses","Groceries",,$12.13,$0.00,C,$908.84
"Us Bank",,,02/09/2015,"Download from usbank.com. PICNIC          SAN FRANCISCCA","Everyday Expenses:Household Goods","Everyday Expenses","Household Goods",,$13.05,$0.00,C,$895.79
"Us Bank",,,02/09/2015,"Download from usbank.com. AMAZON MKTPLACE AMZN.COM/BILWA","Everyday Expenses:Spending Money","Everyday Expenses","Spending Money",,$15.94,$0.00,C,$879.85
"Us Bank",,,02/09/2015,"Download from usbank.com. BACCHUS KIRK    SAN FRANCISCCA","Everyday Expenses:Spending Money","Everyday Expenses","Spending Money",,$17.00,$0.00,C,$862.85
"Us Bank",,,02/09/2015,"Download from usbank.com. BITE            SAN FRANCISCCA","Everyday Expenses:Spending Money","Everyday Expenses","Spending Money",,$20.10,$0.00,C,$842.75
"Us Bank",,,02/09/2015,"Download from usbank.com. SUTTER FINE FOODSAN FRANCISCCA","Everyday Expenses:Groceries","Everyday Expenses","Groceries",,$24.29,$0.00,C,$818.46
"Us Bank",,,02/09/2015,"Download from usbank.com. BELCAMPO MEAT COSAN FRANCISCCA","Everyday Expenses:Spending Money","Everyday Expenses","Spending Money",,$37.63,$0.00,C,$780.83
"Us Bank",,,02/09/2015,"Download from usbank.com. THE GOLDEN GATE SAN FRANCISCCA","Everyday Expenses:Spending Money","Everyday Expenses","Spending Money",,$39.00,$0.00,C,$741.83
"Us Bank",,,02/09/2015,"Download from usbank.com. JASPERS CORNER TSAN FRANCISCCA","Everyday Expenses:Spending Money","Everyday Expenses","Spending Money",,$50.00,$0.00,C,$691.83
"Us Bank",,,02/09/2015,"Download from usbank.com. BROWNIES HARDWARSAN FRANCISCCA","Everyday Expenses:Household Goods","Everyday Expenses","Household Goods",,$70.18,$0.00,C,$621.65
"Us Bank",,,02/10/2015,"Download from usbank.com. CHIPOTLE 1857   SAN FRANCISCCA","Everyday Expenses:Spending Money","Everyday Expenses","Spending Money",,$7.56,$0.00,C,$614.09
"Us Bank",,,02/10/2015,"Download from usbank.com. BROWNIES HARDWARSAN FRANCISCCA","Everyday Expenses:Household Goods","Everyday Expenses","Household Goods",,$23.65,$0.00,C,$590.44
"Us Bank",,,02/10/2015,"Download from usbank.com. NARA SUSHI      SAN FRANCISCCA","Everyday Expenses:Spending Money","Everyday Expenses","Spending Money",,$27.36,$0.00,C,$563.08
"Us Bank",,,02/10/2015,"Download from usbank.com. UTRECHT ART 8004SAN FRANCISCCA","Everyday Expenses:Household Goods","Everyday Expenses","Household Goods",,$35.89,$0.00,C,$527.19
"Us Bank",,,02/10/2015,"Download from usbank.com. GOOD VIBRATIONS SAN FRANCISCCA","Rainy Day Funds:Gifts","Rainy Day Funds","Gifts",,$39.58,$0.00,C,$487.61
"Us Bank",,,02/11/2015,"Download from usbank.com. Coffee Bar MontgSF          CA","Everyday Expenses:Spending Money","Everyday Expenses","Spending Money",,$3.86,$0.00,C,$483.75
"Us Bank",,,02/11/2015,"Download from usbank.com. SQ *CONTRABAND CSan FranciscCA","Everyday Expenses:Spending Money","Everyday Expenses","Spending Money",,$10.31,$0.00,C,$473.44
"Us Bank",,,02/11/2015,"Download from usbank.com. MIXT GREENS     SAN FRANCISCCA","Everyday Expenses:Spending Money","Everyday Expenses","Spending Money",,$12.30,$0.00,C,$461.14
"Us Bank",,,02/11/2015,"Download from usbank.com. EAT24.COM       866-3281123 CA","Everyday Expenses:Spending Money","Everyday Expenses","Spending Money",,$31.46,$0.00,C,$429.68
"Us Bank",,,02/11/2015,"Download from usbank.com. MODCLOTH INC.   888-4959699 CA","Everyday Expenses:Clothing","Everyday Expenses","Clothing",,$39.88,$0.00,C,$389.80
"Us Bank",,,02/11/2015,"Download from usbank.com. TRADER JOE'S #20SAN FRANCISCCA","Everyday Expenses:Groceries","Everyday Expenses","Groceries",,$117.61,$0.00,C,$272.19
"Us Bank",,,02/12/2015,"Download from usbank.com.","Debt:Eric's Credit Card","Debt","Eric's Credit Card",,$0.00,$23.87,C,$296.06
"Us Bank",,,02/12/2015,"Download from usbank.com.","Debt:Eric's Credit Card","Debt","Eric's Credit Card",,$0.50,$0.00,C,$295.56
"Us Bank",,,02/12/2015,"Download from usbank.com. SQ *PHILZ COFFEESan FranciscCA","Everyday Expenses:Spending Money","Everyday Expenses","Spending Money",,$7.00,$0.00,C,$288.56
"Us Bank",,,02/12/2015,"Download from usbank.com. SQ *GOLDEN WEST San FranciscCA","Everyday Expenses:Spending Money","Everyday Expenses","Spending Money",,$9.50,$0.00,C,$279.06
"Us Bank",,,02/12/2015,"Download from usbank.com. OLD NAVY USA    San FranciscCA","Everyday Expenses:Clothing","Everyday Expenses","Clothing",,$20.80,$0.00,C,$258.26
"Us Bank",,,02/13/2015,"Download from usbank.com. SQWIGGLE INC","Income:Available this month","Income","Available this month",,$0.00,$1971.49,C,$2229.75
"Us Bank",,,02/13/2015,"Download from usbank.com. MODCLOTH INC","Income:Available this month","Income","Available this month",,$0.00,$1527.10,C,$3756.85
"Us Bank",,,02/13/2015,"Download from usbank.com. VIRGIN AMER 9842SAN FRANCISCCA","Savings Goals:Vacation & Travel","Savings Goals","Vacation & Travel",,$5.60,$0.00,C,$3751.25
"Us Bank",,,02/13/2015,"Download from usbank.com. VIRGIN AMER 9842SAN FRANCISCCA","Savings Goals:Vacation & Travel","Savings Goals","Vacation & Travel",,$5.60,$0.00,C,$3745.65
"Us Bank",,,02/13/2015,"Download from usbank.com. WORKING GIRLS CASAN FRANCISCCA","Everyday Expenses:Spending Money","Everyday Expenses","Spending Money",,$9.95,$0.00,C,$3735.70
"Us Bank",,,02/13/2015,"Download from usbank.com. Audible         888-283-5051NJ","Monthly Bills:Web Stuff","Monthly Bills","Web Stuff",,$14.95,$0.00,C,$3720.75
"Us Bank",,,02/13/2015,"Download from usbank.com. HOTEL ABRI PUCCISAN FRANCISCCA","Everyday Expenses:Spending Money","Everyday Expenses","Spending Money",,$15.57,$0.00,C,$3705.18
"Us Bank",,,02/13/2015,"Download from usbank.com. WALGREENS 1300 BSAN FRANCISCCA","Everyday Expenses:Household Goods","Everyday Expenses","Household Goods",,$45.62,$0.00,C,$3659.56
"Us Bank",,,02/13/2015,"Download from usbank.com. AMZ*Beautifi4157SAN FRANCISCCA","Everyday Expenses:Spending Money","Everyday Expenses","Spending Money",,$64.90,$0.00,C,$3594.66
"Us Bank",,,02/17/2015,"Download from usbank.com. GOLD HARVEST MA SHINGLE SPRICA","Everyday Expenses:Spending Money","Everyday Expenses","Spending Money",,$1.64,$0.00,C,$3593.02
"Us Bank",,,02/17/2015,"Download from usbank.com. APL* ITUNES.COM/866-712-7753CA","Everyday Expenses:Spending Money","Everyday Expenses","Spending Money",,$3.99,$0.00,C,$3589.03
"Us Bank",,,02/17/2015,"Download from usbank.com. MONT BLEU CASINOSTATELINE   NV","Everyday Expenses:Spending Money","Everyday Expenses","Spending Money",,$5.00,$0.00,C,$3584.03
"Us Bank",,,02/17/2015,"Download from usbank.com. SUBWAY        00S LAKE TAHOECA","Everyday Expenses:Spending Money","Everyday Expenses","Spending Money",,$5.75,$0.00,C,$3578.28
"Us Bank",,,02/17/2015,"Download from usbank.com. SAFEWAY STORE  1SOUTH LAKE TCA","Everyday Expenses:Spending Money","Everyday Expenses","Spending Money",,$5.93,$0.00,C,$3572.35
"Us Bank",,,02/17/2015,"Download from usbank.com. SAFEWAY STORE  1SOUTH LAKE TCA","Everyday Expenses:Spending Money","Everyday Expenses","Spending Money",,$6.58,$0.00,C,$3565.77
"Us Bank",,,02/17/2015,"Download from usbank.com. CHICK-FIL-A #027WALNUT CREEKCA","Everyday Expenses:Spending Money","Everyday Expenses","Spending Money",,$7.80,$0.00,C,$3557.97
"Us Bank",,,02/17/2015,"Download from usbank.com. SMARTE CARTE    ST PAUL     MN","Everyday Expenses:Spending Money","Everyday Expenses","Spending Money",,$8.00,$0.00,C,$3549.97
"Us Bank",,,02/17/2015,"Download from usbank.com. MONT BLEU CASINOSTATELINE   NV","Everyday Expenses:Spending Money","Everyday Expenses","Spending Money",,$9.00,$0.00,C,$3540.97
"Us Bank",,,02/17/2015,"Download from usbank.com. STARBUCKS CARD R800-782-7282WA","Everyday Expenses:Spending Money","Everyday Expenses","Spending Money",,$10.00,$0.00,C,$3530.97
"Us Bank",,,02/17/2015,"Download from usbank.com. SKY DECK LODGE FSTATELINE   NV","Everyday Expenses:Spending Money","Everyday Expenses","Spending Money",,$11.85,$0.00,C,$3519.12
"Us Bank",,,02/17/2015,"Download from usbank.com. STARBUCKS CARD R800-782-7282WA","Everyday Expenses:Spending Money","Everyday Expenses","Spending Money",,$15.00,$0.00,C,$3504.12
"Us Bank",,,02/17/2015,"Download from usbank.com. MODCLOTH INC.   888-4959699 CA","Everyday Expenses:Clothing","Everyday Expenses","Clothing",,$22.50,$0.00,C,$3481.62
"Us Bank",,,02/17/2015,"Download from usbank.com. MONT BLEU CASINOSTATELINE   NV","Everyday Expenses:Spending Money","Everyday Expenses","Spending Money",,$26.00,$0.00,C,$3455.62
"Us Bank",,,02/17/2015,"Download from usbank.com. THE BREWERY AT LS LAKE TAHOECA","Everyday Expenses:Spending Money","Everyday Expenses","Spending Money",,$32.48,$0.00,C,$3423.14
"Us Bank",,,02/17/2015,"Download from usbank.com. VENMO           855-812-4430NY","Everyday Expenses:Spending Money","Everyday Expenses","Spending Money",,$33.00,$0.00,C,$3390.14
"Us Bank",,,02/17/2015,"Download from usbank.com. PAYPAL","Everyday Expenses:Spending Money","Everyday Expenses","Spending Money",,$39.99,$0.00,C,$3350.15
"Us Bank",,,02/17/2015,"Download from usbank.com. TRADER JOE'S #20SAN FRANCISCCA","Everyday Expenses:Groceries","Everyday Expenses","Groceries",,$62.94,$0.00,C,$3287.21
"Us Bank",,,02/17/2015,"Download from usbank.com. HEAVENLY MAIN LOSO LAKE TAHOCA","Everyday Expenses:Spending Money","Everyday Expenses","Spending Money",,$74.56,$0.00,C,$3212.65
"Us Bank",,,02/17/2015,"Download from usbank.com. SAFEWAY STORE  1SOUTH LAKE TCA","Everyday Expenses:Groceries","Everyday Expenses","Groceries",,$92.29,$0.00,C,$3120.36
"Us Bank",,,02/17/2015,"Download from usbank.com. HEAVENLY LIFT TKSO LAKE TAHOCA","Everyday Expenses:Spending Money","Everyday Expenses","Spending Money",,$125.00,$0.00,C,$2995.36
"Us Bank",,,02/18/2015,"Download from usbank.com. ASOS US SALES LLWWW.ASOS.COMDE","Everyday Expenses:Clothing","Everyday Expenses","Clothing",,$0.00,$34.11,C,$3029.47
"Us Bank",,,02/18/2015,"Download from usbank.com. URBAN YOGURT INCSHINGLE SPRICA","Everyday Expenses:Spending Money","Everyday Expenses","Spending Money",,$4.50,$0.00,C,$3024.97
"Us Bank",,,02/18/2015,"Download from usbank.com. Acorns Investmen","Savings Goals:Savings","Savings Goals","Savings",,$9.56,$0.00,C,$3015.41
"Us Bank",,,02/18/2015,"Download from usbank.com. PAYPAL","Monthly Bills:Web Stuff","Monthly Bills","Web Stuff",,$9.99,$0.00,C,$3005.42
"Us Bank",,,02/19/2015,"Download from usbank.com. SF SOUP CO MONTGSAN FRANCISCCA","Everyday Expenses:Spending Money","Everyday Expenses","Spending Money",,$10.38,$0.00,C,$2995.04
"Us Bank",,,02/19/2015,"Download from usbank.com. ATT","Monthly Bills:Cell Phone","Monthly Bills","Cell Phone",,$142.10,$0.00,C,$2852.94
"Us Bank",,,02/20/2015,"Download from usbank.com. VIRGIN AMER 9840BURLINGAME  CA","Savings Goals:Vacation & Travel","Savings Goals","Vacation & Travel",,$0.00,$5.60,C,$2858.54
"Us Bank",,,02/20/2015,"Download from usbank.com. VIRGIN AMER 9840BURLINGAME  CA","Savings Goals:Vacation & Travel","Savings Goals","Vacation & Travel",,$0.00,$5.60,C,$2864.14
"Us Bank",,,02/20/2015,"Download from usbank.com. BALADIE GOURMET SAN FRANCISCCA","Everyday Expenses:Spending Money","Everyday Expenses","Spending Money",,$8.95,$0.00,C,$2855.19
"Us Bank",,,02/20/2015,"Download from usbank.com. MANHATTAN HUB   SAN FRANCISCCA","Everyday Expenses:Spending Money","Everyday Expenses","Spending Money",,$8.97,$0.00,C,$2846.22
"Us Bank",,,02/20/2015,"Download from usbank.com. PAYPAL","Monthly Bills:Web Stuff","Monthly Bills","Web Stuff",,$9.99,$0.00,C,$2836.23
"Us Bank",,,02/20/2015,"Download from usbank.com. PIRAAT PIZZERIA SAN FRANCISCCA","Everyday Expenses:Spending Money","Everyday Expenses","Spending Money",,$10.79,$0.00,C,$2825.44
"Us Bank",,,02/23/2015,"Download from usbank.com. APL* ITUNES.COM/866-712-7753CA","Everyday Expenses:Spending Money","Everyday Expenses","Spending Money",,$3.99,$0.00,C,$2821.45
"Us Bank",,,02/23/2015,"Download from usbank.com. SQ *PHILZ COFFEESan FranciscCA","Everyday Expenses:Spending Money","Everyday Expenses","Spending Money",,$7.25,$0.00,C,$2814.20
"Us Bank",,,02/23/2015,"Download from usbank.com. SQ *PHILZ COFFEESan FranciscCA","Everyday Expenses:Spending Money","Everyday Expenses","Spending Money",,$7.75,$0.00,C,$2806.45
"Us Bank",,,02/23/2015,"Download from usbank.com. BITE            SAN FRANCISCCA","Everyday Expenses:Spending Money","Everyday Expenses","Spending Money",,$9.78,$0.00,C,$2796.67
"Us Bank",,,02/23/2015,"Download from usbank.com. PAYPAL","Monthly Bills:Web Stuff","Monthly Bills","Web Stuff",,$9.99,$0.00,C,$2786.68
"Us Bank",,,02/23/2015,"Download from usbank.com. Spotify USA     877-778-1161NY","Monthly Bills:Web Stuff","Monthly Bills","Web Stuff",,$9.99,$0.00,C,$2776.69
"Us Bank",,,02/23/2015,"Download from usbank.com. PAYPAL","Everyday Expenses:Spending Money","Everyday Expenses","Spending Money",,$10.00,$0.00,C,$2766.69
"Us Bank",,,02/23/2015,"Download from usbank.com. SQ *ANOTHER CAFESan FranciscCA","Everyday Expenses:Spending Money","Everyday Expenses","Spending Money",,$18.21,$0.00,C,$2748.48
"Us Bank",,,02/23/2015,"Download from usbank.com. DARN GOOD FOOD  SAN FRANCISCCA","Everyday Expenses:Spending Money","Everyday Expenses","Spending Money",,$19.47,$0.00,C,$2729.01
"Us Bank",,,02/23/2015,"Download from usbank.com. PAYPAL","Monthly Bills:Web Stuff","Monthly Bills","Web Stuff",,$24.84,$0.00,C,$2704.17
"Us Bank",,,02/23/2015,"Download from usbank.com. AmazonLocal     866-395-2090WA","Everyday Expenses:Spending Money","Everyday Expenses","Spending Money",,$36.00,$0.00,C,$2668.17
"Us Bank",,,02/23/2015,"Download from usbank.com. MURPHYS         SAN FRANCISCCA","Everyday Expenses:Spending Money","Everyday Expenses","Spending Money",,$40.60,$0.00,C,$2627.57
"Us Bank",,,02/23/2015,"Download from usbank.com. MODERN THAI     SAN FRANCISCCA","Everyday Expenses:Spending Money","Everyday Expenses","Spending Money",,$49.69,$0.00,C,$2577.88
"Us Bank",,,02/24/2015,"Download from usbank.com. PAYPAL","Debt:Eric's Credit Card","Debt","Eric's Credit Card",,$0.00,$282.14,C,$2860.02
"Us Bank",,,02/24/2015,"Download from usbank.com.","Debt:Eric's Credit Card","Debt","Eric's Credit Card",,$0.00,$6.95,C,$2866.97
"Us Bank",,,02/24/2015,"Download from usbank.com. APL* ITUNES.COM/866-712-7753CA","Everyday Expenses:Spending Money","Everyday Expenses","Spending Money",,$4.99,$0.00,C,$2861.98
"Us Bank",,,02/24/2015,"Download from usbank.com.","Debt:Eric's Credit Card","Debt","Eric's Credit Card",,$6.95,$0.00,C,$2855.03
"Us Bank",,,02/24/2015,"Download from usbank.com. SLIDERS DINER   SAN FRANCISCCA","Everyday Expenses:Spending Money","Everyday Expenses","Spending Money",,$11.42,$0.00,C,$2843.61
"Us Bank",,,02/24/2015,"Download from usbank.com. BLUE FOG MARKETSSAN FRANCISCCA","Everyday Expenses:Groceries","Everyday Expenses","Groceries",,$17.04,$0.00,C,$2826.57
"Us Bank",,,02/24/2015,"Download from usbank.com. GOODWILL SF - FLSAN FRANCISCCA","Everyday Expenses:Spending Money","Everyday Expenses","Spending Money",,$22.14,$0.00,C,$2804.43
"Us Bank",,,02/24/2015,"Download from usbank.com. BLAZING SADDLES SAN FRANCISCCA","Everyday Expenses:Spending Money","Everyday Expenses","Spending Money",,$23.00,$0.00,C,$2781.43
"Us Bank",,,02/24/2015,"Download from usbank.com. PAYPAL","Monthly Bills:Web Stuff","Monthly Bills","Web Stuff",,$46.34,$0.00,C,$2735.09
"Us Bank",,,02/24/2015,"Download from usbank.com. BAR BOCCE       SAUSALITO   CA","Everyday Expenses:Spending Money","Everyday Expenses","Spending Money",,$58.00,$0.00,C,$2677.09
"Us Bank",,,02/24/2015,"Download from usbank.com. 7246","Debt:Eric's Credit Card","Debt","Eric's Credit Card",,$301.65,$0.00,C,$2375.44
"Us Bank",,,02/24/2015,"Download from usbank.com. 7246","Debt:Eric's Credit Card","Debt","Eric's Credit Card",,$798.96,$0.00,C,$1576.48
"Us Bank",,,02/25/2015,"Download from usbank.com. VENMO","Debt:Eric's Credit Card","Debt","Eric's Credit Card",,$0.00,$505.06,C,$2081.54
"Us Bank",,,02/25/2015,"Download from usbank.com. PAYPAL","Monthly Bills:Web Stuff","Monthly Bills","Web Stuff",,$3.10,$0.00,C,$2078.44
"Us Bank",,,02/25/2015,"Download from usbank.com. COFFEE CULTURES SAN FRANCISCCA","Everyday Expenses:Spending Money","Everyday Expenses","Spending Money",,$4.00,$0.00,C,$2074.44
"Us Bank",,,02/25/2015,"Download from usbank.com. PAYPAL","Everyday Expenses:Transportation","Everyday Expenses","Transportation",,$5.00,$0.00,C,$2069.44
"Us Bank",,,02/25/2015,"Download from usbank.com. HLU*Hulu 2274453HULU.COM/BILCA","Monthly Bills:Web Stuff","Monthly Bills","Web Stuff",,$7.99,$0.00,C,$2061.45
"Us Bank",,,02/25/2015,"Download from usbank.com. UBER TECHNOLOGIE866-576-1039CA","Everyday Expenses:Transportation","Everyday Expenses","Transportation",,$8.28,$0.00,C,$2053.17
"Us Bank",,,02/25/2015,"Download from usbank.com. BAMBOO ASIA     SAN FRANCISCCA","Everyday Expenses:Spending Money","Everyday Expenses","Spending Money",,$10.10,$0.00,C,$2043.07
"Us Bank",,,02/25/2015,"Download from usbank.com. WALGREENS 1300 BSAN FRANCISCCA","Everyday Expenses:Household Goods","Everyday Expenses","Household Goods",,$26.51,$0.00,C,$2016.56
"Us Bank",,,02/25/2015,"Download from usbank.com. UTAH SALOON     SAN FRANCISCCA","Everyday Expenses:Spending Money","Everyday Expenses","Spending Money",,$59.00,$0.00,C,$1957.56
"Us Bank",,,02/25/2015,"Download from usbank.com. TRADER JOE'S #20SAN FRANCISCCA","Everyday Expenses:Groceries","Everyday Expenses","Groceries",,$63.72,$0.00,C,$1893.84
"Us Bank",,,02/26/2015,"Download from usbank.com. PROSPER MARKETPL","Debt:Eric's Credit Card","Debt","Eric's Credit Card",,$0.00,$1232.00,C,$3125.84
"Us Bank",,,02/26/2015,"Download from usbank.com. BARCLAYS BANK DE","Savings Goals:Savings","Savings Goals","Savings",,$0.00,$301.65,C,$3427.49
"Us Bank",,,02/26/2015,"Download from usbank.com. Acorns Investmen","Savings Goals:Savings","Savings Goals","Savings",,$7.77,$0.00,C,$3419.72
"Us Bank",,,02/26/2015,"Download from usbank.com. AYOLA (KEARNY)  SAN FRANCISCCA","Everyday Expenses:Spending Money","Everyday Expenses","Spending Money",,$10.82,$0.00,C,$3408.90
"Us Bank",,,02/26/2015,"Download from usbank.com. BLUE FOG MARKETSSAN FRANCISCCA","Everyday Expenses:Groceries","Everyday Expenses","Groceries",,$12.13,$0.00,C,$3396.77
"Us Bank",,,02/26/2015,"Download from usbank.com. MODCLOTH INC.   888-4959699 CA","Everyday Expenses:Clothing","Everyday Expenses","Clothing",,$29.86,$0.00,C,$3366.91
"Us Bank",,,02/26/2015,"Download from usbank.com. SOUTHWES    5262800-435-9792TX","Savings Goals:Vacation & Travel","Savings Goals","Vacation & Travel",,$285.60,$0.00,C,$3081.31
"Us Bank",,,02/26/2015,"Download from usbank.com. 7246","Debt:Eric's Credit Card","Debt","Eric's Credit Card",,$1232.00,$0.00,C,$1849.31
"Us Bank",,,02/27/2015,"Download from usbank.com. SQWIGGLE INC","Income:Available this month","Income","Available this month",,$0.00,$1971.49,C,$3820.80
"Us Bank",,,02/27/2015,"Download from usbank.com. MODCLOTH INC","Income:Available this month","Income","Available this month",,$0.00,$1527.10,C,$5347.90
"Us Bank",,,02/27/2015,"Download from usbank.com. COFFEE CULTURES SAN FRANCISCCA","Everyday Expenses:Spending Money","Everyday Expenses","Spending Money",,$4.00,$0.00,C,$5343.90
"Us Bank",,,02/27/2015,"Download from usbank.com. LYFT THU AT 1004855-280-0278CA","Everyday Expenses:Spending Money","Everyday Expenses","Spending Money",,$4.00,$0.00,C,$5339.90
"Us Bank",,,02/27/2015,"Download from usbank.com. SQ *ANOTHER CAFESan FranciscCA","Everyday Expenses:Spending Money","Everyday Expenses","Spending Money",,$8.65,$0.00,C,$5331.25
"Us Bank",,,02/27/2015,"Download from usbank.com. SORABOL_RINCON CSAN FRANCISCCA","Everyday Expenses:Spending Money","Everyday Expenses","Spending Money",,$9.73,$0.00,C,$5321.52
"Us Bank",,,02/27/2015,"Download from usbank.com. SLIDERS DINER   SAN FRANCISCCA","Everyday Expenses:Spending Money","Everyday Expenses","Spending Money",,$11.42,$0.00,C,$5310.10
"Us Bank",,,02/27/2015,"Download from usbank.com. BITE            SAN FRANCISCCA","Everyday Expenses:Spending Money","Everyday Expenses","Spending Money",,$20.86,$0.00,C,$5289.24
"Us Bank",,,02/27/2015,"Download from usbank.com. ATLAS TAP ROOM  SAN FRANCISCCA","Everyday Expenses:Spending Money","Everyday Expenses","Spending Money",,$46.81,$0.00,C,$5242.43
"Us Bank",,,02/27/2015,"Download from usbank.com. SOUTHWES    5262800-435-9792TX","Savings Goals:Vacation & Travel","Savings Goals","Vacation & Travel",,$285.60,$0.00,C,$4956.83
"Us Bank",,,03/02/2015,"Download from usbank.com. PROSPER MARKETPL","Debt:Eric's Credit Card","Debt","Eric's Credit Card",,$0.00,$574.29,C,$5531.12
"Us Bank",,,03/02/2015,"Download from usbank.com. AMAZON DIG584059","Everyday Expenses:Spending Money","Everyday Expenses","Spending Money",,$0.00,$1.40,C,$5532.52
"Us Bank",,,03/02/2015,"Download from usbank.com. GUITAR CENTER #2SAN FRANCISCCA","Everyday Expenses:Spending Money","Everyday Expenses","Spending Money",,$1.73,$0.00,C,$5530.79
"Us Bank",,,03/02/2015,"Download from usbank.com. SUTTER FINE FOODSAN FRANCISCCA","Everyday Expenses:Groceries","Everyday Expenses","Groceries",,$2.99,$0.00,C,$5527.80
"Us Bank",,,03/02/2015,"Download from usbank.com. PAYPAL","Everyday Expenses:Spending Money","Everyday Expenses","Spending Money",,$3.90,$0.00,C,$5523.90
"Us Bank",,,03/02/2015,"Download from usbank.com. DAZBOG COFFEE   DENVER      CO","Everyday Expenses:Spending Money","Everyday Expenses","Spending Money",,$4.27,$0.00,C,$5519.63
"Us Bank",,,03/02/2015,"Download from usbank.com. APL* ITUNES.COM/866-712-7753CA","Everyday Expenses:Spending Money","Everyday Expenses","Spending Money",,$4.99,$0.00,C,$5514.64
"Us Bank",,,03/02/2015,"Download from usbank.com. PAYPAL","Everyday Expenses:Transportation","Everyday Expenses","Transportation",,$7.00,$0.00,C,$5507.64
"Us Bank",,,03/02/2015,"Download from usbank.com. SMARTE CARTE    ST PAUL     MN","Everyday Expenses:Spending Money","Everyday Expenses","Spending Money",,$7.00,$0.00,C,$5500.64
"Us Bank",,,03/02/2015,"Download from usbank.com. FRESHROLL       SAN FRANCISCCA","Everyday Expenses:Spending Money","Everyday Expenses","Spending Money",,$8.09,$0.00,C,$5492.55
"Us Bank",,,03/02/2015,"Download from usbank.com. SQUAW VALLEY STAOLYMPIC VALLCA","Everyday Expenses:Spending Money","Everyday Expenses","Spending Money",,$8.71,$0.00,C,$5483.84
"Us Bank",,,03/02/2015,"Download from usbank.com. SF SOUP CO MONTGSAN FRANCISCCA","Everyday Expenses:Spending Money","Everyday Expenses","Spending Money",,$8.87,$0.00,C,$5474.97
"Us Bank",,,03/02/2015,"Download from usbank.com. WOODY CREEK BAKEDENVER      CO","Everyday Expenses:Spending Money","Everyday Expenses","Spending Money",,$8.91,$0.00,C,$5466.06
"Us Bank",,,03/02/2015,"Download from usbank.com. Acorns Investmen","Savings Goals:Savings","Savings Goals","Savings",,$9.41,$0.00,C,$5456.65
"Us Bank",,,03/02/2015,"Download from usbank.com. MAILCHIMP       MAILCHIMP.COGA","Monthly Bills:Web Stuff","Monthly Bills","Web Stuff",,$10.00,$0.00,C,$5446.65
"Us Bank",,,03/02/2015,"Download from usbank.com. STARBUCKS CARD R800-782-7282WA","Everyday Expenses:Spending Money","Everyday Expenses","Spending Money",,$10.00,$0.00,C,$5436.65
"Us Bank",,,03/02/2015,"Download from usbank.com. BREAK TIME 3125 POPLAR BLUFFMO","Everyday Expenses:Transportation","Everyday Expenses","Transportation",,$11.88,$0.00,C,$5424.77
"Us Bank",,,03/02/2015,"Download from usbank.com. WALGREENS 1300 BSAN FRANCISCCA","Everyday Expenses:Household Goods","Everyday Expenses","Household Goods",,$15.40,$0.00,C,$5409.37
"Us Bank",,,03/02/2015,"Download from usbank.com. GRANITE CITY - FFRANKLIN    TN","Everyday Expenses:Spending Money","Everyday Expenses","Spending Money",,$27.43,$0.00,C,$5381.94
"Us Bank",,,03/02/2015,"Download from usbank.com. GUITAR CENTER #2SAN FRANCISCCA","Everyday Expenses:Spending Money","Everyday Expenses","Spending Money",,$28.26,$0.00,C,$5353.68
"Us Bank",,,03/02/2015,"Download from usbank.com. SQUAW VALLEY OLYOLYMPIC VALLCA","Everyday Expenses:Spending Money","Everyday Expenses","Spending Money",,$34.00,$0.00,C,$5319.68
"Us Bank",,,03/02/2015,"Download from usbank.com. TRADER JOE'S #20SAN FRANCISCCA","Everyday Expenses:Groceries","Everyday Expenses","Groceries",,$36.00,$0.00,C,$5283.68
"Us Bank",,,03/02/2015,"Download from usbank.com. MET CAS INS CO","Monthly Bills:Car Insurance","Monthly Bills","Car Insurance",,$52.16,$0.00,C,$5231.52
"Us Bank",,,03/02/2015,"Download from usbank.com. PLUMPJACK SPORT OLYMPIC VALLCA","Everyday Expenses:Spending Money","Everyday Expenses","Spending Money",,$87.20,$0.00,C,$5144.32
"Us Bank",,,03/02/2015,"Download from usbank.com. PAYPAL","Everyday Expenses:Misc","Everyday Expenses","Misc",,$134.00,$0.00,C,$5010.32
"Us Bank",,,03/02/2015,"Download from usbank.com. MOUNTAINWEST    SAN FRANCISCCA","Everyday Expenses:Misc","Everyday Expenses","Misc",,$374.08,$0.00,C,$4636.24
"Us Bank",,,03/03/2015,"Download from usbank.com. CHIPOTLE 1857   SAN FRANCISCCA","Everyday Expenses:Spending Money","Everyday Expenses","Spending Money",,$7.56,$0.00,C,$4628.68
"Us Bank",,,03/03/2015,"Download from usbank.com. PASTA HOUSE     SAINT LOUIS MO","Everyday Expenses:Spending Money","Everyday Expenses","Spending Money",,$27.86,$0.00,C,$4600.82
"Us Bank",,,03/03/2015,"Download from usbank.com. GOOGLE*ADWS","Monthly Bills:Web Stuff","Monthly Bills","Web Stuff",,$36.86,$0.00,C,$4563.96
"Us Bank",,,03/03/2015,"Download from usbank.com. CLASSPASS.COM CL888-493-5953NY","Everyday Expenses:Spending Money","Everyday Expenses","Spending Money",,$99.00,$0.00,C,$4464.96
"Us Bank",,,03/03/2015,"Download from usbank.com. 7246","Debt:Eric's Credit Card","Debt","Eric's Credit Card",,$574.29,$0.00,C,$3890.67
"Us Bank",,,03/03/2015,"Download from usbank.com. Mosser Companies","Monthly Bills:Rent","Monthly Bills","Rent",,$1582.72,$0.00,C,$2307.95
"Us Bank",,,03/04/2015,"Download from usbank.com. EINSTEINS BAGELSDENVER      CO","Everyday Expenses:Spending Money","Everyday Expenses","Spending Money",,$7.72,$0.00,C,$2300.23
"Us Bank",,,03/04/2015,"Download from usbank.com. HUDSON NEWS     DENVER      CO","Everyday Expenses:Spending Money","Everyday Expenses","Spending Money",,$8.94,$0.00,C,$2291.29
"Us Bank",,,03/04/2015,"Download from usbank.com. SUTTER FINE FOODSAN FRANCISCCA","Everyday Expenses:Groceries","Everyday Expenses","Groceries",,$8.98,$0.00,C,$2282.31
"Us Bank",,,03/04/2015,"Download from usbank.com. LYFT SAT AT 0855855-280-0278CA","Everyday Expenses:Spending Money","Everyday Expenses","Spending Money",,$9.71,$0.00,C,$2272.60
"Us Bank",,,03/04/2015,"Download from usbank.com. Acorns Investmen","Savings Goals:Savings","Savings Goals","Savings",,$9.97,$0.00,C,$2262.63
"Us Bank",,,03/04/2015,"Download from usbank.com. STARBUCKS CARD R800-782-7282WA","Everyday Expenses:Spending Money","Everyday Expenses","Spending Money",,$10.00,$0.00,C,$2252.63
"Us Bank",,,03/04/2015,"Download from usbank.com. SUSHIRRITO      SAN FRANCISCCA","Everyday Expenses:Spending Money","Everyday Expenses","Spending Money",,$11.42,$0.00,C,$2241.21
"Us Bank",,,03/04/2015,"Download from usbank.com. APL* ITUNES.COM/866-712-7753CA","Everyday Expenses:Spending Money","Everyday Expenses","Spending Money",,$11.97,$0.00,C,$2229.24
"Us Bank",,,03/04/2015,"Download from usbank.com. Uber Technologie866-5761039 CA","Everyday Expenses:Transportation","Everyday Expenses","Transportation",,$15.00,$0.00,C,$2214.24
"Us Bank",,,03/04/2015,"Download from usbank.com. TARGET T3201    SAN FRANCISCCA","Everyday Expenses:Spending Money","Everyday Expenses","Spending Money",,$28.98,$0.00,C,$2185.26
"Us Bank",,,03/04/2015,"Download from usbank.com. Amazon.com      AMZN.COM/BILWA","Everyday Expenses:Spending Money","Everyday Expenses","Spending Money",,$48.89,$0.00,C,$2136.37
"Us Bank",,,03/04/2015,"Download from usbank.com. WHOLEFDS FRK 100San FranciscCA","Everyday Expenses:Groceries","Everyday Expenses","Groceries",,$68.91,$0.00,C,$2067.46
"Us Bank",,,03/05/2015,"Download from usbank.com. VENMO","Everyday Expenses:Spending Money","Everyday Expenses","Spending Money",,$10.00,$0.00,C,$2057.46
"Us Bank",,,03/05/2015,"Download from usbank.com. SUGAR CAFE      SAN FRANCISCCA","Everyday Expenses:Spending Money","Everyday Expenses","Spending Money",,$10.64,$0.00,C,$2046.82
"Us Bank",,,03/05/2015,"Download from usbank.com. HARPER & RYE    SAN FRANCISCCA","Everyday Expenses:Spending Money","Everyday Expenses","Spending Money",,$14.05,$0.00,C,$2032.77
"Us Bank",,,03/05/2015,"Download from usbank.com. ESAVVY DENVER   DENVER      CO","Everyday Expenses:Spending Money","Everyday Expenses","Spending Money",,$21.51,$0.00,C,$2011.26
"Us Bank",,,03/05/2015,"Download from usbank.com. PAYPAL","Everyday Expenses:Misc","Everyday Expenses","Misc",,$290.00,$0.00,C,$1721.26
"Us Bank",,,03/06/2015,"Download from usbank.com.","Debt:Eric's Credit Card","Debt","Eric's Credit Card",,$0.20,$0.00,C,$1721.06
"Us Bank",,,03/06/2015,"Download from usbank.com. APL* ITUNES.COM/866-712-7753CA","Everyday Expenses:Spending Money","Everyday Expenses","Spending Money",,$7.98,$0.00,C,$1713.08
"Us Bank",,,03/06/2015,"Download from usbank.com. BAMBOO ASIA     SAN FRANCISCCA","Everyday Expenses:Spending Money","Everyday Expenses","Spending Money",,$9.73,$0.00,C,$1703.35
"Us Bank",,,03/06/2015,"Download from usbank.com. GHOST PERSONAL  +44207224282","Monthly Bills:Web Stuff","Monthly Bills","Web Stuff",,$10.00,$0.00,C,$1693.35
"Us Bank",,,03/06/2015,"Download from usbank.com. Audible US      888-283-5051NJ","Monthly Bills:Web Stuff","Monthly Bills","Web Stuff",,$17.14,$0.00,C,$1676.21
"Us Bank",,,03/06/2015,"Download from usbank.com. PAYPAL","Everyday Expenses:Spending Money","Everyday Expenses","Spending Money",,$20.00,$0.00,C,$1656.21
"Us Bank",,,03/06/2015,"Download from usbank.com. TARGET T3201    SAN FRANCISCCA","Everyday Expenses:Spending Money","Everyday Expenses","Spending Money",,$43.55,$0.00,C,$1612.66
"Us Bank",,,03/06/2015,"Download from usbank.com. MODCLOTH INC.   888-4959699 CA","Everyday Expenses:Clothing","Everyday Expenses","Clothing",,$61.04,$0.00,C,$1551.62
"Us Bank",,,03/06/2015,"Download from usbank.com. Amazon.com      AMZN.COM/BILWA","Everyday Expenses:Misc","Everyday Expenses","Misc",,$68.10,$0.00,C,$1483.52
"Us Bank",,,03/06/2015,"Download from usbank.com. SUTTER PUB      SAN FRANCISCCA","Everyday Expenses:Spending Money","Everyday Expenses","Spending Money",,$71.25,$0.00,C,$1412.27
"Us Bank",,,03/09/2015,"Download from usbank.com. VENMO","Everyday Expenses:Clothing","Everyday Expenses","Clothing",,$0.00,$160.53,C,$1572.80
"Us Bank",,,03/09/2015,"Download from usbank.com. Expensify Inc.","Everyday Expenses:Spending Money","Everyday Expenses","Spending Money",,$0.00,$0.90,C,$1573.70
"Us Bank",,,03/09/2015,"Download from usbank.com. Expensify Inc.","Everyday Expenses:Spending Money","Everyday Expenses","Spending Money",,$0.00,$0.37,C,$1574.07
"Us Bank",,,03/09/2015,"Download from usbank.com. Expensify Inc.","Everyday Expenses:Spending Money","Everyday Expenses","Spending Money",,$1.27,$0.00,C,$1572.80
"Us Bank",,,03/09/2015,"Download from usbank.com. VENMO","Everyday Expenses:Spending Money","Everyday Expenses","Spending Money",,$5.00,$0.00,C,$1567.80
"Us Bank",,,03/09/2015,"Download from usbank.com. CHIPOTLE 1857   SAN FRANCISCCA","Everyday Expenses:Groceries","Everyday Expenses","Groceries",,$7.56,$0.00,C,$1560.24
"Us Bank",,,03/09/2015,"Download from usbank.com. EURO SNACK INC.TRUCKEE     CA","Everyday Expenses:Spending Money","Everyday Expenses","Spending Money",,$8.00,$0.00,C,$1552.24
"Us Bank",,,03/09/2015,"Download from usbank.com. SMARTE CARTE    ST PAUL     MN","Everyday Expenses:Spending Money","Everyday Expenses","Spending Money",,$8.00,$0.00,C,$1544.24
"Us Bank",,,03/09/2015,"Download from usbank.com. GUITAR CENTER #2SAN FRANCISCCA","Everyday Expenses:Spending Money","Everyday Expenses","Spending Money",,$9.23,$0.00,C,$1535.01
"Us Bank",,,03/09/2015,"Download from usbank.com. BAMBOO ASIA     SAN FRANCISCCA","Everyday Expenses:Spending Money","Everyday Expenses","Spending Money",,$9.73,$0.00,C,$1525.28
"Us Bank",,,03/09/2015,"Download from usbank.com. STARBUCKS CARD R800-782-7282WA","Everyday Expenses:Spending Money","Everyday Expenses","Spending Money",,$10.00,$0.00,C,$1515.28
"Us Bank",,,03/09/2015,"Download from usbank.com. CVS 10189       SAN FRANCISCCA","Everyday Expenses:Spending Money","Everyday Expenses","Spending Money",,$11.76,$0.00,C,$1503.52
"Us Bank",,,03/09/2015,"Download from usbank.com. PAYPAL","Everyday Expenses:Spending Money","Everyday Expenses","Spending Money",,$12.43,$0.00,C,$1491.09
"Us Bank",,,03/09/2015,"Download from usbank.com. SUTTER FINE FOODSAN FRANCISCCA","Everyday Expenses:Groceries","Everyday Expenses","Groceries",,$13.69,$0.00,C,$1477.40
"Us Bank",,,03/09/2015,"Download from usbank.com. SUTTER FINE FOODSAN FRANCISCCA","Everyday Expenses:Groceries","Everyday Expenses","Groceries",,$13.97,$0.00,C,$1463.43
"Us Bank",,,03/09/2015,"Download from usbank.com. MOUNTAINWEST    SAN FRANCISCCA","Everyday Expenses:Misc","Everyday Expenses","Misc",,$22.83,$0.00,C,$1440.60
"Us Bank",,,03/09/2015,"Download from usbank.com. BEVERAGES & MORESAN FRANCISCCA","Everyday Expenses:Spending Money","Everyday Expenses","Spending Money",,$26.28,$0.00,C,$1414.32
"Us Bank",,,03/09/2015,"Download from usbank.com. VILLAGE BARS    TRUCKEE     CA","Everyday Expenses:Spending Money","Everyday Expenses","Spending Money",,$36.00,$0.00,C,$1378.32
"Us Bank",,,03/09/2015,"Download from usbank.com. TRADER JOE'S #20SAN FRANCISCCA","Everyday Expenses:Groceries","Everyday Expenses","Groceries",,$90.22,$0.00,C,$1288.10
"Us Bank",,,03/09/2015,"Download from usbank.com. MODCLOTH INC.   888-4959699 CA","Everyday Expenses:Clothing","Everyday Expenses","Clothing",,$93.10,$0.00,C,$1195.00
"Us Bank",,,03/10/2015,"Download from usbank.com. CHIPOTLE 1857   SAN FRANCISCCA","Everyday Expenses:Groceries","Everyday Expenses","Groceries",,$7.56,$0.00,C,$1187.44
"Us Bank",,,03/10/2015,"Download from usbank.com. Acorns Investmen","Savings Goals:Savings","Savings Goals","Savings",,$12.80,$0.00,C,$1174.64
"Us Bank",,,03/10/2015,"Download from usbank.com. BLUE FOG MARKETSSAN FRANCISCCA","Everyday Expenses:Groceries","Everyday Expenses","Groceries",,$31.63,$0.00,C,$1143.01
"Us Bank",,,03/10/2015,"Download from usbank.com. TARGET T3201    SAN FRANCISCCA","Everyday Expenses:Household Goods","Everyday Expenses","Household Goods",,$34.77,$0.00,C,$1108.24
"Us Bank",,,03/10/2015,"Download from usbank.com. MODCLOTH INC.   888-4959699 CA","Everyday Expenses:Clothing","Everyday Expenses","Clothing",,$92.49,$0.00,C,$1015.75
"Us Bank",,,03/11/2015,"Download from usbank.com. APL* ITUNES.COM/866-712-7753CA","Everyday Expenses:Spending Money","Everyday Expenses","Spending Money",,$4.99,$0.00,C,$1010.76
"Us Bank",,,03/11/2015,"Download from usbank.com. CHIPOTLE 1857   SAN FRANCISCCA","Everyday Expenses:Groceries","Everyday Expenses","Groceries",,$7.56,$0.00,C,$1003.20
"Us Bank",,,03/11/2015,"Download from usbank.com. MIXT GREENS     SAN FRANCISCCA","Everyday Expenses:Spending Money","Everyday Expenses","Spending Money",,$12.29,$0.00,C,$990.91
"Us Bank",,,03/11/2015,"Download from usbank.com. The Plant Cafe DSan FranciscCA","Everyday Expenses:Spending Money","Everyday Expenses","Spending Money",,$13.59,$0.00,C,$977.32
"Us Bank",,,03/11/2015,"Download from usbank.com. SUTTER FINE FOODSAN FRANCISCCA","Everyday Expenses:Groceries","Everyday Expenses","Groceries",,$15.24,$0.00,C,$962.08
"Us Bank",,,03/12/2015,"Download from usbank.com. SUGAR CAFE      SAN FRANCISCCA","Everyday Expenses:Spending Money","Everyday Expenses","Spending Money",,$5.00,$0.00,C,$957.08
"Us Bank",,,03/12/2015,"Download from usbank.com. CHIPOTLE 1857   SAN FRANCISCCA","Everyday Expenses:Groceries","Everyday Expenses","Groceries",,$7.56,$0.00,C,$949.52
"Us Bank",,,03/12/2015,"Download from usbank.com. Acorns Investmen","Savings Goals:Savings","Savings Goals","Savings",,$9.31,$0.00,C,$940.21
"Us Bank",,,03/12/2015,"Download from usbank.com. SUGAR CAFE      SAN FRANCISCCA","Everyday Expenses:Spending Money","Everyday Expenses","Spending Money",,$13.00,$0.00,C,$927.21
"Us Bank",,,03/12/2015,"Download from usbank.com. WALGREENS 1300 BSAN FRANCISCCA","Everyday Expenses:Household Goods","Everyday Expenses","Household Goods",,$95.97,$0.00,C,$831.24
"Us Bank",,,03/13/2015,"Download from usbank.com. SQWIGGLE INC","Income:Available this month","Income","Available this month",,$0.00,$1971.49,C,$2802.73
"Us Bank",,,03/13/2015,"Download from usbank.com. APL* ITUNES.COM/866-712-7753CA","Everyday Expenses:Spending Money","Everyday Expenses","Spending Money",,$4.99,$0.00,C,$2797.74
"Us Bank",,,03/13/2015,"Download from usbank.com. SQ *HRD         San FranciscCA","Everyday Expenses:Spending Money","Everyday Expenses","Spending Money",,$10.06,$0.00,C,$2787.68
"Us Bank",,,03/13/2015,"Download from usbank.com. AYOLA (KEARNY)  SAN FRANCISCCA","Everyday Expenses:Spending Money","Everyday Expenses","Spending Money",,$10.82,$0.00,C,$2776.86
"Us Bank",,,03/13/2015,"Download from usbank.com. Audible         888-283-5051NJ","Monthly Bills:Web Stuff","Monthly Bills","Web Stuff",,$14.95,$0.00,C,$2761.91
"Us Bank",,,03/13/2015,"Download from usbank.com.","Everyday Expenses:Spending Money","Everyday Expenses","Spending Money",,$75.00,$0.00,C,$2686.91
"Us Bank",,,03/16/2015,"Download from usbank.com. Sqwiggle Inc.","Everyday Expenses:Spending Money","Everyday Expenses","Spending Money",,$0.00,$14.99,C,$2701.90
"Us Bank",,,03/16/2015,"Download from usbank.com. 031515PLUSTERM449 POWELL STREESAN FRANCISCCAUS1","Everyday Expenses:Spending Money","Everyday Expenses","Spending Money",,$2.50,$0.00,C,$2699.40
"Us Bank",,,03/16/2015,"Download from usbank.com. T1 MAX S WORLD30SAN FRANCISCCA","Everyday Expenses:Spending Money","Everyday Expenses","Spending Money",,$4.45,$0.00,C,$2694.95
"Us Bank",,,03/16/2015,"Download from usbank.com. LYFT FRI AT 0836855-280-0278CA","Everyday Expenses:Transportation","Everyday Expenses","Transportation",,$5.00,$0.00,C,$2689.95
"Us Bank",,,03/16/2015,"Download from usbank.com. LYFT FRI AT 1055855-280-0278CA","Everyday Expenses:Transportation","Everyday Expenses","Transportation",,$5.00,$0.00,C,$2684.95
"Us Bank",,,03/16/2015,"Download from usbank.com. PAYPAL","Everyday Expenses:Spending Money","Everyday Expenses","Spending Money",,$7.00,$0.00,C,$2677.95
"Us Bank",,,03/16/2015,"Download from usbank.com. 3- COFFEE BEAN  AUSTIN      TX","Everyday Expenses:Spending Money","Everyday Expenses","Spending Money",,$7.30,$0.00,C,$2670.65
"Us Bank",,,03/16/2015,"Download from usbank.com. TAQUERIAS EL FARSAN FRANCISCCA","Everyday Expenses:Spending Money","Everyday Expenses","Spending Money",,$7.34,$0.00,C,$2663.31
"Us Bank",,,03/16/2015,"Download from usbank.com. CHIPOTLE 1857   SAN FRANCISCCA","Everyday Expenses:Groceries","Everyday Expenses","Groceries",,$7.56,$0.00,C,$2655.75
"Us Bank",,,03/16/2015,"Download from usbank.com. DADA SF STUDIO  SAN FRANCISCCA","Everyday Expenses:Spending Money","Everyday Expenses","Spending Money",,$13.00,$0.00,C,$2642.75
"Us Bank",,,03/16/2015,"Download from usbank.com. DIMASSIS MEDITERAUSTIN      TX","Everyday Expenses:Spending Money","Everyday Expenses","Spending Money",,$14.99,$0.00,C,$2627.76
"Us Bank",,,03/16/2015,"Download from usbank.com. BLUE FOG MARKETSSAN FRANCISCCA","Everyday Expenses:Groceries","Everyday Expenses","Groceries",,$16.45,$0.00,C,$2611.31
"Us Bank",,,03/16/2015,"Download from usbank.com. PAYPAL","Everyday Expenses:Spending Money","Everyday Expenses","Spending Money",,$20.00,$0.00,C,$2591.31
"Us Bank",,,03/16/2015,"Download from usbank.com. PAYPAL","Everyday Expenses:Spending Money","Everyday Expenses","Spending Money",,$20.00,$0.00,C,$2571.31
"Us Bank",,,03/16/2015,"Download from usbank.com. BITE            SAN FRANCISCCA","Everyday Expenses:Spending Money","Everyday Expenses","Spending Money",,$20.64,$0.00,C,$2550.67
"Us Bank",,,03/16/2015,"Download from usbank.com. 449 POWELL STREESAN FRANCISCCAUS1","Everyday Expenses:Spending Money","Everyday Expenses","Spending Money",,$23.00,$0.00,C,$2527.67
"Us Bank",,,03/16/2015,"Download from usbank.com. GUITAR CENTER #2SAN FRANCISCCA","Everyday Expenses:Spending Money","Everyday Expenses","Spending Money",,$23.90,$0.00,C,$2503.77
"Us Bank",,,03/16/2015,"Download from usbank.com. PAYPAL","Everyday Expenses:Transportation","Everyday Expenses","Transportation",,$25.00,$0.00,C,$2478.77
"Us Bank",,,03/16/2015,"Download from usbank.com. WHOLEFDS DOM # 1Austin      TX","Everyday Expenses:Groceries","Everyday Expenses","Groceries",,$99.41,$0.00,C,$2379.36
"Us Bank",,,03/17/2015,"Download from usbank.com. THE GOLDEN GATE SAN FRANCISCCA","Everyday Expenses:Spending Money","Everyday Expenses","Spending Money",,$7.00,$0.00,C,$2372.36
"Us Bank",,,03/17/2015,"Download from usbank.com. FLY             SAN FRANCISCCA","Everyday Expenses:Spending Money","Everyday Expenses","Spending Money",,$20.97,$0.00,C,$2351.39
"Us Bank",,,03/17/2015,"Download from usbank.com. CASA SOL MEXICANSEGUIN      TX","Everyday Expenses:Spending Money","Everyday Expenses","Spending Money",,$28.78,$0.00,C,$2322.61
"Us Bank",,,03/17/2015,"Download from usbank.com. VICTORIA'S SECREAUSTIN      TX","Everyday Expenses:Spending Money","Everyday Expenses","Spending Money",,$46.01,$0.00,C,$2276.60
"Us Bank",,,03/18/2015,"Download from usbank.com. PAYPAL","Monthly Bills:Web Stuff","Monthly Bills","Web Stuff",,$9.99,$0.00,C,$2266.61
"Us Bank",,,03/18/2015,"Download from usbank.com. JASON'S DELI # 1AUSTIN      TX","Everyday Expenses:Spending Money","Everyday Expenses","Spending Money",,$11.98,$0.00,C,$2254.63
"Us Bank",,,03/18/2015,"Download from usbank.com. TARGET T2288    AUSTIN      TX","Everyday Expenses:Spending Money","Everyday Expenses","Spending Money",,$14.06,$0.00,C,$2240.57
"Us Bank",,,03/18/2015,"Download from usbank.com. Acorns Investmen","Savings Goals:Savings","Savings Goals","Savings",,$14.11,$0.00,C,$2226.46
"Us Bank",,,03/18/2015,"Download from usbank.com. GRISTMILL RIVER 830-6250684 TX","Everyday Expenses:Spending Money","Everyday Expenses","Spending Money",,$22.89,$0.00,C,$2203.57
"Us Bank",,,03/18/2015,"Download from usbank.com. CORNER STORE 103SAN ANTONIO TX","Everyday Expenses:Spending Money","Everyday Expenses","Spending Money",,$29.00,$0.00,C,$2174.57
"Us Bank",,,03/18/2015,"Download from usbank.com. TARGET T2438    SAN MARCOS  TX","Everyday Expenses:Clothing","Everyday Expenses","Clothing",,$52.36,$0.00,C,$2122.21
"Us Bank",,,03/19/2015,"manual reconciliation","Income:Available this month","Income","Available this month",,$0.00,$1527.11,C,$3649.32
"Us Bank",,,03/19/2015,"Download from usbank.com. ASPEN'S BREW    SAN ANTONIO TX","Everyday Expenses:Spending Money","Everyday Expenses","Spending Money",,$3.19,$0.00,C,$3646.13
"Us Bank",,,03/19/2015,"Download from usbank.com. APL* ITUNES.COM/866-712-7753CA","Everyday Expenses:Spending Money","Everyday Expenses","Spending Money",,$7.96,$0.00,C,$3638.17
"Us Bank",,,03/19/2015,"Download from usbank.com. 3529 FOREVER 21 SAN ANTONIO TX","Everyday Expenses:Spending Money","Everyday Expenses","Spending Money",,$16.23,$0.00,C,$3621.94
"Us Bank",,,03/19/2015,"Download from usbank.com. SPEC'S LIQUOR #1SAN MARCUS  TX","Everyday Expenses:Spending Money","Everyday Expenses","Spending Money",,$25.20,$0.00,C,$3596.74
"Us Bank",,,03/19/2015,"Download from usbank.com. PACSUN #0003    877-372-2786CA","Everyday Expenses:Clothing","Everyday Expenses","Clothing",,$29.44,$0.00,C,$3567.30
"Us Bank",,,03/19/2015,"Download from usbank.com. ELIZABETH STREETAUSTIN      TX","Everyday Expenses:Spending Money","Everyday Expenses","Spending Money",,$31.06,$0.00,C,$3536.24
"Us Bank",,,03/19/2015,"Download from usbank.com. DSW SAN ANTONIO SAN ANTONIO TX","Everyday Expenses:Spending Money","Everyday Expenses","Spending Money",,$43.25,$0.00,C,$3492.99
"Us Bank",,,03/19/2015,"Download from usbank.com. OLD NAVY USA    SAN MARCOS  TX","Everyday Expenses:Clothing","Everyday Expenses","Clothing",,$47.97,$0.00,C,$3445.02
"Us Bank",,,03/19/2015,"Download from usbank.com. ATT","Monthly Bills:Cell Phone","Monthly Bills","Cell Phone",,$142.13,$0.00,C,$3302.89
"Us Bank",,,03/20/2015,"Download from usbank.com. APL* ITUNES.COM/866-712-7753CA","Everyday Expenses:Spending Money","Everyday Expenses","Spending Money",,$2.99,$0.00,C,$3299.90
"Us Bank",,,03/20/2015,"Download from usbank.com. FREEBIRDS WORLD SAN ANTONIO TX","Everyday Expenses:Spending Money","Everyday Expenses","Spending Money",,$7.96,$0.00,C,$3291.94
"Us Bank",,,03/20/2015,"Download from usbank.com. PAYPAL","Monthly Bills:Web Stuff","Monthly Bills","Web Stuff",,$9.99,$0.00,C,$3281.95
"Us Bank",,,03/20/2015,"Download from usbank.com. INDIA PALACE    SAN ANTONIO TX","Everyday Expenses:Spending Money","Everyday Expenses","Spending Money",,$10.77,$0.00,C,$3271.18
"Us Bank",,,03/20/2015,"Download from usbank.com. TRADER JOE'S #20SAN FRANCISCCA","Everyday Expenses:Groceries","Everyday Expenses","Groceries",,$13.59,$0.00,C,$3257.59
"Us Bank",,,03/20/2015,"Download from usbank.com. ASIANA NAILS LOUSAN ANTONIO TX","Everyday Expenses:Spending Money","Everyday Expenses","Spending Money",,$40.00,$0.00,C,$3217.59
"Us Bank",,,03/20/2015,"Download from usbank.com. HEB #173        SEGUIN      TX","Everyday Expenses:Spending Money","Everyday Expenses","Spending Money",,$49.80,$0.00,C,$3167.79
"Us Bank",,,03/20/2015,"Download from usbank.com. THE SPA AT CIBOLSAN ANTONIO TX","Everyday Expenses:Spending Money","Everyday Expenses","Spending Money",,$60.00,$0.00,C,$3107.79
"Us Bank",,,03/23/2015,"Download from usbank.com.","Everyday Expenses:Spending Money","Everyday Expenses","Spending Money",,$0.00,$6.95,C,$3114.74
"Us Bank",,,03/23/2015,"Download from usbank.com. CANDLELIGHT COFFSAN ANTONIO TX","Everyday Expenses:Spending Money","Everyday Expenses","Spending Money",,$2.25,$0.00,C,$3112.49
"Us Bank",,,03/23/2015,"Download from usbank.com.","Everyday Expenses:Spending Money","Everyday Expenses","Spending Money",,$6.95,$0.00,C,$3105.54
"Us Bank",,,03/23/2015,"Download from usbank.com. RAISING CANES CHSAN ANTONIO TX","Everyday Expenses:Spending Money","Everyday Expenses","Spending Money",,$8.76,$0.00,C,$3096.78
"Us Bank",,,03/23/2015,"Download from usbank.com. PAYPAL","Monthly Bills:Web Stuff","Monthly Bills","Web Stuff",,$9.99,$0.00,C,$3086.79
"Us Bank",,,03/23/2015,"Download from usbank.com. STARBUCKS CARD R800-782-7282WA","Everyday Expenses:Spending Money","Everyday Expenses","Spending Money",,$10.00,$0.00,C,$3076.79
"Us Bank",,,03/23/2015,"Download from usbank.com. STARBUCKS CARD R800-782-7282WA","Everyday Expenses:Spending Money","Everyday Expenses","Spending Money",,$10.00,$0.00,C,$3066.79
"Us Bank",,,03/23/2015,"Download from usbank.com. RED JACK SALOON SAN FRANCISCCA","Everyday Expenses:Spending Money","Everyday Expenses","Spending Money",,$11.00,$0.00,C,$3055.79
"Us Bank",,,03/23/2015,"Download from usbank.com. CANDLELIGHT COFFSAN ANTONIO TX","Everyday Expenses:Spending Money","Everyday Expenses","Spending Money",,$12.72,$0.00,C,$3043.07
"Us Bank",,,03/23/2015,"Download from usbank.com. VENMO","Everyday Expenses:Spending Money","Everyday Expenses","Spending Money",,$16.00,$0.00,C,$3027.07
"Us Bank",,,03/23/2015,"Download from usbank.com. SUTTER FINE FOODSAN FRANCISCCA","Everyday Expenses:Groceries","Everyday Expenses","Groceries",,$19.96,$0.00,C,$3007.11
"Us Bank",,,03/23/2015,"Download from usbank.com. BUBBA'S COUNTRY AUSTIN      TX","Everyday Expenses:Spending Money","Everyday Expenses","Spending Money",,$27.81,$0.00,C,$2979.30
"Us Bank",,,03/23/2015,"Download from usbank.com. FLY             SAN FRANCISCCA","Everyday Expenses:Spending Money","Everyday Expenses","Spending Money",,$28.07,$0.00,C,$2951.23
"Us Bank",,,03/23/2015,"Download from usbank.com. Amazon.com      AMZN.COM/BILWA","Everyday Expenses:Spending Money","Everyday Expenses","Spending Money",,$41.99,$0.00,C,$2909.24
"Us Bank",,,03/23/2015,"Download from usbank.com. THE LIMITED STORSAN ANTONIO TX","Everyday Expenses:Spending Money","Everyday Expenses","Spending Money",,$60.23,$0.00,C,$2849.01
"Us Bank",,,03/24/2015,"Download from usbank.com. Acorns Investmen","Savings Goals:Savings","Savings Goals","Savings",,$8.29,$0.00,C,$2840.72
"Us Bank",,,03/24/2015,"Download from usbank.com. Spotify USA     877-778-1161NY","Monthly Bills:Web Stuff","Monthly Bills","Web Stuff",,$9.99,$0.00,C,$2830.73
"Us Bank",,,03/24/2015,"Download from usbank.com. PAYPAL","Everyday Expenses:Spending Money","Everyday Expenses","Spending Money",,$10.00,$0.00,C,$2820.73
"Us Bank",,,03/24/2015,"Download from usbank.com. STARBUCKS CARD R800-782-7282WA","Everyday Expenses:Spending Money","Everyday Expenses","Spending Money",,$10.00,$0.00,C,$2810.73
"Us Bank",,,03/24/2015,"Download from usbank.com. UBER            866-576-1039CA","Everyday Expenses:Transportation","Everyday Expenses","Transportation",,$15.00,$0.00,C,$2795.73
"Us Bank",,,03/24/2015,"Download from usbank.com. BURGERMEISTER NOSAN FRANCISCCA","Everyday Expenses:Spending Money","Everyday Expenses","Spending Money",,$24.98,$0.00,C,$2770.75
"Us Bank",,,03/24/2015,"Download from usbank.com. TARGET T3201    SAN FRANCISCCA","Everyday Expenses:Spending Money","Everyday Expenses","Spending Money",,$36.79,$0.00,C,$2733.96
"Us Bank",,,03/24/2015,"Download from usbank.com. NARA SUSHI      SAN FRANCISCCA","Everyday Expenses:Spending Money","Everyday Expenses","Spending Money",,$44.04,$0.00,C,$2689.92
"Us Bank",,,03/24/2015,"Download from usbank.com. GOOD VIBRATIONS SAN FRANCISCCA","Everyday Expenses:Spending Money","Everyday Expenses","Spending Money",,$62.09,$0.00,C,$2627.83
"Us Bank",,,03/25/2015,"Download from usbank.com. HLU*Hulu 2274453HULU.COM/BILCA","Monthly Bills:Web Stuff","Monthly Bills","Web Stuff",,$7.99,$0.00,C,$2619.84
"Us Bank",,,03/25/2015,"Download from usbank.com. FRESHROLL       SAN FRANCISCCA","Everyday Expenses:Spending Money","Everyday Expenses","Spending Money",,$9.51,$0.00,C,$2610.33
"Us Bank",,,03/25/2015,"Download from usbank.com. TRADER JOE'S #20SAN FRANCISCCA","Everyday Expenses:Groceries","Everyday Expenses","Groceries",,$36.88,$0.00,C,$2573.45
"Us Bank",,,03/26/2015,"Download from usbank.com. VICTORIA'S SECRESAN FRANCISCCA","Everyday Expenses:Clothing","Everyday Expenses","Clothing",,$0.00,$46.01,C,$2619.46
"Us Bank",,,03/26/2015,"Download from usbank.com. Acorns Investmen","Savings Goals:Savings","Savings Goals","Savings",,$9.17,$0.00,C,$2610.29
"Us Bank",,,03/26/2015,"Download from usbank.com. AMAZON MKTPLACE AMZN.COM/BILWA","Everyday Expenses:Spending Money","Everyday Expenses","Spending Money",,$18.98,$0.00,C,$2591.31
"Us Bank",,,03/26/2015,"Download from usbank.com. AMAZON MKTPLACE AMZN.COM/BILWA","Everyday Expenses:Spending Money","Everyday Expenses","Spending Money",,$25.62,$0.00,C,$2565.69
"Us Bank",,,03/27/2015,"Download from usbank.com. MODCLOTH INC","Income:Available this month","Income","Available this month",,$0.00,$1527.10,C,$4092.79
"Us Bank",,,03/27/2015,"Download from usbank.com. CHIPOTLE 1702   SAN FRANCISCCA","Everyday Expenses:Groceries","Everyday Expenses","Groceries",,$7.56,$0.00,C,$4085.23
"Us Bank",,,03/27/2015,"Download from usbank.com. WALGREENS 1300 BSAN FRANCISCCA","Everyday Expenses:Household Goods","Everyday Expenses","Household Goods",,$21.17,$0.00,C,$4064.06
"Us Bank",,,03/27/2015,"Download from usbank.com. PUBLIC BARBER SASAN FRANCISCCA","Everyday Expenses:Spending Money","Everyday Expenses","Spending Money",,$39.00,$0.00,C,$4025.06
"Us Bank",,,03/27/2015,"Download from usbank.com. AMAZON MKTPLACE AMZN.COM/BILWA","Everyday Expenses:Spending Money","Everyday Expenses","Spending Money",,$39.20,$0.00,C,$3985.86
"Us Bank",,,03/27/2015,"Download from usbank.com. 6010 FOREVER 21 SAN FRANCISCCA","Everyday Expenses:Clothing","Everyday Expenses","Clothing",,$45.46,$0.00,C,$3940.40
"Us Bank",,,03/27/2015,"Download from usbank.com. AMZ*Beautifi4157SAN FRANCISCCA","Everyday Expenses:Spending Money","Everyday Expenses","Spending Money",,$64.90,$0.00,C,$3875.50
"Us Bank",,,03/27/2015,"Download from usbank.com. VENUE DRIVER EVE866-760-0007NV","Everyday Expenses:Vegas","Everyday Expenses","Vegas",,$135.96,$0.00,C,$3739.54
"Us Bank",,,03/27/2015,"Download from usbank.com. MARQUEE LAS VEGA212-399-6000NV","Everyday Expenses:Vegas","Everyday Expenses","Vegas",,$264.00,$0.00,C,$3475.54
"Us Bank",,,03/30/2015,"Download from usbank.com. AMAZON DIG594477","Everyday Expenses:Spending Money","Everyday Expenses","Spending Money",,$0.00,$0.60,C,$3476.14
"Us Bank",,,03/30/2015,"Download from usbank.com. 032815PLUSTERM395 Geary StreetSan FranciscCAUS1","Everyday Expenses:Spending Money","Everyday Expenses","Spending Money",,$2.50,$0.00,C,$3473.64
"Us Bank",,,03/30/2015,"Download from usbank.com. 032815PLUSTERM395 Geary StreetSan FranciscCAUS1","Everyday Expenses:Spending Money","Everyday Expenses","Spending Money",,$2.50,$0.00,C,$3471.14
"Us Bank",,,03/30/2015,"Download from usbank.com. APL* ITUNES.COM/866-712-7753CA","Everyday Expenses:Spending Money","Everyday Expenses","Spending Money",,$3.99,$0.00,C,$3467.15
"Us Bank",,,03/30/2015,"Download from usbank.com. Acorns Investmen","Savings Goals:Savings","Savings Goals","Savings",,$6.13,$0.00,C,$3461.02
"Us Bank",,,03/30/2015,"Download from usbank.com. SUTTER FINE FOODSAN FRANCISCCA","Everyday Expenses:Groceries","Everyday Expenses","Groceries",,$9.99,$0.00,C,$3451.03
"Us Bank",,,03/30/2015,"Download from usbank.com. MAILCHIMP       MAILCHIMP.COGA","Monthly Bills:Web Stuff","Monthly Bills","Web Stuff",,$10.00,$0.00,C,$3441.03
"Us Bank",,,03/30/2015,"Download from usbank.com. STARBUCKS CARD R800-782-7282WA","Everyday Expenses:Spending Money","Everyday Expenses","Spending Money",,$10.00,$0.00,C,$3431.03
"Us Bank",,,03/30/2015,"Download from usbank.com. BLUE FOG MARKETSSAN FRANCISCCA","Everyday Expenses:Groceries","Everyday Expenses","Groceries",,$12.13,$0.00,C,$3418.90
"Us Bank",,,03/30/2015,"Download from usbank.com. WALGREENS 500 GESAN FRANCISCCA","Everyday Expenses:Household Goods","Everyday Expenses","Household Goods",,$13.01,$0.00,C,$3405.89
"Us Bank",,,03/30/2015,"Download from usbank.com. SUTTER FINE FOODSAN FRANCISCCA","Everyday Expenses:Groceries","Everyday Expenses","Groceries",,$13.16,$0.00,C,$3392.73
"Us Bank",,,03/30/2015,"Download from usbank.com. SUTTER FINE FOODSAN FRANCISCCA","Everyday Expenses:Groceries","Everyday Expenses","Groceries",,$15.22,$0.00,C,$3377.51
"Us Bank",,,03/30/2015,"Download from usbank.com. BART-CLIPPER POWSAN FRANCISCCA","Everyday Expenses:Transportation","Everyday Expenses","Transportation",,$19.95,$0.00,C,$3357.56
"Us Bank",,,03/30/2015,"Download from usbank.com. INTERNATIONAL HOSAN FRANCISCCA","Everyday Expenses:Spending Money","Everyday Expenses","Spending Money",,$22.78,$0.00,C,$3334.78
"Us Bank",,,03/30/2015,"Download from usbank.com. BURGER JOINT    SAN FRANCISCCA","Everyday Expenses:Spending Money","Everyday Expenses","Spending Money",,$36.58,$0.00,C,$3298.20
"Us Bank",,,03/30/2015,"Download from usbank.com. 395 Geary StreetSan FranciscCAUS1","Everyday Expenses:Spending Money","Everyday Expenses","Spending Money",,$202.95,$0.00,C,$3095.25
"Us Bank",,,03/30/2015,"Download from usbank.com. 395 Geary StreetSan FranciscCAUS1","Everyday Expenses:Spending Money","Everyday Expenses","Spending Money",,$202.95,$0.00,C,$2892.30
"Us Bank",,,03/31/2015,"Download from usbank.com. SQWIGGLE INC","Income:Available this month","Income","Available this month",,$0.00,$1971.49,C,$4863.79
"Us Bank",,,03/31/2015,"Download from usbank.com. 033015SCS4TU80THE D LAS VEGAS LAS VEGAS   NVUS1","Everyday Expenses:Vegas","Everyday Expenses","Vegas",,$2.50,$0.00,C,$4861.29
"Us Bank",,,03/31/2015,"Download from usbank.com. MARQUEE LAS VEGALAS VEGAS   NV","Everyday Expenses:Vegas","Everyday Expenses","Vegas",,$23.00,$0.00,C,$4838.29
"Us Bank",,,03/31/2015,"Download from usbank.com. MARQUEE LAS VEGALAS VEGAS   NV","Everyday Expenses:Vegas","Everyday Expenses","Vegas",,$23.00,$0.00,C,$4815.29
"Us Bank",,,03/31/2015,"Download from usbank.com. PBR ROCK BAR    LAS VEGAS   NV","Everyday Expenses:Vegas","Everyday Expenses","Vegas",,$25.89,$0.00,C,$4789.40
"Us Bank",,,03/31/2015,"Download from usbank.com. THE D LAS VEGAS LAS VEGAS   NVUS1","Everyday Expenses:Vegas","Everyday Expenses","Vegas",,$203.50,$0.00,C,$4585.90
"Us Bank",,,04/01/2015,"Download from usbank.com. SOUVENIR SUPERMALAS VEGAS   NV","Everyday Expenses:Vegas","Everyday Expenses","Vegas",,$5.39,$0.00,C,$4580.51
"Us Bank",,,04/01/2015,"Download from usbank.com. LINQ CATALYST   LAS VEGAS   NV","Everyday Expenses:Vegas","Everyday Expenses","Vegas",,$12.00,$0.00,C,$4568.51
"Us Bank",,,04/01/2015,"Download from usbank.com. PAYPAL","Everyday Expenses:Transportation","Everyday Expenses","Transportation",,$15.00,$0.00,C,$4553.51
"Us Bank",,,04/01/2015,"Download from usbank.com. THE D GIFT SHOP LAS VEGAS   NV","Everyday Expenses:Vegas","Everyday Expenses","Vegas",,$15.56,$0.00,C,$4537.95
"Us Bank",,,04/01/2015,"Download from usbank.com. PICCADILLY FREMOLAS VEGAS   NV","Everyday Expenses:Vegas","Everyday Expenses","Vegas",,$22.11,$0.00,C,$4515.84
"Us Bank",,,04/01/2015,"Download from usbank.com. WESTIN CASUARINALAS VEGAS   NV","Everyday Expenses:Vegas","Everyday Expenses","Vegas",,$33.66,$0.00,C,$4482.18
"Us Bank",,,04/01/2015,"Download from usbank.com. HASH HOUSE A GO LAS VEGAS   NV","Everyday Expenses:Vegas","Everyday Expenses","Vegas",,$39.33,$0.00,C,$4442.85
"Us Bank",,,04/01/2015,"Download from usbank.com. WALGREENS 1300 BSAN FRANCISCCA","Everyday Expenses:Household Goods","Everyday Expenses","Household Goods",,$45.64,$0.00,C,$4397.21
"Us Bank",,,04/01/2015,"Download from usbank.com. TRADER JOE'S #20SAN FRANCISCCA","Everyday Expenses:Groceries","Everyday Expenses","Groceries",,$51.22,$0.00,C,$4345.99
"Us Bank",,,04/01/2015,"Download from usbank.com. MET CAS INS CO","Monthly Bills:Car Insurance","Monthly Bills","Car Insurance",,$52.16,$0.00,C,$4293.83
"Us Bank",,,04/02/2015,"Download from usbank.com. CHIPOTLE 1857   SAN FRANCISCCA","Everyday Expenses:Groceries","Everyday Expenses","Groceries",,$7.56,$0.00,C,$4286.27
"Us Bank",,,04/02/2015,"Download from usbank.com. Acorns Investmen","Savings Goals:Savings","Savings Goals","Savings",,$11.49,$0.00,C,$4274.78
"Us Bank",,,04/02/2015,"Download from usbank.com. 6010 FOREVER 21 SAN FRANCISCCA","Everyday Expenses:Clothing","Everyday Expenses","Clothing",,$12.94,$0.00,C,$4261.84
"Us Bank",,,04/02/2015,"Download from usbank.com. GOOGLE*ADWS","Monthly Bills:Web Stuff","Monthly Bills","Web Stuff",,$15.51,$0.00,C,$4246.33
"Us Bank",,,04/02/2015,"Download from usbank.com. PEI WEI T-3 FC30LAS VEGAS   NV","Everyday Expenses:Vegas","Everyday Expenses","Vegas",,$20.29,$0.00,C,$4226.04
"Us Bank",,,04/02/2015,"Download from usbank.com. Mosser Companies","Monthly Bills:Rent","Monthly Bills","Rent",,$1582.72,$0.00,C,$2643.32
"Us Bank",,,04/03/2015,"Download from usbank.com. CHIPOTLE 1857   SAN FRANCISCCA","Everyday Expenses:Groceries","Everyday Expenses","Groceries",,$7.56,$0.00,C,$2635.76
"Us Bank",,,04/03/2015,"Download from usbank.com. JOHNNY ROCKETS -LAS VEGAS   NV","Everyday Expenses:Vegas","Everyday Expenses","Vegas",,$22.54,$0.00,C,$2613.22
"Us Bank",,,04/03/2015,"Download from usbank.com. TARGET T3201    SAN FRANCISCCA","Everyday Expenses:Groceries","Everyday Expenses","Groceries",,$27.39,$0.00,C,$2585.83
"Us Bank",,,04/03/2015,"Download from usbank.com. K-KEL INC.      3340 S HIGHLNV","Everyday Expenses:Vegas","Everyday Expenses","Vegas",,$45.00,$0.00,C,$2540.83
"Us Bank",,,04/03/2015,"Download from usbank.com. CLASSPASS.COM CL888-493-5953NY","Everyday Expenses:Spending Money","Everyday Expenses","Spending Money",,$99.00,$0.00,C,$2441.83
"Us Bank",,,04/03/2015,"Download from usbank.com. COMCAST","Monthly Bills:Internet","Monthly Bills","Internet",,$155.66,$0.00,C,$2286.17
"Us Bank",,,04/06/2015,"Download from usbank.com. VENMO","Debt:Eric's Credit Card","Debt","Eric's Credit Card",,$0.00,$287.03,C,$2573.20
"Us Bank",,,04/06/2015,"Download from usbank.com. VENMO","Everyday Expenses:Spending Money","Everyday Expenses","Spending Money",,$0.00,$12.25,C,$2585.45
"Us Bank",,,04/06/2015,"Download from usbank.com.","Everyday Expenses:Spending Money","Everyday Expenses","Spending Money",,$0.20,$0.00,C,$2585.25
"Us Bank",,,04/06/2015,"Download from usbank.com. Amazon Video On 866-216-1072WA","Everyday Expenses:Spending Money","Everyday Expenses","Spending Money",,$2.99,$0.00,C,$2582.26
"Us Bank",,,04/06/2015,"Download from usbank.com. LYFT SUN AT 1038855-280-0278CA","Everyday Expenses:Transportation","Everyday Expenses","Transportation",,$6.00,$0.00,C,$2576.26
"Us Bank",,,04/06/2015,"Download from usbank.com. LYFT SUN AT 1234855-280-0278CA","Everyday Expenses:Transportation","Everyday Expenses","Transportation",,$6.30,$0.00,C,$2569.96
"Us Bank",,,04/06/2015,"Download from usbank.com. CHEVRON 00090030SAN FRANCISCCA","Everyday Expenses:Transportation","Everyday Expenses","Transportation",,$9.52,$0.00,C,$2560.44
"Us Bank",,,04/06/2015,"Download from usbank.com. GHOST PERSONAL  +44207224282","Monthly Bills:Web Stuff","Monthly Bills","Web Stuff",,$10.00,$0.00,C,$2550.44
"Us Bank",,,04/06/2015,"Download from usbank.com. STARBUCKS CARD R800-782-7282WA","Everyday Expenses:Spending Money","Everyday Expenses","Spending Money",,$10.00,$0.00,C,$2540.44
"Us Bank",,,04/06/2015,"Download from usbank.com. SQ *CONTRABAND CSan FranciscCA","Everyday Expenses:Spending Money","Everyday Expenses","Spending Money",,$11.25,$0.00,C,$2529.19
"Us Bank",,,04/06/2015,"Download from usbank.com. DOMINOS 7764    SAN FRANCISCCA","Everyday Expenses:Spending Money","Everyday Expenses","Spending Money",,$13.57,$0.00,C,$2515.62
"Us Bank",,,04/06/2015,"Download from usbank.com. AMC VAN NESS 14 SAN FRANCISCCA","Everyday Expenses:Spending Money","Everyday Expenses","Spending Money",,$14.58,$0.00,C,$2501.04
"Us Bank",,,04/06/2015,"Download from usbank.com. WALGREENS 1300 BSAN FRANCISCCA","Everyday Expenses:Household Goods","Everyday Expenses","Household Goods",,$17.20,$0.00,C,$2483.84
"Us Bank",,,04/06/2015,"Download from usbank.com. GETAROUND       8664382768  CA","Everyday Expenses:Transportation","Everyday Expenses","Transportation",,$23.00,$0.00,C,$2460.84
"Us Bank",,,04/06/2015,"Download from usbank.com. SPOONROCKET.COM 5109219929  CA","Everyday Expenses:Groceries","Everyday Expenses","Groceries",,$24.50,$0.00,C,$2436.34
"Us Bank",,,04/06/2015,"Download from usbank.com. STARBELLY       SAN FRANCISCCA","Everyday Expenses:Spending Money","Everyday Expenses","Spending Money",,$30.00,$0.00,C,$2406.34
"Us Bank",,,04/06/2015,"Download from usbank.com. NOB HILL CAT CLISAN FRANCISCCA","Everyday Expenses:Household Goods","Everyday Expenses","Household Goods",,$35.28,$0.00,C,$2371.06
"Us Bank",,,04/06/2015,"Download from usbank.com. BEVERAGES & MORESAN FRANCISCCA","Everyday Expenses:Spending Money","Everyday Expenses","Spending Money",,$41.21,$0.00,C,$2329.85
"Us Bank",,,04/06/2015,"Download from usbank.com. KYOTO SUSHI     SAN FRANCISCCA","Everyday Expenses:Spending Money","Everyday Expenses","Spending Money",,$50.00,$0.00,C,$2279.85
"Us Bank",,,04/06/2015,"Download from usbank.com. LOWE'S #3095    SAN FRANCISCCA","Everyday Expenses:Misc","Everyday Expenses","Misc",,$169.15,$0.00,C,$2110.70
"Us Bank",,,04/07/2015,"Download from usbank.com. WALGREENS 141 KESAN FRANCISCCA","Everyday Expenses:Household Goods","Everyday Expenses","Household Goods",,$3.25,$0.00,C,$2107.45
"Us Bank",,,04/07/2015,"Download from usbank.com. CHIPOTLE 1857   SAN FRANCISCCA","Everyday Expenses:Groceries","Everyday Expenses","Groceries",,$7.56,$0.00,C,$2099.89
"Us Bank",,,04/07/2015,"Download from usbank.com. LOS HERMANOS    SAN FRANCISCCA","Everyday Expenses:Spending Money","Everyday Expenses","Spending Money",,$7.94,$0.00,C,$2091.95
"Us Bank",,,04/07/2015,"Download from usbank.com. Acorns Investmen","Savings Goals:Savings","Savings Goals","Savings",,$11.02,$0.00,C,$2080.93
"Us Bank",,,04/07/2015,"Download from usbank.com. LOS HERMANOS    SAN FRANCISCCA","Everyday Expenses:Spending Money","Everyday Expenses","Spending Money",,$17.29,$0.00,C,$2063.64
"Us Bank",,,04/07/2015,"Download from usbank.com. TRADER JOE'S #20SAN FRANCISCCA","Everyday Expenses:Groceries","Everyday Expenses","Groceries",,$74.55,$0.00,C,$1989.09
"Us Bank",,,04/08/2015,"Download from usbank.com. SF SOUP CO MONTGSAN FRANCISCCA","Everyday Expenses:Spending Money","Everyday Expenses","Spending Money",,$5.06,$0.00,C,$1984.03
"Us Bank",,,04/08/2015,"Download from usbank.com. WALGREENS 1300 BSAN FRANCISCCA","Everyday Expenses:Household Goods","Everyday Expenses","Household Goods",,$6.51,$0.00,C,$1977.52
"Us Bank",,,04/08/2015,"Download from usbank.com. Mosser Companies","Monthly Bills:Rent","Monthly Bills","Rent",,$10.20,$0.00,C,$1967.32
"Us Bank",,,04/08/2015,"Download from usbank.com. TARGET T3201    SAN FRANCISCCA","Everyday Expenses:Groceries","Everyday Expenses","Groceries",,$36.53,$0.00,C,$1930.79
"Us Bank",,,04/08/2015,"Download from usbank.com. 7246","Debt:Eric's Credit Card","Debt","Eric's Credit Card",,$287.03,$0.00,C,$1643.76
"Us Bank",,,04/09/2015,"Download from usbank.com. PACSUN #0003    ANAHEIM     CA","Everyday Expenses:Spending Money","Everyday Expenses","Spending Money",,$0.00,$29.44,C,$1673.20
"Us Bank",,,04/09/2015,"Download from usbank.com. LA BOULANGE DU DSAN FRANCISCCA","Everyday Expenses:Spending Money","Everyday Expenses","Spending Money",,$12.24,$0.00,C,$1660.96
"Us Bank",,,04/09/2015,"Download from usbank.com. PAYPAL","Monthly Bills:Web Stuff","Monthly Bills","Web Stuff",,$12.42,$0.00,C,$1648.54
"Us Bank",,,04/09/2015,"Download from usbank.com. Acorns Investmen","Savings Goals:Savings","Savings Goals","Savings",,$13.36,$0.00,C,$1635.18
"Us Bank",,,04/09/2015,"Download from usbank.com. SMOKE THIS SMOKESAN FRANCISCCA","Everyday Expenses:Spending Money","Everyday Expenses","Spending Money",,$25.30,$0.00,C,$1609.88
"Us Bank",,,04/09/2015,"Download from usbank.com. TM *PURITY RING 415-421-8497CA","Everyday Expenses:Spending Money","Everyday Expenses","Spending Money",,$179.60,$0.00,C,$1430.28
"Us Bank",,,04/10/2015,"Download from usbank.com. MODCLOTH INC","Income:Available this month","Income","Available this month",,$0.00,$1507.85,C,$2938.13
"Us Bank",,,04/10/2015,"Download from usbank.com. UBER TECHNOLOGIE866-576-1039CA","Everyday Expenses:Transportation","Everyday Expenses","Transportation",,$7.00,$0.00,C,$2931.13
"Us Bank",,,04/10/2015,"Download from usbank.com. SQ *FLOURCHYLDE San FranciscCA","Everyday Expenses:Spending Money","Everyday Expenses","Spending Money",,$9.00,$0.00,C,$2922.13
"Us Bank",,,04/10/2015,"Download from usbank.com. WORKING GIRLS CASAN FRANCISCCA","Everyday Expenses:Spending Money","Everyday Expenses","Spending Money",,$9.95,$0.00,C,$2912.18
"Us Bank",,,04/10/2015,"Download from usbank.com. BAMBOO ASIA     SAN FRANCISCCA","Everyday Expenses:Spending Money","Everyday Expenses","Spending Money",,$10.10,$0.00,C,$2902.08
"Us Bank",,,04/10/2015,"Download from usbank.com. MODCLOTH INC.   888-4959699 CA","Everyday Expenses:Clothing","Everyday Expenses","Clothing",,$18.80,$0.00,C,$2883.28
"Us Bank",,,04/10/2015,"Download from usbank.com. JOHN COLLINS    SAN FRANCISCCA","Everyday Expenses:Spending Money","Everyday Expenses","Spending Money",,$19.00,$0.00,C,$2864.28
"Us Bank",,,04/13/2015,"Download from usbank.com. SQ *ANOTHER CAFESan FranciscCA","Everyday Expenses:Spending Money","Everyday Expenses","Spending Money",,$3.25,$0.00,C,$2861.03
"Us Bank",,,04/13/2015,"Download from usbank.com. TRADER JOE'S #20SAN FRANCISCCA","Everyday Expenses:Groceries","Everyday Expenses","Groceries",,$5.43,$0.00,C,$2855.60
"Us Bank",,,04/13/2015,"Download from usbank.com. BELLISSIMO PIZZASAN FRANCISCCA","Everyday Expenses:Spending Money","Everyday Expenses","Spending Money",,$6.00,$0.00,C,$2849.60
"Us Bank",,,04/13/2015,"Download from usbank.com. GETAROUND       8664382768  CA","Everyday Expenses:Transportation","Everyday Expenses","Transportation",,$6.00,$0.00,C,$2843.60
"Us Bank",,,04/13/2015,"Download from usbank.com. MUNCHERY INC.  888-458-5376CA","Everyday Expenses:Groceries","Everyday Expenses","Groceries",,$7.15,$0.00,C,$2836.45
"Us Bank",,,04/13/2015,"Download from usbank.com. APL* ITUNES.COM/866-712-7753CA","Everyday Expenses:Spending Money","Everyday Expenses","Spending Money",,$7.96,$0.00,C,$2828.49
"Us Bank",,,04/13/2015,"Download from usbank.com. STARBUCKS CARD R800-782-7282WA","Everyday Expenses:Spending Money","Everyday Expenses","Spending Money",,$10.00,$0.00,C,$2818.49
"Us Bank",,,04/13/2015,"Download from usbank.com. Audible         888-283-5051NJ","Monthly Bills:Web Stuff","Monthly Bills","Web Stuff",,$14.95,$0.00,C,$2803.54
"Us Bank",,,04/13/2015,"Download from usbank.com. GETAROUND       8664382768  CA","Everyday Expenses:Transportation","Everyday Expenses","Transportation",,$17.00,$0.00,C,$2786.54
"Us Bank",,,04/13/2015,"Download from usbank.com. LOS HERMANOS    SAN FRANCISCCA","Everyday Expenses:Spending Money","Everyday Expenses","Spending Money",,$22.78,$0.00,C,$2763.76
"Us Bank",,,04/13/2015,"Download from usbank.com. SUTTER FINE FOODSAN FRANCISCCA","Everyday Expenses:Groceries","Everyday Expenses","Groceries",,$24.70,$0.00,C,$2739.06
"Us Bank",,,04/13/2015,"Download from usbank.com. TRADER JOE'S #20SAN FRANCISCCA","Everyday Expenses:Groceries","Everyday Expenses","Groceries",,$28.30,$0.00,C,$2710.76
"Us Bank",,,04/13/2015,"Download from usbank.com.","Everyday Expenses:Spending Money","Everyday Expenses","Spending Money",,$62.50,$0.00,C,$2648.26
"Us Bank",,,04/13/2015,"Download from usbank.com. TRADER JOE'S #20SAN FRANCISCCA","Everyday Expenses:Groceries","Everyday Expenses","Groceries",,$77.66,$0.00,C,$2570.60
"Us Bank",,,04/13/2015,"Download from usbank.com. MODCLOTH INC.   888-4959699 CA","Everyday Expenses:Clothing","Everyday Expenses","Clothing",,$84.10,$0.00,C,$2486.50
"Us Bank",,,04/13/2015,"Download from usbank.com. LOWE'S #3095    SAN FRANCISCCA","Everyday Expenses:Misc","Everyday Expenses","Misc",,$124.95,$0.00,C,$2361.55
"Us Bank",,,04/14/2015,"Download from usbank.com. Acorns Investmen","Savings Goals:Savings","Savings Goals","Savings",,$6.59,$0.00,C,$2354.96
"Us Bank",,,04/14/2015,"Download from usbank.com. CHIPOTLE 1857   SAN FRANCISCCA","Everyday Expenses:Groceries","Everyday Expenses","Groceries",,$7.56,$0.00,C,$2347.40
"Us Bank",,,04/15/2015,"Download from usbank.com. SQWIGGLE INC","Income:Available this month","Income","Available this month",,$0.00,$1971.49,C,$4318.89
"Us Bank",,,04/15/2015,"Download from usbank.com. APL* ITUNES.COM/866-712-7753CA","Everyday Expenses:Spending Money","Everyday Expenses","Spending Money",,$1.99,$0.00,C,$4316.90
"Us Bank",,,04/15/2015,"Download from usbank.com. CHIPOTLE 1857   SAN FRANCISCCA","Everyday Expenses:Groceries","Everyday Expenses","Groceries",,$7.56,$0.00,C,$4309.34
"Us Bank",,,04/15/2015,"Download from usbank.com. Acorns Investmen","Savings Goals:Savings","Savings Goals","Savings",,$9.27,$0.00,C,$4300.07
"Us Bank",,,04/16/2015,"Download from usbank.com. PAYPAL","Everyday Expenses:Spending Money","Everyday Expenses","Spending Money",,$0.00,$64.28,C,$4364.35
"Us Bank",,,04/16/2015,"Download from usbank.com. APL* ITUNES.COM/866-712-7753CA","Everyday Expenses:Spending Money","Everyday Expenses","Spending Money",,$7.96,$0.00,C,$4356.39
"Us Bank",,,04/16/2015,"Download from usbank.com. 111 MINNA ST GALSAN FRANCISCCA","Everyday Expenses:Spending Money","Everyday Expenses","Spending Money",,$9.00,$0.00,C,$4347.39
"Us Bank",,,04/16/2015,"Download from usbank.com. FRESHROLL       SAN FRANCISCCA","Everyday Expenses:Spending Money","Everyday Expenses","Spending Money",,$9.51,$0.00,C,$4337.88
"Us Bank",,,04/16/2015,"Download from usbank.com. SUTTER FINE FOODSAN FRANCISCCA","Everyday Expenses:Groceries","Everyday Expenses","Groceries",,$10.10,$0.00,C,$4327.78
"Us Bank",,,04/16/2015,"Download from usbank.com. WALGREENS 100 SASAN FRANCISCCA","Everyday Expenses:Household Goods","Everyday Expenses","Household Goods",,$12.27,$0.00,C,$4315.51
"Us Bank",,,04/16/2015,"Download from usbank.com. H&M             SAN FRANCISCCA","Everyday Expenses:Clothing","Everyday Expenses","Clothing",,$30.40,$0.00,C,$4285.11
"Us Bank",,,04/16/2015,"Download from usbank.com. WALGREENS 1300 BSAN FRANCISCCA","Everyday Expenses:Household Goods","Everyday Expenses","Household Goods",,$48.79,$0.00,C,$4236.32
"Us Bank",,,04/16/2015,"Download from usbank.com. VICTORIA'S SECRESAN FRANCISCCA","Everyday Expenses:Clothing","Everyday Expenses","Clothing",,$63.94,$0.00,C,$4172.38
"Us Bank",,,04/16/2015,"Download from usbank.com. FRANCHISE TAX BO","Debt:Fucking Taxes","Debt","Fucking Taxes",,$1862.00,$0.00,C,$2310.38
"Us Bank",,,04/17/2015,"Download from usbank.com. PAYPAL","Everyday Expenses:Spending Money","Everyday Expenses","Spending Money",,$0.00,$61.78,C,$2372.16
"Us Bank",,,04/17/2015,"Download from usbank.com. LYFT RIDE THU 8P855-280-0278CA","Everyday Expenses:Transportation","Everyday Expenses","Transportation",,$6.00,$0.00,C,$2366.16
"Us Bank",,,04/20/2015,"Download from usbank.com.","Everyday Expenses:Misc","Everyday Expenses","Misc",,$0.00,$300.00,C,$2666.16
"Us Bank",,,04/20/2015,"Download from usbank.com. AMAZON MKTPLACE AMZN.COM/BILWA","Everyday Expenses:Spending Money","Everyday Expenses","Spending Money",,$0.00,$18.98,C,$2685.14
"Us Bank",,,04/20/2015,"Download from usbank.com. KAI BAARS","Everyday Expenses:Spending Money","Everyday Expenses","Spending Money",,$1.11,$0.00,C,$2684.03
"Us Bank",,,04/20/2015,"Download from usbank.com. SQ *PHILZ COFFEESan FranciscCA","Everyday Expenses:Spending Money","Everyday Expenses","Spending Money",,$3.00,$0.00,C,$2681.03
"Us Bank",,,04/20/2015,"Download from usbank.com. LYFT RIDE SUN 2P855-280-0278CA","Everyday Expenses:Transportation","Everyday Expenses","Transportation",,$5.00,$0.00,C,$2676.03
"Us Bank",,,04/20/2015,"Download from usbank.com. LYFT RIDE THU 11855-280-0278CA","Everyday Expenses:Transportation","Everyday Expenses","Transportation",,$6.00,$0.00,C,$2670.03
"Us Bank",,,04/20/2015,"Download from usbank.com. SQ *TARA FIRMA FKENSINGTON  CA","Everyday Expenses:Misc","Everyday Expenses","Misc",,$6.00,$0.00,C,$2664.03
"Us Bank",,,04/20/2015,"Download from usbank.com. LYFT RIDE SUN 4P855-280-0278CA","Everyday Expenses:Transportation","Everyday Expenses","Transportation",,$7.45,$0.00,C,$2656.58
"Us Bank",,,04/20/2015,"Download from usbank.com. BAMBOO ASIA     SAN FRANCISCCA","Everyday Expenses:Spending Money","Everyday Expenses","Spending Money",,$9.73,$0.00,C,$2646.85
"Us Bank",,,04/20/2015,"Download from usbank.com. PAYPAL","Monthly Bills:Web Stuff","Monthly Bills","Web Stuff",,$9.99,$0.00,C,$2636.86
"Us Bank",,,04/20/2015,"Download from usbank.com. PAYPAL","Monthly Bills:Web Stuff","Monthly Bills","Web Stuff",,$9.99,$0.00,C,$2626.87
"Us Bank",,,04/20/2015,"Download from usbank.com. PAYPAL","Everyday Expenses:Coffee Shop","Everyday Expenses","Coffee Shop",,$10.00,$0.00,C,$2616.87
"Us Bank",,,04/20/2015,"Download from usbank.com. WALGREENS 1300 BSAN FRANCISCCA","Everyday Expenses:Household Goods","Everyday Expenses","Household Goods",,$11.38,$0.00,C,$2605.49
"Us Bank",,,04/20/2015,"Download from usbank.com. SQ *DELISH DELI San FranciscCA","Everyday Expenses:Spending Money","Everyday Expenses","Spending Money",,$15.77,$0.00,C,$2589.72
"Us Bank",,,04/20/2015,"Download from usbank.com. SQ *FINS ON THE San FranciscCA","Everyday Expenses:Spending Money","Everyday Expenses","Spending Money",,$24.00,$0.00,C,$2565.72
"Us Bank",,,04/20/2015,"Download from usbank.com. BEVERAGES & MORESAN FRANCISCCA","Everyday Expenses:Spending Money","Everyday Expenses","Spending Money",,$26.09,$0.00,C,$2539.63
"Us Bank",,,04/20/2015,"Download from usbank.com. TARGET T3201    SAN FRANCISCCA","Everyday Expenses:Groceries","Everyday Expenses","Groceries",,$30.29,$0.00,C,$2509.34
"Us Bank",,,04/20/2015,"Download from usbank.com. MODCLOTH INC.   888-4959699 CA","Everyday Expenses:Clothing","Everyday Expenses","Clothing",,$61.78,$0.00,C,$2447.56
"Us Bank",,,04/20/2015,"Download from usbank.com. GUITAR CENTER #2SAN FRANCISCCA","Everyday Expenses:Misc","Everyday Expenses","Misc",,$76.07,$0.00,C,$2371.49
"Us Bank",,,04/20/2015,"Download from usbank.com. MODCLOTH INC.   888-4959699 CA","Everyday Expenses:Clothing","Everyday Expenses","Clothing",,$90.64,$0.00,C,$2280.85
"Us Bank",,,04/20/2015,"Download from usbank.com. TRADER JOE'S #20SAN FRANCISCCA","Everyday Expenses:Groceries","Everyday Expenses","Groceries",,$121.93,$0.00,C,$2158.92
"Us Bank",,,04/20/2015,"Download from usbank.com. INDIAN SPRINGS RCALISTOGA   CA","Everyday Expenses:Misc","Everyday Expenses","Misc",,$125.00,$0.00,C,$2033.92
"Us Bank",,,04/20/2015,"Download from usbank.com. ATT","Monthly Bills:Cell Phone","Monthly Bills","Cell Phone",,$142.13,$0.00,C,$1891.79
"Us Bank",,,04/20/2015,"Download from usbank.com. GCI*MUSICIAN'S F800-776-5173UT","Everyday Expenses:Misc","Everyday Expenses","Misc",,$383.45,$0.00,C,$1508.34
"Us Bank",,,04/21/2015,"Download from usbank.com. SAJJ            MENLO PARK  CA","Everyday Expenses:Spending Money","Everyday Expenses","Spending Money",,$3.00,$0.00,C,$1505.34
"Us Bank",,,04/21/2015,"Download from usbank.com. Acorns Investmen","Savings Goals:Savings","Savings Goals","Savings",,$6.92,$0.00,C,$1498.42
"Us Bank",,,04/21/2015,"Download from usbank.com. WORKING GIRLS CASAN FRANCISCCA","Everyday Expenses:Spending Money","Everyday Expenses","Spending Money",,$9.95,$0.00,C,$1488.47
"Us Bank",,,04/21/2015,"Download from usbank.com. MURACCI'S JAPANESAN FRANCISCCA","Everyday Expenses:Spending Money","Everyday Expenses","Spending Money",,$11.09,$0.00,C,$1477.38
"Us Bank",,,04/22/2015,"Download from usbank.com.","Everyday Expenses:Spending Money","Everyday Expenses","Spending Money",,$0.00,$6.95,C,$1484.33
"Us Bank",,,04/22/2015,"Download from usbank.com. SQ *WORKSHOP CAFSan FranciscCA","Everyday Expenses:Spending Money","Everyday Expenses","Spending Money",,$5.00,$0.00,C,$1479.33
"Us Bank",,,04/22/2015,"Download from usbank.com.","Everyday Expenses:Spending Money","Everyday Expenses","Spending Money",,$6.95,$0.00,C,$1472.38
"Us Bank",,,04/23/2015,"Download from usbank.com. APL* ITUNES.COM/866-712-7753CA","Everyday Expenses:Spending Money","Everyday Expenses","Spending Money",,$4.98,$0.00,C,$1467.40
"Us Bank",,,04/23/2015,"Download from usbank.com. WALGREENS 1300 BSAN FRANCISCCA","Everyday Expenses:Household Goods","Everyday Expenses","Household Goods",,$6.51,$0.00,C,$1460.89
"Us Bank",,,04/23/2015,"Download from usbank.com. THE POSH BAGEL  SAN FRANCISCCA","Everyday Expenses:Spending Money","Everyday Expenses","Spending Money",,$7.29,$0.00,C,$1453.60
"Us Bank",,,04/23/2015,"Download from usbank.com. PANDA EXPRESS #1SAN FRANCISCCA","Everyday Expenses:Spending Money","Everyday Expenses","Spending Money",,$8.81,$0.00,C,$1444.79
"Us Bank",,,04/23/2015,"Download from usbank.com. SF SOUP CO MONTGSAN FRANCISCCA","Everyday Expenses:Spending Money","Everyday Expenses","Spending Money",,$9.33,$0.00,C,$1435.46
"Us Bank",,,04/23/2015,"Download from usbank.com. EAT24.COM       866-3281123 CA","Everyday Expenses:Spending Money","Everyday Expenses","Spending Money",,$9.89,$0.00,C,$1425.57
"Us Bank",,,04/23/2015,"Download from usbank.com. Acorns Investmen","Savings Goals:Savings","Savings Goals","Savings",,$9.98,$0.00,C,$1415.59
"Us Bank",,,04/23/2015,"Download from usbank.com. PAYPAL","Monthly Bills:Web Stuff","Monthly Bills","Web Stuff",,$9.99,$0.00,C,$1405.60
"Us Bank",,,04/23/2015,"Download from usbank.com. Spotify USA     877-778-1161NY","Monthly Bills:Web Stuff","Monthly Bills","Web Stuff",,$9.99,$0.00,C,$1395.61
"Us Bank",,,04/24/2015,"Download from usbank.com. MODCLOTH INC","Income:Available this month","Income","Available this month",,$0.00,$1507.86,C,$2903.47
"Us Bank",,,04/24/2015,"Download from usbank.com. VENMO","Everyday Expenses:Misc","Everyday Expenses","Misc",,$0.00,$181.64,C,$3085.11
"Us Bank",,,04/24/2015,"Download from usbank.com. ENVATO PTY LTD","Monthly Bills:Web Stuff","Monthly Bills","Web Stuff",,$9.00,$0.00,C,$3076.11
"Us Bank",,,04/24/2015,"Download from usbank.com. FRESHROLL       SAN FRANCISCCA","Everyday Expenses:Spending Money","Everyday Expenses","Spending Money",,$9.51,$0.00,C,$3066.60
"Us Bank",,,04/24/2015,"Download from usbank.com. SUSHI TOSUKI    SAN FRANCISCCA","Everyday Expenses:Spending Money","Everyday Expenses","Spending Money",,$9.79,$0.00,C,$3056.81
"Us Bank",,,04/24/2015,"Download from usbank.com. MUNCHERY INC.  888-458-5376CA","Everyday Expenses:Groceries","Everyday Expenses","Groceries",,$14.90,$0.00,C,$3041.91
"Us Bank",,,04/24/2015,"Download from usbank.com. TRADER JOE'S #20SAN FRANCISCCA","Everyday Expenses:Groceries","Everyday Expenses","Groceries",,$48.41,$0.00,C,$2993.50
"Us Bank",,,04/24/2015,"Download from usbank.com. VENMO           855-812-4430NY","Everyday Expenses:Misc","Everyday Expenses","Misc",,$173.17,$0.00,C,$2820.33
"Us Bank",,,04/27/2015,"Download from usbank.com. SQ *BLUE BOTTLE San FranciscCA","Everyday Expenses:Coffee Shop","Everyday Expenses","Coffee Shop",,$4.25,$0.00,C,$2816.08
"Us Bank",,,04/27/2015,"Download from usbank.com. LYFT   *RIDE FRI855-280-0278CA","Everyday Expenses:Transportation","Everyday Expenses","Transportation",,$5.03,$0.00,C,$2811.05
"Us Bank",,,04/27/2015,"Download from usbank.com. HLU*Hulu 2274453HULU.COM/BILCA","Monthly Bills:Web Stuff","Monthly Bills","Web Stuff",,$7.99,$0.00,C,$2803.06
"Us Bank",,,04/27/2015,"Download from usbank.com. STARBUCKS CARD R800-782-7282WA","Everyday Expenses:Coffee Shop","Everyday Expenses","Coffee Shop",,$10.00,$0.00,C,$2793.06
"Us Bank",,,04/27/2015,"Download from usbank.com. THE GOLDEN GATE SAN FRANCISCCA","Everyday Expenses:Spending Money","Everyday Expenses","Spending Money",,$14.00,$0.00,C,$2779.06
"Us Bank",,,04/27/2015,"Download from usbank.com. THE GOLDEN GATE SAN FRANCISCCA","Everyday Expenses:Spending Money","Everyday Expenses","Spending Money",,$14.00,$0.00,C,$2765.06
"Us Bank",,,04/27/2015,"Download from usbank.com. SLIDERS DINER   SAN FRANCISCCA","Everyday Expenses:Spending Money","Everyday Expenses","Spending Money",,$23.11,$0.00,C,$2741.95
"Us Bank",,,04/27/2015,"Download from usbank.com. WICHCRAFT SAN FRSAN FRANCISCCA","Everyday Expenses:Spending Money","Everyday Expenses","Spending Money",,$23.76,$0.00,C,$2718.19
"Us Bank",,,04/27/2015,"Download from usbank.com. AMC VAN NESS 14 SAN FRANCISCCA","Everyday Expenses:Spending Money","Everyday Expenses","Spending Money",,$24.58,$0.00,C,$2693.61
"Us Bank",,,04/27/2015,"Download from usbank.com. FOREVER 21.COM  213-747-2121CA","Everyday Expenses:Clothing","Everyday Expenses","Clothing",,$28.11,$0.00,C,$2665.50
"Us Bank",,,04/27/2015,"Download from usbank.com. TYCOON RESTAURANSAN FRANCISCCA","Everyday Expenses:Spending Money","Everyday Expenses","Spending Money",,$32.41,$0.00,C,$2633.09
"Us Bank",,,04/27/2015,"Download from usbank.com. WALGREENS 1300 BSAN FRANCISCCA","Everyday Expenses:Household Goods","Everyday Expenses","Household Goods",,$42.12,$0.00,C,$2590.97
"Us Bank",,,04/27/2015,"Download from usbank.com. WHOLEFDS FRK 100San FranciscCA","Everyday Expenses:Groceries","Everyday Expenses","Groceries",,$123.16,$0.00,C,$2467.81
"Us Bank",,,04/28/2015,"Download from usbank.com. Acorns Investmen","Savings Goals:Savings","Savings Goals","Savings",,$5.43,$0.00,C,$2462.38
"Us Bank",,,04/28/2015,"Download from usbank.com. SQ *ANOTHER CAFESan FranciscCA","Everyday Expenses:Spending Money","Everyday Expenses","Spending Money",,$8.65,$0.00,C,$2453.73
"Us Bank",,,04/28/2015,"Download from usbank.com. TRADER JOE'S #20SAN FRANCISCCA","Everyday Expenses:Groceries","Everyday Expenses","Groceries",,$20.54,$0.00,C,$2433.19
"Us Bank",,,04/28/2015,"Download from usbank.com. THE CREPE HOUSE SAN FRANCISCCA","Everyday Expenses:Spending Money","Everyday Expenses","Spending Money",,$24.90,$0.00,C,$2408.29
"Us Bank",,,04/28/2015,"Download from usbank.com. UNO DOS TACO    SAN FRANCISCCA","Everyday Expenses:Spending Money","Everyday Expenses","Spending Money",,$32.36,$0.00,C,$2375.93
"Us Bank",,,04/29/2015,"Download from usbank.com. AMAZON DIG606093","Everyday Expenses:Spending Money","Everyday Expenses","Spending Money",,$0.00,$0.62,C,$2376.55
"Us Bank",,,04/29/2015,"Download from usbank.com. UBER TECHNOLOGIE866-576-1039CA","Everyday Expenses:Transportation","Everyday Expenses","Transportation",,$7.00,$0.00,C,$2369.55
"Us Bank",,,04/29/2015,"Download from usbank.com. MR HOLMES BAKEHOSAN FRANCISCCA","Everyday Expenses:Spending Money","Everyday Expenses","Spending Money",,$26.01,$0.00,C,$2343.54
"Us Bank",,,04/29/2015,"Download from usbank.com. WALGREENS 1300 BSAN FRANCISCCA","Everyday Expenses:Household Goods","Everyday Expenses","Household Goods",,$57.12,$0.00,C,$2286.42
"Us Bank",,,04/30/2015,"Download from usbank.com. SQWIGGLE INC","Income:Available this month","Income","Available this month",,$0.00,$1798.57,C,$4084.99
"Us Bank",,,04/30/2015,"Download from usbank.com. Acorns.com","Everyday Expenses:Spending Money","Everyday Expenses","Spending Money",,$9.79,$0.00,C,$4075.20
"Us Bank",,,04/30/2015,"Download from usbank.com. MAILCHIMP       MAILCHIMP.COGA","Monthly Bills:Web Stuff","Monthly Bills","Web Stuff",,$10.00,$0.00,C,$4065.20
"Us Bank",,,04/30/2015,"Download from usbank.com. SPOONROCKET.COM 510-921-9929CA","Everyday Expenses:Spending Money","Everyday Expenses","Spending Money",,$20.15,$0.00,C,$4045.05
"Us Bank",,,04/30/2015,"Download from usbank.com. MODCLOTH INC.   888-4959699 CA","Everyday Expenses:Clothing","Everyday Expenses","Clothing",,$71.61,$0.00,C,$3973.44
"Us Bank",,,05/01/2015,"Download from usbank.com. APL* ITUNES.COM/866-712-7753CA","Everyday Expenses:Spending Money","Everyday Expenses","Spending Money",,$1.99,$0.00,C,$3971.45
"Us Bank",,,05/01/2015,"Download from usbank.com. AYOLA (KEARNY)  SAN FRANCISCCA","Everyday Expenses:Spending Money","Everyday Expenses","Spending Money",,$2.99,$0.00,C,$3968.46
"Us Bank",,,05/01/2015,"Download from usbank.com. TRADER JOE'S #20SAN FRANCISCCA","Everyday Expenses:Groceries","Everyday Expenses","Groceries",,$38.44,$0.00,C,$3930.02
"Us Bank",,,05/01/2015,"Download from usbank.com. PAYPAL","Monthly Bills:Web Stuff","Monthly Bills","Web Stuff",,$39.99,$0.00,C,$3890.03
"Us Bank",,,05/01/2015,"Download from usbank.com. AMZ*Beautifi4157SAN FRANCISCCA","Everyday Expenses:Spending Money","Everyday Expenses","Spending Money",,$65.00,$0.00,C,$3825.03
"Us Bank",,,05/04/2015,"Download from usbank.com. AMC VAN NESS 14 SAN FRANCISCCA","Everyday Expenses:Spending Money","Everyday Expenses","Spending Money",,$5.79,$0.00,C,$3819.24
"Us Bank",,,05/04/2015,"Download from usbank.com. FRESHROLL       SAN FRANCISCCA","Everyday Expenses:Spending Money","Everyday Expenses","Spending Money",,$9.51,$0.00,C,$3809.73
"Us Bank",,,05/04/2015,"Download from usbank.com. SQ *CONTRABAND CSan FranciscCA","Everyday Expenses:Coffee Shop","Everyday Expenses","Coffee Shop",,$9.76,$0.00,C,$3799.97
"Us Bank",,,05/04/2015,"Download from usbank.com. STARBUCKS CARD R800-782-7282WA","Everyday Expenses:Spending Money","Everyday Expenses","Spending Money",,$10.00,$0.00,C,$3789.97
"Us Bank",,,05/04/2015,"Download from usbank.com. CVS 10080       SAN FRANCISCCA","Everyday Expenses:Household Goods","Everyday Expenses","Household Goods",,$13.14,$0.00,C,$3776.83
"Us Bank",,,05/04/2015,"Download from usbank.com. CVS 10080       SAN FRANCISCCA","Everyday Expenses:Household Goods","Everyday Expenses","Household Goods",,$15.00,$0.00,C,$3761.83
"Us Bank",,,05/04/2015,"Download from usbank.com. TRADER JOE'S #20SAN FRANCISCCA","Everyday Expenses:Groceries","Everyday Expenses","Groceries",,$16.24,$0.00,C,$3745.59
"Us Bank",,,05/04/2015,"Download from usbank.com. LOS HERMANOS    SAN FRANCISCCA","Everyday Expenses:Spending Money","Everyday Expenses","Spending Money",,$22.51,$0.00,C,$3723.08
"Us Bank",,,05/04/2015,"Download from usbank.com. AMC VAN NESS 14 SAN FRANCISCCA","Everyday Expenses:Spending Money","Everyday Expenses","Spending Money",,$24.58,$0.00,C,$3698.50
"Us Bank",,,05/04/2015,"Download from usbank.com. TRADER JOE'S #20SAN FRANCISCCA","Everyday Expenses:Groceries","Everyday Expenses","Groceries",,$28.50,$0.00,C,$3670.00
"Us Bank",,,05/04/2015,"Download from usbank.com. KYOTO SUSHI     SAN FRANCISCCA","Everyday Expenses:Spending Money","Everyday Expenses","Spending Money",,$55.81,$0.00,C,$3614.19
"Us Bank",,,05/04/2015,"Download from usbank.com. CLASSPASS.COM CL888-493-5953NY","Everyday Expenses:Spending Money","Everyday Expenses","Spending Money",,$99.00,$0.00,C,$3515.19
"Us Bank",,,05/05/2015,"Download from usbank.com. PAYPAL","Everyday Expenses:Coffee Shop","Everyday Expenses","Coffee Shop",,$10.00,$0.00,C,$3505.19
"Us Bank",,,05/05/2015,"Download from usbank.com. 0180 FOREVER 21 SAN FRANCISCCA","Everyday Expenses:Clothing","Everyday Expenses","Clothing",,$46.55,$0.00,C,$3458.64
"Us Bank",,,05/05/2015,"Download from usbank.com. BEVERAGES & MORESAN FRANCISCCA","Everyday Expenses:Spending Money","Everyday Expenses","Spending Money",,$138.38,$0.00,C,$3320.26
"Us Bank",,,05/05/2015,"Download from usbank.com. Mosser Companies","Monthly Bills:Rent","Monthly Bills","Rent",,$1582.72,$0.00,C,$1737.54
"Us Bank",,,05/06/2015,"Download from usbank.com.","Everyday Expenses:Spending Money","Everyday Expenses","Spending Money",,$0.20,$0.00,C,$1737.34
"Us Bank",,,05/06/2015,"Download from usbank.com. UBER            866-576-1039CA","Everyday Expenses:Transportation","Everyday Expenses","Transportation",,$5.30,$0.00,C,$1732.04
"Us Bank",,,05/06/2015,"Download from usbank.com. APL* ITUNES.COM/866-712-7753CA","Everyday Expenses:Spending Money","Everyday Expenses","Spending Money",,$6.98,$0.00,C,$1725.06
"Us Bank",,,05/06/2015,"Download from usbank.com. BAMBOO ASIA     SAN FRANCISCCA","Everyday Expenses:Spending Money","Everyday Expenses","Spending Money",,$9.73,$0.00,C,$1715.33
"Us Bank",,,05/06/2015,"Download from usbank.com. GHOST PERSONAL  +44207224282","Monthly Bills:Web Stuff","Monthly Bills","Web Stuff",,$10.00,$0.00,C,$1705.33
"Us Bank",,,05/06/2015,"Download from usbank.com. Acorns.com","Savings Goals:Savings","Savings Goals","Savings",,$10.99,$0.00,C,$1694.34
"Us Bank",,,05/06/2015,"Download from usbank.com. ONIGILLY        SAN FRANCISCCA","Everyday Expenses:Spending Money","Everyday Expenses","Spending Money",,$11.00,$0.00,C,$1683.34
"Us Bank",,,05/06/2015,"Download from usbank.com. EAT24.COM       866-3281123 CA","Everyday Expenses:Spending Money","Everyday Expenses","Spending Money",,$13.10,$0.00,C,$1670.24
"Us Bank",,,05/06/2015,"Download from usbank.com. The Perch       Las Vegas   NV","Everyday Expenses:Spending Money","Everyday Expenses","Spending Money",,$13.97,$0.00,C,$1656.27
"Us Bank",,,05/06/2015,"Download from usbank.com. WALGREENS 495 FRLAS VEGAS   NV","Everyday Expenses:Household Goods","Everyday Expenses","Household Goods",,$17.10,$0.00,C,$1639.17
"Us Bank",,,05/06/2015,"Download from usbank.com. WALGREENS 495 FRLAS VEGAS   NV","Everyday Expenses:Household Goods","Everyday Expenses","Household Goods",,$59.66,$0.00,C,$1579.51
"Us Bank",,,05/07/2015,"Download from usbank.com. GHOSTBAR        LAS VEGAS   NV","Everyday Expenses:Spending Money","Everyday Expenses","Spending Money",,$19.00,$0.00,C,$1560.51
"Us Bank",,,05/07/2015,"Download from usbank.com. VENMO","Everyday Expenses:Spending Money","Everyday Expenses","Spending Money",,$23.50,$0.00,C,$1537.01
"Us Bank",,,05/07/2015,"Download from usbank.com. TRADER JOE'S #20SAN FRANCISCCA","Everyday Expenses:Groceries","Everyday Expenses","Groceries",,$25.25,$0.00,C,$1511.76
"Us Bank",,,05/08/2015,"Download from usbank.com. MODCLOTH INC","Income:Available this month","Income","Available this month",,$0.00,$1507.86,C,$3019.62
"Us Bank",,,05/08/2015,"Download from usbank.com. Acorns.com","Savings Goals:Savings","Savings Goals","Savings",,$8.31,$0.00,C,$3011.31
"Us Bank",,,05/08/2015,"Download from usbank.com. COMMONWEALTH 2  LAS VEGAS   NV","Everyday Expenses:Spending Money","Everyday Expenses","Spending Money",,$11.00,$0.00,C,$3000.31
"Us Bank",,,05/08/2015,"Download from usbank.com. SQ *THE BEAT COFLas Vegas   NV","Everyday Expenses:Spending Money","Everyday Expenses","Spending Money",,$11.33,$0.00,C,$2988.98
"Us Bank",,,05/08/2015,"Download from usbank.com. SUPER DUPER BURGSAN FRANCISCCA","Everyday Expenses:Spending Money","Everyday Expenses","Spending Money",,$12.78,$0.00,C,$2976.20
"Us Bank",,,05/08/2015,"Download from usbank.com. COMMONWEALTH 2  LAS VEGAS   NV","Everyday Expenses:Spending Money","Everyday Expenses","Spending Money",,$17.00,$0.00,C,$2959.20
"Us Bank",,,05/11/2015,"Download from usbank.com. SQ *WORKSHOP CAFSan FranciscCA","Everyday Expenses:Spending Money","Everyday Expenses","Spending Money",,$5.00,$0.00,C,$2954.20
"Us Bank",,,05/11/2015,"Download from usbank.com. LYFT   *RIDE SAT855-280-0278CA","Everyday Expenses:Transportation","Everyday Expenses","Transportation",,$6.00,$0.00,C,$2948.20
"Us Bank",,,05/11/2015,"Download from usbank.com. LYFT   *RIDE SAT855-280-0278CA","Everyday Expenses:Transportation","Everyday Expenses","Transportation",,$8.00,$0.00,C,$2940.20
"Us Bank",,,05/11/2015,"Download from usbank.com. PAYPAL","Everyday Expenses:Coffee Shop","Everyday Expenses","Coffee Shop",,$10.00,$0.00,C,$2930.20
"Us Bank",,,05/11/2015,"Download from usbank.com. SQ *SAN FRANPSYCSan FranciscCA","Everyday Expenses:Spending Money","Everyday Expenses","Spending Money",,$10.88,$0.00,C,$2919.32
"Us Bank",,,05/11/2015,"Download from usbank.com. ORDERAHEAD URBAN650-503-3279CA","Everyday Expenses:Spending Money","Everyday Expenses","Spending Money",,$11.77,$0.00,C,$2907.55
"Us Bank",,,05/11/2015,"Download from usbank.com. TARGET T3201    SAN FRANCISCCA","Everyday Expenses:Groceries","Everyday Expenses","Groceries",,$14.71,$0.00,C,$2892.84
"Us Bank",,,05/11/2015,"Download from usbank.com. SUTTER FINE FOODSAN FRANCISCCA","Everyday Expenses:Groceries","Everyday Expenses","Groceries",,$14.77,$0.00,C,$2878.07
"Us Bank",,,05/11/2015,"Download from usbank.com. PAYPAL","Everyday Expenses:Transportation","Everyday Expenses","Transportation",,$15.00,$0.00,C,$2863.07
"Us Bank",,,05/11/2015,"Download from usbank.com. BITE            SAN FRANCISCCA","Everyday Expenses:Spending Money","Everyday Expenses","Spending Money",,$19.01,$0.00,C,$2844.06
"Us Bank",,,05/11/2015,"Download from usbank.com. SQ *EBBETT'S GOOSan FranciscCA","Everyday Expenses:Spending Money","Everyday Expenses","Spending Money",,$21.00,$0.00,C,$2823.06
"Us Bank",,,05/11/2015,"Download from usbank.com. VENMO","Everyday Expenses:Spending Money","Everyday Expenses","Spending Money",,$23.00,$0.00,C,$2800.06
"Us Bank",,,05/11/2015,"Download from usbank.com. WALGREENS 1300 BSAN FRANCISCCA","Everyday Expenses:Household Goods","Everyday Expenses","Household Goods",,$24.62,$0.00,C,$2775.44
"Us Bank",,,05/11/2015,"Download from usbank.com. DOMINOS 7764    415-821-9700CA","Everyday Expenses:Spending Money","Everyday Expenses","Spending Money",,$31.68,$0.00,C,$2743.76
"Us Bank",,,05/11/2015,"Download from usbank.com. Sharis *Berries 877-237-7437CA","Everyday Expenses:Spending Money","Everyday Expenses","Spending Money",,$48.97,$0.00,C,$2694.79
"Us Bank",,,05/11/2015,"Download from usbank.com. PAYPAL","Rainy Day Funds:Gifts","Rainy Day Funds","Gifts",,$84.97,$0.00,C,$2609.82
"Us Bank",,,05/11/2015,"Download from usbank.com. WHOLEFDS FRK 100San FranciscCA","Everyday Expenses:Groceries","Everyday Expenses","Groceries",,$155.47,$0.00,C,$2454.35
"Us Bank",,,05/12/2015,"Download from usbank.com. Acorns.com","Savings Goals:Savings","Savings Goals","Savings",,$5.14,$0.00,C,$2449.21
"Us Bank",,,05/12/2015,"Download from usbank.com. AMZ*NijiJapa4153San FranciscCA","Everyday Expenses:Spending Money","Everyday Expenses","Spending Money",,$9.23,$0.00,C,$2439.98
"Us Bank",,,05/12/2015,"Download from usbank.com. Apex Clearing","Savings Goals:Savings","Savings Goals","Savings",,$100.00,$0.00,C,$2339.98
"Us Bank",,,05/13/2015,"Download from usbank.com. SQ *WORKSHOP CAFSan FranciscCA","Everyday Expenses:Spending Money","Everyday Expenses","Spending Money",,$5.00,$0.00,C,$2334.98
"Us Bank",,,05/13/2015,"Download from usbank.com. SUTTER FINE FOODSAN FRANCISCCA","Everyday Expenses:Groceries","Everyday Expenses","Groceries",,$6.28,$0.00,C,$2328.70
"Us Bank",,,05/13/2015,"Download from usbank.com. SF SOUP CO MONTGSAN FRANCISCCA","Everyday Expenses:Spending Money","Everyday Expenses","Spending Money",,$9.08,$0.00,C,$2319.62
"Us Bank",,,05/13/2015,"Download from usbank.com. Acorns.com","Savings Goals:Savings","Savings Goals","Savings",,$9.15,$0.00,C,$2310.47
"Us Bank",,,05/13/2015,"Download from usbank.com. SQ *REVEILLE COFSan FranciscCA","Everyday Expenses:Spending Money","Everyday Expenses","Spending Money",,$11.00,$0.00,C,$2299.47
"Us Bank",,,05/13/2015,"Download from usbank.com. Audible         888-283-5051NJ","Monthly Bills:Web Stuff","Monthly Bills","Web Stuff",,$14.95,$0.00,C,$2284.52
"Us Bank",,,05/14/2015,"Download from usbank.com. CHEZ FAYALA LLC SAN FRANCISCCA","Everyday Expenses:Spending Money","Everyday Expenses","Spending Money",,$7.10,$0.00,C,$2277.42
"Us Bank",,,05/14/2015,"Download from usbank.com. CHIPOTLE 1857   SAN FRANCISCCA","Everyday Expenses:Spending Money","Everyday Expenses","Spending Money",,$7.56,$0.00,C,$2269.86
"Us Bank",,,05/14/2015,"Download from usbank.com. AmazonPrime Membamzn.com/prmNV","Everyday Expenses:Spending Money","Everyday Expenses","Spending Money",,$107.66,$0.00,C,$2162.20
"Us Bank",,,05/15/2015,"Download from usbank.com. SQWIGGLE INC","Income:Available this month","Income","Available this month",,$0.00,$1798.57,C,$3960.77
"Us Bank",,,05/15/2015,"Download from usbank.com. CHIPOTLE 1857   SAN FRANCISCCA","Everyday Expenses:Spending Money","Everyday Expenses","Spending Money",,$7.56,$0.00,C,$3953.21
"Us Bank",,,05/15/2015,"Download from usbank.com. SUTTER FINE FOODSAN FRANCISCCA","Everyday Expenses:Groceries","Everyday Expenses","Groceries",,$8.98,$0.00,C,$3944.23
"Us Bank",,,05/15/2015,"Download from usbank.com. SCHROEDER'S     SAN FRANCISCCA","Everyday Expenses:Spending Money","Everyday Expenses","Spending Money",,$47.64,$0.00,C,$3896.59
"Us Bank",,,05/15/2015,"Download from usbank.com. CHA AM THAI RESTSAN FRANCISCCA","Everyday Expenses:Spending Money","Everyday Expenses","Spending Money",,$54.88,$0.00,C,$3841.71
"Us Bank",,,05/15/2015,"Download from usbank.com. PGANDE","Monthly Bills:Utilities","Monthly Bills","Utilities",,$81.97,$0.00,C,$3759.74
"Us Bank",,,05/18/2015,"Download from usbank.com. LYFT   *RIDE WED855-280-0278CA","Everyday Expenses:Transportation","Everyday Expenses","Transportation",,$6.00,$0.00,C,$3753.74
"Us Bank",,,05/18/2015,"Download from usbank.com. SUTTER FINE FOODSAN FRANCISCCA","Everyday Expenses:Groceries","Everyday Expenses","Groceries",,$7.93,$0.00,C,$3745.81
"Us Bank",,,05/18/2015,"Download from usbank.com. AMC VAN NESS 14 SAN FRANCISCCA","Everyday Expenses:Spending Money","Everyday Expenses","Spending Money",,$8.00,$0.00,C,$3737.81
"Us Bank",,,05/18/2015,"Download from usbank.com. SQ *JOY'S PLACE San FranciscCA","Everyday Expenses:Spending Money","Everyday Expenses","Spending Money",,$8.16,$0.00,C,$3729.65
"Us Bank",,,05/18/2015,"Download from usbank.com. SQ *JOY'S PLACE San FranciscCA","Everyday Expenses:Spending Money","Everyday Expenses","Spending Money",,$9.24,$0.00,C,$3720.41
"Us Bank",,,05/18/2015,"Download from usbank.com. PAYPAL","Monthly Bills:Web Stuff","Monthly Bills","Web Stuff",,$9.99,$0.00,C,$3710.42
"Us Bank",,,05/18/2015,"Download from usbank.com. STARBUCKS CARD R800-782-7282WA","Everyday Expenses:Coffee Shop","Everyday Expenses","Coffee Shop",,$10.00,$0.00,C,$3700.42
"Us Bank",,,05/18/2015,"Download from usbank.com. HARROW          SAN FRANCISCCA","Everyday Expenses:Spending Money","Everyday Expenses","Spending Money",,$10.87,$0.00,C,$3689.55
"Us Bank",,,05/18/2015,"Download from usbank.com. SPOONROCKET.COM 510-921-9929CA","Everyday Expenses:Spending Money","Everyday Expenses","Spending Money",,$21.75,$0.00,C,$3667.80
"Us Bank",,,05/18/2015,"Download from usbank.com. AMC THEATRES ONL888-440-4262KS","Everyday Expenses:Spending Money","Everyday Expenses","Spending Money",,$24.58,$0.00,C,$3643.22
"Us Bank",,,05/18/2015,"Download from usbank.com. TOPSYS FUNHOUSE SAN FRANCISCCA","Everyday Expenses:Spending Money","Everyday Expenses","Spending Money",,$24.75,$0.00,C,$3618.47
"Us Bank",,,05/18/2015,"Download from usbank.com. WALGREENS 1300 BSAN FRANCISCCA","Everyday Expenses:Household Goods","Everyday Expenses","Household Goods",,$30.22,$0.00,C,$3588.25
"Us Bank",,,05/18/2015,"Download from usbank.com. MODCLOTH INC.   888-4959699 CA","Everyday Expenses:Clothing","Everyday Expenses","Clothing",,$53.71,$0.00,C,$3534.54
"Us Bank",,,05/18/2015,"Download from usbank.com. WHOLEFDS FRK 100San FranciscCA","Everyday Expenses:Groceries","Everyday Expenses","Groceries",,$113.44,$0.00,C,$3421.10
"Us Bank",,,05/19/2015,"Download from usbank.com. Audible US      888-283-5051NJ","Monthly Bills:Web Stuff","Monthly Bills","Web Stuff",,$0.95,$0.00,C,$3420.15
"Us Bank",,,05/19/2015,"Download from usbank.com. APL* ITUNES.COM/866-712-7753CA","Everyday Expenses:Spending Money","Everyday Expenses","Spending Money",,$4.99,$0.00,C,$3415.16
"Us Bank",,,05/19/2015,"Download from usbank.com. SQ *WORKSHOP CAFSan FranciscCA","Everyday Expenses:Spending Money","Everyday Expenses","Spending Money",,$5.00,$0.00,C,$3410.16
"Us Bank",,,05/19/2015,"Download from usbank.com. Acorns.com","Savings Goals:Savings","Savings Goals","Savings",,$5.37,$0.00,C,$3404.79
"Us Bank",,,05/19/2015,"Download from usbank.com. APL* ITUNES.COM/866-712-7753CA","Everyday Expenses:Spending Money","Everyday Expenses","Spending Money",,$6.99,$0.00,C,$3397.80
"Us Bank",,,05/19/2015,"Download from usbank.com. AMAZON MKTPLACE AMZN.COM/BILWA","Everyday Expenses:Spending Money","Everyday Expenses","Spending Money",,$13.89,$0.00,C,$3383.91
"Us Bank",,,05/19/2015,"Download from usbank.com. MURACCI'S JAPANESAN FRANCISCCA","Everyday Expenses:Spending Money","Everyday Expenses","Spending Money",,$22.72,$0.00,C,$3361.19
"Us Bank",,,05/19/2015,"Download from usbank.com. LOS HERMANOS    SAN FRANCISCCA","Everyday Expenses:Spending Money","Everyday Expenses","Spending Money",,$24.58,$0.00,C,$3336.61
"Us Bank",,,05/19/2015,"Download from usbank.com. NARA SUSHI      SAN FRANCISCCA","Everyday Expenses:Spending Money","Everyday Expenses","Spending Money",,$30.00,$0.00,C,$3306.61
"Us Bank",,,05/19/2015,"Download from usbank.com. ATT","Monthly Bills:Cell Phone","Monthly Bills","Cell Phone",,$142.71,$0.00,C,$3163.90
"Us Bank",,,05/19/2015,"Download from usbank.com. BETTERMENT","Savings Goals:Savings","Savings Goals","Savings",,$150.00,$0.00,C,$3013.90
"Us Bank",,,05/20/2015,"Download from usbank.com. APL* ITUNES.COM/866-712-7753CA","Everyday Expenses:Spending Money","Everyday Expenses","Spending Money",,$7.97,$0.00,C,$3005.93
"Us Bank",,,05/20/2015,"Download from usbank.com. WORKING GIRLS CASAN FRANCISCCA","Everyday Expenses:Spending Money","Everyday Expenses","Spending Money",,$9.95,$0.00,C,$2995.98
"Us Bank",,,05/20/2015,"Download from usbank.com. PAYPAL","Monthly Bills:Web Stuff","Monthly Bills","Web Stuff",,$9.99,$0.00,C,$2985.99
"Us Bank",,,05/20/2015,"Download from usbank.com. SPOONROCKET.COM 510-921-9929CA","Everyday Expenses:Spending Money","Everyday Expenses","Spending Money",,$20.45,$0.00,C,$2965.54
"Us Bank",,,05/20/2015,"Download from usbank.com. 7246","Debt:Eric's Credit Card","Debt","Eric's Credit Card",,$400.00,$0.00,C,$2565.54
"Us Bank",,,05/21/2015,"Download from usbank.com. SUTTER FINE FOODSAN FRANCISCCA","Everyday Expenses:Groceries","Everyday Expenses","Groceries",,$4.08,$0.00,C,$2561.46
"Us Bank",,,05/21/2015,"Download from usbank.com. SQ *WORKSHOP CAFSan FranciscCA","Everyday Expenses:Spending Money","Everyday Expenses","Spending Money",,$4.50,$0.00,C,$2556.96
"Us Bank",,,05/21/2015,"Download from usbank.com. CHIPOTLE 1857   SAN FRANCISCCA","Everyday Expenses:Spending Money","Everyday Expenses","Spending Money",,$7.56,$0.00,C,$2549.40
"Us Bank",,,05/21/2015,"Download from usbank.com. SF SOUP CO MONTGSAN FRANCISCCA","Everyday Expenses:Spending Money","Everyday Expenses","Spending Money",,$7.83,$0.00,C,$2541.57
"Us Bank",,,05/21/2015,"Download from usbank.com. Acorns.com","Savings Goals:Savings","Savings Goals","Savings",,$8.33,$0.00,C,$2533.24
"Us Bank",,,05/21/2015,"Download from usbank.com. WWW.WORKSHOPCAFE4153221048  CA","Everyday Expenses:Spending Money","Everyday Expenses","Spending Money",,$10.00,$0.00,C,$2523.24
"Us Bank",,,05/22/2015,"Download from usbank.com. MODCLOTH INC","Income:Available this month","Income","Available this month",,$0.00,$1651.54,C,$4174.78
"Us Bank",,,05/22/2015,"Download from usbank.com.","Everyday Expenses:Spending Money","Everyday Expenses","Spending Money",,$0.00,$6.95,C,$4181.73
"Us Bank",,,05/22/2015,"Download from usbank.com. Amazon Video On 866-216-1072WA","Everyday Expenses:Spending Money","Everyday Expenses","Spending Money",,$1.99,$0.00,C,$4179.74
"Us Bank",,,05/22/2015,"Download from usbank.com. SUTTER FINE FOODSAN FRANCISCCA","Everyday Expenses:Groceries","Everyday Expenses","Groceries",,$4.98,$0.00,C,$4174.76
"Us Bank",,,05/22/2015,"Download from usbank.com.","Everyday Expenses:Spending Money","Everyday Expenses","Spending Money",,$6.95,$0.00,C,$4167.81
"Us Bank",,,05/22/2015,"Download from usbank.com. FRESHROLL       SAN FRANCISCCA","Everyday Expenses:Spending Money","Everyday Expenses","Spending Money",,$9.51,$0.00,C,$4158.30
"Us Bank",,,05/22/2015,"Download from usbank.com. SQ *BIBIMBAR    San FranciscCA","Everyday Expenses:Spending Money","Everyday Expenses","Spending Money",,$9.79,$0.00,C,$4148.51
"Us Bank",,,05/22/2015,"Download from usbank.com. WORKING GIRLS CASAN FRANCISCCA","Everyday Expenses:Spending Money","Everyday Expenses","Spending Money",,$9.95,$0.00,C,$4138.56
"Us Bank",,,05/22/2015,"Download from usbank.com. Audible US      888-283-5051NJ","Monthly Bills:Web Stuff","Monthly Bills","Web Stuff",,$13.96,$0.00,C,$4124.60
"Us Bank",,,05/22/2015,"Download from usbank.com. SCHROEDER'S     SAN FRANCISCCA","Everyday Expenses:Spending Money","Everyday Expenses","Spending Money",,$88.83,$0.00,C,$4035.77
"Us Bank",,,05/26/2015,"Download from usbank.com. Amazon Video On 866-216-1072WA","Everyday Expenses:Spending Money","Everyday Expenses","Spending Money",,$1.99,$0.00,C,$4033.78
"Us Bank",,,05/26/2015,"Download from usbank.com. Amazon Video On 866-216-1072WA","Everyday Expenses:Spending Money","Everyday Expenses","Spending Money",,$1.99,$0.00,C,$4031.79
"Us Bank",,,05/26/2015,"Download from usbank.com. APL* ITUNES.COM/866-712-7753CA","Everyday Expenses:Spending Money","Everyday Expenses","Spending Money",,$3.99,$0.00,C,$4027.80
"Us Bank",,,05/26/2015,"Download from usbank.com. CHEZ FAYALA LLC SAN FRANCISCCA","Everyday Expenses:Spending Money","Everyday Expenses","Spending Money",,$6.84,$0.00,C,$4020.96
"Us Bank",,,05/26/2015,"Download from usbank.com. HLU*Hulu 2274453HULU.COM/BILCA","Monthly Bills:Web Stuff","Monthly Bills","Web Stuff",,$7.99,$0.00,C,$4012.97
"Us Bank",,,05/26/2015,"Download from usbank.com. Acorns.com","Savings Goals:Savings","Savings Goals","Savings",,$8.84,$0.00,C,$4004.13
"Us Bank",,,05/26/2015,"Download from usbank.com. UBER            866-576-1039CA","Everyday Expenses:Transportation","Everyday Expenses","Transportation",,$8.89,$0.00,C,$3995.24
"Us Bank",,,05/26/2015,"Download from usbank.com. CVS 10080       SAN FRANCISCCA","Everyday Expenses:Household Goods","Everyday Expenses","Household Goods",,$9.23,$0.00,C,$3986.01
"Us Bank",,,05/26/2015,"Download from usbank.com. PAYPAL","Monthly Bills:Web Stuff","Monthly Bills","Web Stuff",,$9.99,$0.00,C,$3976.02
"Us Bank",,,05/26/2015,"Download from usbank.com. Spotify USA     877-778-1161NY","Monthly Bills:Web Stuff","Monthly Bills","Web Stuff",,$9.99,$0.00,C,$3966.03
"Us Bank",,,05/26/2015,"Download from usbank.com. SUSHIRRITO      SAN FRANCISCCA","Everyday Expenses:Spending Money","Everyday Expenses","Spending Money",,$10.88,$0.00,C,$3955.15
"Us Bank",,,05/26/2015,"Download from usbank.com. WHOLEFDS SOM 101San FranciscCA","Everyday Expenses:Groceries","Everyday Expenses","Groceries",,$11.56,$0.00,C,$3943.59
"Us Bank",,,05/26/2015,"Download from usbank.com. PAYPAL","Rainy Day Funds:Gifts","Rainy Day Funds","Gifts",,$12.42,$0.00,C,$3931.17
"Us Bank",,,05/26/2015,"Download from usbank.com. BACCHUS KIRK    SAN FRANCISCCA","Everyday Expenses:Spending Money","Everyday Expenses","Spending Money",,$18.00,$0.00,C,$3913.17
"Us Bank",,,05/26/2015,"Download from usbank.com. STARBUCKS CARD R800-782-7282WA","Everyday Expenses:Coffee Shop","Everyday Expenses","Coffee Shop",,$20.00,$0.00,C,$3893.17
"Us Bank",,,05/26/2015,"Download from usbank.com. VILLAGE PETS & SSAN FRANCISCCA","Everyday Expenses:Household Goods","Everyday Expenses","Household Goods",,$25.00,$0.00,C,$3868.17
"Us Bank",,,05/26/2015,"Download from usbank.com. SQ *ANOTHER CAFESan FranciscCA","Everyday Expenses:Spending Money","Everyday Expenses","Spending Money",,$26.14,$0.00,C,$3842.03
"Us Bank",,,05/26/2015,"Download from usbank.com. WHOLEFDS SOM 101San FranciscCA","Everyday Expenses:Groceries","Everyday Expenses","Groceries",,$42.42,$0.00,C,$3799.61
"Us Bank",,,05/26/2015,"Download from usbank.com. FLY             SAN FRANCISCCA","Everyday Expenses:Spending Money","Everyday Expenses","Spending Money",,$50.56,$0.00,C,$3749.05
"Us Bank",,,05/26/2015,"Download from usbank.com. TRADER JOE'S #20SAN FRANCISCCA---- You Requested $10.00 in Cash Back","Everyday Expenses:Groceries","Everyday Expenses","Groceries",,$66.30,$0.00,C,$3682.75
"Us Bank",,,05/26/2015,"Download from usbank.com. EB BOTTLEROCK BU888-810-2063CA","Everyday Expenses:Spending Money","Everyday Expenses","Spending Money",,$86.40,$0.00,C,$3596.35
"Us Bank",,,05/27/2015,"Download from usbank.com. Apex Clearing","Savings Goals:Savings","Savings Goals","Savings",,$0.00,$100.00,C,$3696.35
"Us Bank",,,05/27/2015,"Download from usbank.com. APL* ITUNES.COM/866-712-7753CA","Everyday Expenses:Spending Money","Everyday Expenses","Spending Money",,$2.99,$0.00,C,$3693.36
"Us Bank",,,05/27/2015,"Download from usbank.com. SQ *WORKSHOP CAFSan FranciscCA","Everyday Expenses:Spending Money","Everyday Expenses","Spending Money",,$12.00,$0.00,C,$3681.36
"Us Bank",,,05/27/2015,"Download from usbank.com. PAYPAL","Everyday Expenses:Spending Money","Everyday Expenses","Spending Money",,$15.00,$0.00,C,$3666.36
"Us Bank",,,05/27/2015,"Download from usbank.com. CHEZ FAYALA LLC SAN FRANCISCCA","Everyday Expenses:Spending Money","Everyday Expenses","Spending Money",,$19.48,$0.00,C,$3646.88
"Us Bank",,,05/27/2015,"Download from usbank.com. 6010 FOREVER 21 SAN FRANCISCCA","Everyday Expenses:Clothing","Everyday Expenses","Clothing",,$24.90,$0.00,C,$3621.98
"Us Bank",,,05/27/2015,"Download from usbank.com. PAYPAL","Monthly Bills:Web Stuff","Monthly Bills","Web Stuff",,$39.95,$0.00,C,$3582.03
"Us Bank",,,05/28/2015,"Download from usbank.com. CHIPOTLE 1857   SAN FRANCISCCA","Everyday Expenses:Spending Money","Everyday Expenses","Spending Money",,$7.56,$0.00,C,$3574.47
"Us Bank",,,05/28/2015,"Download from usbank.com. BART-CLIPPER MONSAN FRANCISCCA","Everyday Expenses:Transportation","Everyday Expenses","Transportation",,$12.00,$0.00,C,$3562.47
"Us Bank",,,05/28/2015,"Download from usbank.com. NEWTREE CAFE    SAN FRANCISCCA","Everyday Expenses:Spending Money","Everyday Expenses","Spending Money",,$12.78,$0.00,C,$3549.69
"Us Bank",,,05/28/2015,"Download from usbank.com. WALGREENS 1300 BSAN FRANCISCCA","Everyday Expenses:Household Goods","Everyday Expenses","Household Goods",,$21.18,$0.00,C,$3528.51
"Us Bank",,,05/28/2015,"Download from usbank.com. SUTTER FINE FOODSAN FRANCISCCA","Everyday Expenses:Groceries","Everyday Expenses","Groceries",,$26.89,$0.00,C,$3501.62
"Us Bank",,,05/28/2015,"Download from usbank.com. BETTERMENT","Savings Goals:Savings","Savings Goals","Savings",,$100.00,$0.00,C,$3401.62
"Us Bank",,,05/29/2015,"Download from usbank.com. SQWIGGLE INC","Income:Available this month","Income","Available this month",,$0.00,$1798.57,C,$5200.19
"Us Bank",,,05/29/2015,"Download from usbank.com. AMAZON DIG618058","Everyday Expenses:Spending Money","Everyday Expenses","Spending Money",,$0.00,$0.60,C,$5200.79
"Us Bank",,,05/29/2015,"Download from usbank.com. SQ *WORKSHOP CAFSan FranciscCA","Everyday Expenses:Spending Money","Everyday Expenses","Spending Money",,$4.50,$0.00,C,$5196.29
"Us Bank",,,05/29/2015,"Download from usbank.com. SHORTY GOLDSTEINSAN FRANCISCCA","Everyday Expenses:Spending Money","Everyday Expenses","Spending Money",,$5.00,$0.00,C,$5191.29
"Us Bank",,,05/29/2015,"Download from usbank.com. APL* ITUNES.COM/866-712-7753CA","Everyday Expenses:Spending Money","Everyday Expenses","Spending Money",,$5.98,$0.00,C,$5185.31
"Us Bank",,,05/29/2015,"Download from usbank.com. Acorns.com","Savings Goals:Savings","Savings Goals","Savings",,$9.45,$0.00,C,$5175.86
"Us Bank",,,05/29/2015,"Download from usbank.com. STARBUCKS CARD R800-782-7282WA","Everyday Expenses:Coffee Shop","Everyday Expenses","Coffee Shop",,$10.00,$0.00,C,$5165.86
"Us Bank",,,05/29/2015,"Download from usbank.com. US BANK CIVIC CESAN FRANCISCCAUS1","Everyday Expenses:Spending Money","Everyday Expenses","Spending Money",,$140.00,$0.00,C,$5025.86
"Us Bank",,,06/01/2015,"Download from usbank.com. LYFT   *RIDE THU855-280-0278CA","Everyday Expenses:Transportation","Everyday Expenses","Transportation",,$5.00,$0.00,C,$5020.86
"Us Bank",,,06/01/2015,"Download from usbank.com. SQ *ANOTHER CAFESan FranciscCA","Everyday Expenses:Spending Money","Everyday Expenses","Spending Money",,$5.70,$0.00,C,$5015.16
"Us Bank",,,06/01/2015,"Download from usbank.com. MILLION THAI RESSAN FRANCISCCA","Everyday Expenses:Spending Money","Everyday Expenses","Spending Money",,$6.70,$0.00,C,$5008.46
"Us Bank",,,06/01/2015,"Download from usbank.com. UBER            866-576-1039CA","Everyday Expenses:Transportation","Everyday Expenses","Transportation",,$7.00,$0.00,C,$5001.46
"Us Bank",,,06/01/2015,"Download from usbank.com. SQ *PHILZ COFFEESan FranciscCA","Everyday Expenses:Spending Money","Everyday Expenses","Spending Money",,$8.00,$0.00,C,$4993.46
"Us Bank",,,06/01/2015,"Download from usbank.com. BOTTLEROCK FESTINAPA        CA","Everyday Expenses:Spending Money","Everyday Expenses","Spending Money",,$10.00,$0.00,C,$4983.46
"Us Bank",,,06/01/2015,"Download from usbank.com. MAILCHIMP       MAILCHIMP.COGA","Monthly Bills:Web Stuff","Monthly Bills","Web Stuff",,$10.00,$0.00,C,$4973.46
"Us Bank",,,06/01/2015,"Download from usbank.com. SQ *DELISH DELI San FranciscCA","Everyday Expenses:Spending Money","Everyday Expenses","Spending Money",,$10.77,$0.00,C,$4962.69
"Us Bank",,,06/01/2015,"Download from usbank.com. GROUPON INC     877-788-7858IL","Everyday Expenses:Spending Money","Everyday Expenses","Spending Money",,$12.00,$0.00,C,$4950.69
"Us Bank",,,06/01/2015,"Download from usbank.com. NOB HILL GRILLE SAN FRANCISCCA","Everyday Expenses:Spending Money","Everyday Expenses","Spending Money",,$33.84,$0.00,C,$4916.85
"Us Bank",,,06/01/2015,"Download from usbank.com. TRADER JOE'S #20SAN FRANCISCCA","Everyday Expenses:Groceries","Everyday Expenses","Groceries",,$88.51,$0.00,C,$4828.34
"Us Bank",,,06/02/2015,"Download from usbank.com. SQ *CUP A JOE COSAN FRANCISCCA","Everyday Expenses:Coffee Shop","Everyday Expenses","Coffee Shop",,$6.47,$0.00,C,$4821.87
"Us Bank",,,06/02/2015,"Download from usbank.com. Acorns.com","Savings Goals:Savings","Savings Goals","Savings",,$9.79,$0.00,C,$4812.08
"Us Bank",,,06/02/2015,"Download from usbank.com. Market MayflowerSan FranciscCA","Everyday Expenses:Spending Money","Everyday Expenses","Spending Money",,$10.86,$0.00,C,$4801.22
"Us Bank",,,06/02/2015,"Download from usbank.com. BETTERMENT","Savings Goals:Savings","Savings Goals","Savings",,$150.00,$0.00,C,$4651.22
"Us Bank",,,06/02/2015,"Download from usbank.com. Mosser Companies","Monthly Bills:Rent","Monthly Bills","Rent",,$1582.72,$0.00,C,$3068.50
"Us Bank",,,06/03/2015,"Download from usbank.com. SQ *WORKSHOP CAFSan FranciscCA","Everyday Expenses:Spending Money","Everyday Expenses","Spending Money",,$4.50,$0.00,C,$3064.00
"Us Bank",,,06/03/2015,"Download from usbank.com. CHEZ FAYALA LLC SAN FRANCISCCA","Everyday Expenses:Spending Money","Everyday Expenses","Spending Money",,$17.98,$0.00,C,$3046.02
"Us Bank",,,06/03/2015,"Download from usbank.com. TREEHOUSE       800-928-2130FL","Monthly Bills:Web Stuff","Monthly Bills","Web Stuff",,$25.00,$0.00,C,$3021.02
"Us Bank",,,06/03/2015,"Download from usbank.com. AMZ*Beautifi4157SAN FRANCISCCA","Everyday Expenses:Spending Money","Everyday Expenses","Spending Money",,$64.90,$0.00,C,$2956.12
"Us Bank",,,06/03/2015,"Download from usbank.com. CLASSPASS.COM CL888-493-5953NY","Everyday Expenses:Spending Money","Everyday Expenses","Spending Money",,$99.00,$0.00,C,$2857.12
"Us Bank",,,06/04/2015,"Download from usbank.com. FOREVER 21.COM  LOS ANGELES CA","Everyday Expenses:Clothing","Everyday Expenses","Clothing",,$0.00,$21.64,C,$2878.76
"Us Bank",,,06/04/2015,"Download from usbank.com. CAFE AMBROSIA   SAN FRANCISCCA","Everyday Expenses:Spending Money","Everyday Expenses","Spending Money",,$3.50,$0.00,C,$2875.26
"Us Bank",,,06/04/2015,"Download from usbank.com. SPOONROCKET.COM 510-921-9929CA","Everyday Expenses:Spending Money","Everyday Expenses","Spending Money",,$5.99,$0.00,C,$2869.27
"Us Bank",,,06/04/2015,"Download from usbank.com. UBER            866-576-1039CA","Everyday Expenses:Transportation","Everyday Expenses","Transportation",,$6.66,$0.00,C,$2862.61
"Us Bank",,,06/04/2015,"Download from usbank.com. Acorns.com","Savings Goals:Savings","Savings Goals","Savings",,$9.43,$0.00,C,$2853.18
"Us Bank",,,06/04/2015,"Download from usbank.com. LIQUID GOLD     SAN FRANCISCCA","Everyday Expenses:Spending Money","Everyday Expenses","Spending Money",,$15.00,$0.00,C,$2838.18
"Us Bank",,,06/04/2015,"Download from usbank.com. CLIPPER SERVICE SAN FRANCISCCA","Everyday Expenses:Transportation","Everyday Expenses","Transportation",,$20.00,$0.00,C,$2818.18
"Us Bank",,,06/04/2015,"Download from usbank.com. TRADER JOE'S #20SAN FRANCISCCA","Everyday Expenses:Groceries","Everyday Expenses","Groceries",,$37.53,$0.00,C,$2780.65
"Us Bank",,,06/04/2015,"Download from usbank.com. MODCLOTH INC.   888-4959699 CA","Everyday Expenses:Clothing","Everyday Expenses","Clothing",,$37.79,$0.00,C,$2742.86
"Us Bank",,,06/05/2015,"Download from usbank.com. MODCLOTH INC","Income:Available this month","Income","Available this month",,$0.00,$1507.85,C,$4250.71
"Us Bank",,,06/05/2015,"Download from usbank.com. SQ *PHILZ COFFEESan FranciscCA","Everyday Expenses:Coffee Shop","Everyday Expenses","Coffee Shop",,$3.00,$0.00,C,$4247.71
"Us Bank",,,06/05/2015,"Download from usbank.com. APL* ITUNES.COM/866-712-7753CA","Everyday Expenses:Spending Money","Everyday Expenses","Spending Money",,$3.99,$0.00,C,$4243.72
"Us Bank",,,06/05/2015,"Download from usbank.com. VENMO","Everyday Expenses:Spending Money","Everyday Expenses","Spending Money",,$10.00,$0.00,C,$4233.72
"Us Bank",,,06/05/2015,"Download from usbank.com. APL* ITUNES.COM/866-712-7753CA","Everyday Expenses:Spending Money","Everyday Expenses","Spending Money",,$44.99,$0.00,C,$4188.73
"Us Bank",,,06/05/2015,"Download from usbank.com. VIRGIN AMER 9842SAN FRANCISCCA","Savings Goals:Vacation & Travel","Savings Goals","Vacation & Travel",,$118.55,$0.00,C,$4070.18
"Us Bank",,,06/05/2015,"Download from usbank.com. VIRGIN AMER 9842SAN FRANCISCCA","Savings Goals:Vacation & Travel","Savings Goals","Vacation & Travel",,$118.55,$0.00,C,$3951.63
"Us Bank",,,06/08/2015,"Download from usbank.com. SOUTHWES    5262800-435-9792TX","Savings Goals:Vacation & Travel","Savings Goals","Vacation & Travel",,$0.00,$177.50,C,$4129.13
"Us Bank",,,06/08/2015,"Download from usbank.com. SOUTHWES    5262800-435-9792TX","Savings Goals:Vacation & Travel","Savings Goals","Vacation & Travel",,$0.00,$177.50,C,$4306.63
"Us Bank",,,06/08/2015,"Download from usbank.com.","Everyday Expenses:Spending Money","Everyday Expenses","Spending Money",,$0.20,$0.00,C,$4306.43
"Us Bank",,,06/08/2015,"Download from usbank.com. SQ *ANOTHER CAFESan FranciscCA","Everyday Expenses:Coffee Shop","Everyday Expenses","Coffee Shop",,$3.95,$0.00,C,$4302.48
"Us Bank",,,06/08/2015,"Download from usbank.com. SQ *BOB'S DONUTSSan FranciscCA","Everyday Expenses:Spending Money","Everyday Expenses","Spending Money",,$4.00,$0.00,C,$4298.48
"Us Bank",,,06/08/2015,"Download from usbank.com. SOUTHWES    5262800-435-9792TX","Savings Goals:Vacation & Travel","Savings Goals","Vacation & Travel",,$5.60,$0.00,C,$4292.88
"Us Bank",,,06/08/2015,"Download from usbank.com. Acorns.com","Savings Goals:Savings","Savings Goals","Savings",,$6.15,$0.00,C,$4286.73
"Us Bank",,,06/08/2015,"Download from usbank.com. CVS 10189       SAN FRANCISCCA","Everyday Expenses:Household Goods","Everyday Expenses","Household Goods",,$6.69,$0.00,C,$4280.04
"Us Bank",,,06/08/2015,"Download from usbank.com. UBER            866-576-1039CA","Everyday Expenses:Transportation","Everyday Expenses","Transportation",,$7.00,$0.00,C,$4273.04
"Us Bank",,,06/08/2015,"Download from usbank.com. SQ *ANOTHER CAFESan FranciscCA","Everyday Expenses:Coffee Shop","Everyday Expenses","Coffee Shop",,$8.59,$0.00,C,$4264.45
"Us Bank",,,06/08/2015,"Download from usbank.com. BITE            SAN FRANCISCCA","Everyday Expenses:Spending Money","Everyday Expenses","Spending Money",,$9.23,$0.00,C,$4255.22
"Us Bank",,,06/08/2015,"Download from usbank.com. GHOST PERSONAL  +44207224282","Monthly Bills:Web Stuff","Monthly Bills","Web Stuff",,$10.00,$0.00,C,$4245.22
"Us Bank",,,06/08/2015,"Download from usbank.com. PAYPAL","Everyday Expenses:Coffee Shop","Everyday Expenses","Coffee Shop",,$10.00,$0.00,C,$4235.22
"Us Bank",,,06/08/2015,"Download from usbank.com. PAYPAL","Everyday Expenses:Coffee Shop","Everyday Expenses","Coffee Shop",,$10.00,$0.00,C,$4225.22
"Us Bank",,,06/08/2015,"Download from usbank.com. TOPSYS FUNHOUSE SAN FRANCISCCA","Everyday Expenses:Spending Money","Everyday Expenses","Spending Money",,$15.05,$0.00,C,$4210.17
"Us Bank",,,06/08/2015,"Download from usbank.com. SQ *ANOTHER CAFESan FranciscCA","Everyday Expenses:Spending Money","Everyday Expenses","Spending Money",,$23.50,$0.00,C,$4186.67
"Us Bank",,,06/08/2015,"Download from usbank.com. WALGREENS 1300 BSAN FRANCISCCA","Everyday Expenses:Household Goods","Everyday Expenses","Household Goods",,$25.51,$0.00,C,$4161.16
"Us Bank",,,06/08/2015,"Download from usbank.com. BEST LIL PORK HOALAMEDA     CA","Everyday Expenses:Spending Money","Everyday Expenses","Spending Money",,$25.84,$0.00,C,$4135.32
"Us Bank",,,06/08/2015,"Download from usbank.com. TRADER JOE'S #20SAN FRANCISCCA","Everyday Expenses:Groceries","Everyday Expenses","Groceries",,$35.60,$0.00,C,$4099.72
"Us Bank",,,06/08/2015,"Download from usbank.com. HOGWASH         415-3615500 CA","Everyday Expenses:Spending Money","Everyday Expenses","Spending Money",,$67.72,$0.00,C,$4032.00
"Us Bank",,,06/08/2015,"Download from usbank.com. INSTACART       910-817-2278CA","Everyday Expenses:Groceries","Everyday Expenses","Groceries",,$82.78,$0.00,C,$3949.22
"Us Bank",,,06/08/2015,"Download from usbank.com. SOUTHWES    5262800-435-9792TX","Savings Goals:Vacation & Travel","Savings Goals","Vacation & Travel",,$177.50,$0.00,C,$3771.72
"Us Bank",,,06/08/2015,"Download from usbank.com. 7246","Debt:Eric's Credit Card","Debt","Eric's Credit Card",,$300.00,$0.00,C,$3471.72
"Us Bank",,,06/08/2015,"Download from usbank.com. SOUTHWES    5262800-435-9792TX","Savings Goals:Vacation & Travel","Savings Goals","Vacation & Travel",,$355.00,$0.00,C,$3116.72
"Us Bank",,,06/08/2015,"Download from usbank.com. BETTERMENT","Savings Goals:Savings","Savings Goals","Savings",,$400.00,$0.00,C,$2716.72
"Us Bank",,,06/09/2015,"Download from usbank.com. COACHUSA/MEGABUSWWW.MEGABUS.NJ","Everyday Expenses:Spending Money","Everyday Expenses","Spending Money",,$7.50,$0.00,C,$2709.22
"Us Bank",,,06/09/2015,"Download from usbank.com. CHIPOTLE 1857   SAN FRANCISCCA","Everyday Expenses:Spending Money","Everyday Expenses","Spending Money",,$7.56,$0.00,C,$2701.66
"Us Bank",,,06/09/2015,"Download from usbank.com. AMC VAN NESS 14 SAN FRANCISCCA","Everyday Expenses:Spending Money","Everyday Expenses","Spending Money",,$10.98,$0.00,C,$2690.68
"Us Bank",,,06/09/2015,"Download from usbank.com. Audible US      888-283-5051NJ","Monthly Bills:Web Stuff","Monthly Bills","Web Stuff",,$15.87,$0.00,C,$2674.81
"Us Bank",,,06/09/2015,"Download from usbank.com. UPOUT INC      415-517-8565CA","Everyday Expenses:Spending Money","Everyday Expenses","Spending Money",,$20.00,$0.00,C,$2654.81
"Us Bank",,,06/09/2015,"Download from usbank.com. US BANK SAN FRANSAN FRANCISCCAUS1","Everyday Expenses:Spending Money","Everyday Expenses","Spending Money",,$40.00,$0.00,C,$2614.81
"Us Bank",,,06/09/2015,"Download from usbank.com. MISSION ROCK RESSAN FRANCISCCA","Everyday Expenses:Spending Money","Everyday Expenses","Spending Money",,$79.65,$0.00,C,$2535.16
"Us Bank",,,06/09/2015,"Download from usbank.com. AIRBNB INC      415-800-5959CA","Savings Goals:Vacation & Travel","Savings Goals","Vacation & Travel",,$280.00,$0.00,C,$2255.16
"Us Bank",,,06/10/2015,"Download from usbank.com. UBER            866-576-1039CA","Everyday Expenses:Transportation","Everyday Expenses","Transportation",,$6.00,$0.00,C,$2249.16
"Us Bank",,,06/10/2015,"Download from usbank.com. UBER            866-576-1039CA","Everyday Expenses:Transportation","Everyday Expenses","Transportation",,$6.91,$0.00,C,$2242.25
"Us Bank",,,06/10/2015,"Download from usbank.com. VENMO","Everyday Expenses:Spending Money","Everyday Expenses","Spending Money",,$7.00,$0.00,C,$2235.25
"Us Bank",,,06/10/2015,"Download from usbank.com. CHIPOTLE 1857   SAN FRANCISCCA","Everyday Expenses:Spending Money","Everyday Expenses","Spending Money",,$7.56,$0.00,C,$2227.69
"Us Bank",,,06/10/2015,"Download from usbank.com. HARROW          SAN FRANCISCCA","Everyday Expenses:Spending Money","Everyday Expenses","Spending Money",,$11.00,$0.00,C,$2216.69
"Us Bank",,,06/10/2015,"Download from usbank.com. Acorns.com","Savings Goals:Savings","Savings Goals","Savings",,$11.71,$0.00,C,$2204.98
"Us Bank",,,06/10/2015,"Download from usbank.com. HOTEL UTAH SALOOSAN FRANCISCCA","Everyday Expenses:Spending Money","Everyday Expenses","Spending Money",,$66.00,$0.00,C,$2138.98
"Us Bank",,,06/11/2015,"Download from usbank.com. SUTTER FINE FOODSAN FRANCISCCA","Everyday Expenses:Groceries","Everyday Expenses","Groceries",,$9.98,$0.00,C,$2129.00
"Us Bank",,,06/11/2015,"Download from usbank.com. AYOLA (KEARNY)  SAN FRANCISCCA","Everyday Expenses:Spending Money","Everyday Expenses","Spending Money",,$10.82,$0.00,C,$2118.18
"Us Bank",,,06/12/2015,"Download from usbank.com. Amazon Video On 866-216-1072WA","Everyday Expenses:Spending Money","Everyday Expenses","Spending Money",,$3.99,$0.00,C,$2114.19
"Us Bank",,,06/12/2015,"Download from usbank.com. APL* ITUNES.COM/866-712-7753CA","Everyday Expenses:Spending Money","Everyday Expenses","Spending Money",,$3.99,$0.00,C,$2110.20
"Us Bank",,,06/12/2015,"Download from usbank.com. FLY             SAN FRANCISCCA","Everyday Expenses:Spending Money","Everyday Expenses","Spending Money",,$8.00,$0.00,C,$2102.20
"Us Bank",,,06/12/2015,"Download from usbank.com. SQ *ANOTHER CAFESan FranciscCA","Everyday Expenses:Coffee Shop","Everyday Expenses","Coffee Shop",,$10.82,$0.00,C,$2091.38
"Us Bank",,,06/12/2015,"Download from usbank.com. WALGREENS 1300 BSAN FRANCISCCA","Everyday Expenses:Household Goods","Everyday Expenses","Household Goods",,$18.47,$0.00,C,$2072.91
"Us Bank",,,06/12/2015,"Download from usbank.com. TRADER JOE'S #20SAN FRANCISCCA","Everyday Expenses:Groceries","Everyday Expenses","Groceries",,$27.96,$0.00,C,$2044.95
"Us Bank",,,06/12/2015,"Download from usbank.com. SIX FLAGS CORPOR321-249-0110TX","Everyday Expenses:Spending Money","Everyday Expenses","Spending Money",,$168.83,$0.00,C,$1876.12
"Us Bank",,,06/15/2015,"Download from usbank.com. SQWIGGLE INC","Income:Available this month","Income","Available this month",,$0.00,$1798.57,C,$3674.69
"Us Bank",,,06/15/2015,"Download from usbank.com. VENMO","Everyday Expenses:Spending Money","Everyday Expenses","Spending Money",,$0.00,$66.90,C,$3741.59
"Us Bank",,,06/15/2015,"Download from usbank.com. PAYPAL","Everyday Expenses:Spending Money","Everyday Expenses","Spending Money",,$0.00,$64.73,C,$3806.32
"Us Bank",,,06/15/2015,"Download from usbank.com. SIX FLAGS DISCOVVALLEJO     CA","Everyday Expenses:Spending Money","Everyday Expenses","Spending Money",,$3.25,$0.00,C,$3803.07
"Us Bank",,,06/15/2015,"Download from usbank.com. SQ *CESCO PIZZA San FranciscCA","Everyday Expenses:Spending Money","Everyday Expenses","Spending Money",,$4.35,$0.00,C,$3798.72
"Us Bank",,,06/15/2015,"Download from usbank.com. AYOLA (KEARNY)  SAN FRANCISCCA","Everyday Expenses:Spending Money","Everyday Expenses","Spending Money",,$8.16,$0.00,C,$3790.56
"Us Bank",,,06/15/2015,"Download from usbank.com. SQ *CESCO PIZZA San FranciscCA","Everyday Expenses:Spending Money","Everyday Expenses","Spending Money",,$8.70,$0.00,C,$3781.86
"Us Bank",,,06/15/2015,"Download from usbank.com. WORKING GIRLS CASAN FRANCISCCA","Everyday Expenses:Spending Money","Everyday Expenses","Spending Money",,$9.95,$0.00,C,$3771.91
"Us Bank",,,06/15/2015,"Download from usbank.com. STARBUCKS CARD R800-782-7282WA","Everyday Expenses:Coffee Shop","Everyday Expenses","Coffee Shop",,$10.00,$0.00,C,$3761.91
"Us Bank",,,06/15/2015,"Download from usbank.com. TARGET T3201    SAN FRANCISCCA---- You Requested $10.00 in Cash Back","Everyday Expenses:Household Goods","Everyday Expenses","Household Goods",,$11.22,$0.00,C,$3750.69
"Us Bank",,,06/15/2015,"Download from usbank.com. SIX FLAGS DISCOVVALLEJO     CA","Everyday Expenses:Spending Money","Everyday Expenses","Spending Money",,$11.39,$0.00,C,$3739.30
"Us Bank",,,06/15/2015,"Download from usbank.com. Audible         888-283-5051NJ","Monthly Bills:Web Stuff","Monthly Bills","Web Stuff",,$14.95,$0.00,C,$3724.35
"Us Bank",,,06/15/2015,"Download from usbank.com. SLIDERS DINER   SAN FRANCISCCA","Everyday Expenses:Spending Money","Everyday Expenses","Spending Money",,$18.49,$0.00,C,$3705.86
"Us Bank",,,06/15/2015,"Download from usbank.com. CORIANDER GOURMESAN FRANCISCCA","Everyday Expenses:Spending Money","Everyday Expenses","Spending Money",,$20.31,$0.00,C,$3685.55
"Us Bank",,,06/15/2015,"Download from usbank.com. SIX FLAGS DISCOVVALLEJO     CA","Everyday Expenses:Spending Money","Everyday Expenses","Spending Money",,$21.70,$0.00,C,$3663.85
"Us Bank",,,06/15/2015,"Download from usbank.com. SIX FLAGS DISCOVVALLEJO     CA","Everyday Expenses:Spending Money","Everyday Expenses","Spending Money",,$21.70,$0.00,C,$3642.15
"Us Bank",,,06/15/2015,"Download from usbank.com. DISCOUNT CENTER SAN FRANCISCCA","Everyday Expenses:Spending Money","Everyday Expenses","Spending Money",,$25.86,$0.00,C,$3616.29
"Us Bank",,,06/15/2015,"Download from usbank.com. WALGREENS 1300 BSAN FRANCISCCA","Everyday Expenses:Household Goods","Everyday Expenses","Household Goods",,$45.10,$0.00,C,$3571.19
"Us Bank",,,06/15/2015,"Download from usbank.com. MODCLOTH INC.   888-4959699 CA","Everyday Expenses:Clothing","Everyday Expenses","Clothing",,$68.82,$0.00,C,$3502.37
"Us Bank",,,06/15/2015,"Download from usbank.com. SIX FLAGS DISCOVVALLEJO     CA","Everyday Expenses:Spending Money","Everyday Expenses","Spending Money",,$100.00,$0.00,C,$3402.37
"Us Bank",,,06/16/2015,"Download from usbank.com. LYFT   *RIDE SUN855-280-0278CA","Everyday Expenses:Transportation","Everyday Expenses","Transportation",,$6.00,$0.00,C,$3396.37
"Us Bank",,,06/16/2015,"Download from usbank.com. Acorns.com","Savings Goals:Savings","Savings Goals","Savings",,$6.67,$0.00,C,$3389.70
"Us Bank",,,06/16/2015,"Download from usbank.com. Coffee Bar BryanSan FranciscCA","Everyday Expenses:Coffee Shop","Everyday Expenses","Coffee Shop",,$6.70,$0.00,C,$3383.00
"Us Bank",,,06/16/2015,"Download from usbank.com. CHIPOTLE 1857   SAN FRANCISCCA","Everyday Expenses:Spending Money","Everyday Expenses","Spending Money",,$7.56,$0.00,C,$3375.44
"Us Bank",,,06/16/2015,"Download from usbank.com. CHEZ FAYALA LLC SAN FRANCISCCA","Everyday Expenses:Spending Money","Everyday Expenses","Spending Money",,$9.65,$0.00,C,$3365.79
"Us Bank",,,06/16/2015,"Download from usbank.com. Coffee Bar BryanSan FranciscCA","Everyday Expenses:Coffee Shop","Everyday Expenses","Coffee Shop",,$10.08,$0.00,C,$3355.71
"Us Bank",,,06/16/2015,"Download from usbank.com. DOLCE GELATO    SAN FRANCISCCA","Everyday Expenses:Spending Money","Everyday Expenses","Spending Money",,$17.38,$0.00,C,$3338.33
"Us Bank",,,06/16/2015,"Download from usbank.com. BERETTA         SAN FRANCISCCA","Everyday Expenses:Spending Money","Everyday Expenses","Spending Money",,$72.21,$0.00,C,$3266.12
"Us Bank",,,06/16/2015,"Download from usbank.com. BETTERMENT","Savings Goals:Savings","Savings Goals","Savings",,$150.00,$0.00,C,$3116.12
"Us Bank",,,06/17/2015,"Download from usbank.com. SQ *WORKSHOP CAFSan FranciscCA","Everyday Expenses:Spending Money","Everyday Expenses","Spending Money",,$4.50,$0.00,C,$3111.62
"Us Bank",,,06/17/2015,"Download from usbank.com. LYFT   *RIDE SUN855-280-0278CA","Everyday Expenses:Transportation","Everyday Expenses","Transportation",,$6.00,$0.00,C,$3105.62
"Us Bank",,,06/17/2015,"Download from usbank.com. SQ *WORKSHOP CAFSan FranciscCA","Everyday Expenses:Spending Money","Everyday Expenses","Spending Money",,$7.00,$0.00,C,$3098.62
"Us Bank",,,06/17/2015,"Download from usbank.com. SUTTER FINE FOODSAN FRANCISCCA","Everyday Expenses:Groceries","Everyday Expenses","Groceries",,$13.69,$0.00,C,$3084.93
"Us Bank",,,06/18/2015,"Download from usbank.com. SQ *BLUE BOTTLE San FranciscCA","Everyday Expenses:Coffee Shop","Everyday Expenses","Coffee Shop",,$3.00,$0.00,C,$3081.93
"Us Bank",,,06/18/2015,"Download from usbank.com. Acorns.com","Savings Goals:Savings","Savings Goals","Savings",,$9.72,$0.00,C,$3072.21
"Us Bank",,,06/18/2015,"Download from usbank.com. MURPHYS         SAN FRANCISCCA","Everyday Expenses:Spending Money","Everyday Expenses","Spending Money",,$14.50,$0.00,C,$3057.71
"Us Bank",,,06/18/2015,"Download from usbank.com. CLASSPASS.COM   888-493-5953NY","Everyday Expenses:Transportation","Everyday Expenses","Transportation",,$15.00,$0.00,C,$3042.71
"Us Bank",,,06/18/2015,"Download from usbank.com. Amazon.com      AMZN.COM/BILWA","Everyday Expenses:Spending Money","Everyday Expenses","Spending Money",,$31.80,$0.00,C,$3010.91
"Us Bank",,,06/18/2015,"Download from usbank.com. MODCLOTH INC.   888-4959699 CA","Everyday Expenses:Clothing","Everyday Expenses","Clothing",,$64.73,$0.00,C,$2946.18
"Us Bank",,,06/18/2015,"Download from usbank.com. OLD NAVY USA    San FranciscCA","Everyday Expenses:Clothing","Everyday Expenses","Clothing",,$82.13,$0.00,C,$2864.05
"Us Bank",,,06/18/2015,"Download from usbank.com. DAVIDS BRIDAL ON866-9730238 PA","Everyday Expenses:Clothing","Everyday Expenses","Clothing",,$164.43,$0.00,C,$2699.62
"Us Bank",,,06/19/2015,"Download from usbank.com. MODCLOTH INC","Income:Available this month","Income","Available this month",,$0.00,$1491.61,C,$4191.23
"Us Bank",,,06/19/2015,"Download from usbank.com. SQ *WORKSHOP CAFSan FranciscCA","Everyday Expenses:Spending Money","Everyday Expenses","Spending Money",,$2.25,$0.00,C,$4188.98
"Us Bank",,,06/19/2015,"Download from usbank.com. FRESHROLL       SAN FRANCISCCA","Everyday Expenses:Spending Money","Everyday Expenses","Spending Money",,$9.51,$0.00,C,$4179.47
"Us Bank",,,06/19/2015,"Download from usbank.com. AYOLA (KEARNY)  SAN FRANCISCCA","Everyday Expenses:Spending Money","Everyday Expenses","Spending Money",,$9.73,$0.00,C,$4169.74
"Us Bank",,,06/19/2015,"Download from usbank.com. PAYPAL","Everyday Expenses:Spending Money","Everyday Expenses","Spending Money",,$9.99,$0.00,C,$4159.75
"Us Bank",,,06/19/2015,"Download from usbank.com. FLY             SAN FRANCISCCA","Everyday Expenses:Spending Money","Everyday Expenses","Spending Money",,$10.60,$0.00,C,$4149.15
"Us Bank",,,06/19/2015,"Download from usbank.com. FEIST WINES     FEIST.MYSHOPCA","Everyday Expenses:Spending Money","Everyday Expenses","Spending Money",,$53.75,$0.00,C,$4095.40
"Us Bank",,,06/19/2015,"Download from usbank.com. TARGET T3201    SAN FRANCISCCA---- You Requested $40.00 in Cash Back","Everyday Expenses:Household Goods","Everyday Expenses","Household Goods",,$72.76,$0.00,C,$4022.64
"Us Bank",,,06/19/2015,"Download from usbank.com. FOOTLOCKER      800-9916815 WI","Everyday Expenses:Clothing","Everyday Expenses","Clothing",,$76.11,$0.00,C,$3946.53
"Us Bank",,,06/19/2015,"Download from usbank.com. ATT","Monthly Bills:Cell Phone","Monthly Bills","Cell Phone",,$142.71,$0.00,C,$3803.82
"Us Bank",,,06/22/2015,"Download from usbank.com.","Everyday Expenses:Spending Money","Everyday Expenses","Spending Money",,$0.00,$6.95,C,$3810.77
"Us Bank",,,06/22/2015,"Download from usbank.com. TARGET T3201    SAN FRANCISCCA","Everyday Expenses:Household Goods","Everyday Expenses","Household Goods",,$2.09,$0.00,C,$3808.68
"Us Bank",,,06/22/2015,"Download from usbank.com. Amazon Video On 866-216-1072WA","Everyday Expenses:Spending Money","Everyday Expenses","Spending Money",,$3.99,$0.00,C,$3804.69
"Us Bank",,,06/22/2015,"Download from usbank.com. SQ *WORKSHOP CAFSan FranciscCA","Everyday Expenses:Spending Money","Everyday Expenses","Spending Money",,$4.50,$0.00,C,$3800.19
"Us Bank",,,06/22/2015,"Download from usbank.com. SQ *WORKSHOP CAFSan FranciscCA","Everyday Expenses:Spending Money","Everyday Expenses","Spending Money",,$4.75,$0.00,C,$3795.44
"Us Bank",,,06/22/2015,"Download from usbank.com.","Everyday Expenses:Spending Money","Everyday Expenses","Spending Money",,$6.95,$0.00,C,$3788.49
"Us Bank",,,06/22/2015,"Download from usbank.com. CHIPOTLE 1857   SAN FRANCISCCA","Everyday Expenses:Spending Money","Everyday Expenses","Spending Money",,$7.56,$0.00,C,$3780.93
"Us Bank",,,06/22/2015,"Download from usbank.com. SQ *BLUE BOTTLE San FranciscCA","Everyday Expenses:Coffee Shop","Everyday Expenses","Coffee Shop",,$9.00,$0.00,C,$3771.93
"Us Bank",,,06/22/2015,"Download from usbank.com. THE FOX THEATER BERKELEY    CA","Everyday Expenses:Spending Money","Everyday Expenses","Spending Money",,$9.00,$0.00,C,$3762.93
"Us Bank",,,06/22/2015,"Download from usbank.com. SPOONROCKET.COM 510-921-9929CA","Everyday Expenses:Spending Money","Everyday Expenses","Spending Money",,$9.60,$0.00,C,$3753.33
"Us Bank",,,06/22/2015,"Download from usbank.com. CHEZ FAYALA LLC SAN FRANCISCCA","Everyday Expenses:Spending Money","Everyday Expenses","Spending Money",,$9.78,$0.00,C,$3743.55
"Us Bank",,,06/22/2015,"Download from usbank.com. PAYPAL","Monthly Bills:Web Stuff","Monthly Bills","Web Stuff",,$9.99,$0.00,C,$3733.56
"Us Bank",,,06/22/2015,"Download from usbank.com. SQ *BLUE BOTTLE San FranciscCA","Everyday Expenses:Coffee Shop","Everyday Expenses","Coffee Shop",,$10.00,$0.00,C,$3723.56
"Us Bank",,,06/22/2015,"Download from usbank.com. THE FOX THEATER BERKELEY    CA","Everyday Expenses:Spending Money","Everyday Expenses","Spending Money",,$10.00,$0.00,C,$3713.56
"Us Bank",,,06/22/2015,"Download from usbank.com. THE MELT-EMBARCASAN FRANCISCCA","Everyday Expenses:Spending Money","Everyday Expenses","Spending Money",,$10.07,$0.00,C,$3703.49
"Us Bank",,,06/22/2015,"Download from usbank.com. SUTTER FINE FOODSAN FRANCISCCA","Everyday Expenses:Groceries","Everyday Expenses","Groceries",,$13.04,$0.00,C,$3690.45
"Us Bank",,,06/22/2015,"Download from usbank.com. BART-CLIPPER MONSAN FRANCISCCA","Everyday Expenses:Transportation","Everyday Expenses","Transportation",,$17.05,$0.00,C,$3673.40
"Us Bank",,,06/22/2015,"Download from usbank.com. PAPA JOHN'S #043415-440-7272CA","Everyday Expenses:Spending Money","Everyday Expenses","Spending Money",,$17.93,$0.00,C,$3655.47
"Us Bank",,,06/22/2015,"Download from usbank.com. PAYPAL","Everyday Expenses:Spending Money","Everyday Expenses","Spending Money",,$20.00,$0.00,C,$3635.47
"Us Bank",,,06/22/2015,"Download from usbank.com. WALGREENS 459 POSAN FRANCISCCA---- You Requested $20.00 in Cash Back","Everyday Expenses:Household Goods","Everyday Expenses","Household Goods",,$23.30,$0.00,C,$3612.17
"Us Bank",,,06/22/2015,"Download from usbank.com. KATANA-YA       SAN FRANCISCCA","Everyday Expenses:Spending Money","Everyday Expenses","Spending Money",,$25.73,$0.00,C,$3586.44
"Us Bank",,,06/22/2015,"Download from usbank.com. THE FOX THEATER BERKELEY    CA","Everyday Expenses:Spending Money","Everyday Expenses","Spending Money",,$32.00,$0.00,C,$3554.44
"Us Bank",,,06/22/2015,"Download from usbank.com. TRADER JOE'S #20SAN FRANCISCCA","Everyday Expenses:Groceries","Everyday Expenses","Groceries",,$85.91,$0.00,C,$3468.53
"Us Bank",,,06/22/2015,"Download from usbank.com. AIRBNB INC      415-800-5959CA","Savings Goals:Vacation & Travel","Savings Goals","Vacation & Travel",,$190.00,$0.00,C,$3278.53
"Us Bank",,,06/22/2015,"Download from usbank.com. COMCAST","Monthly Bills:Internet","Monthly Bills","Internet",,$238.24,$0.00,C,$3040.29
"Us Bank",,,06/23/2015,"Download from usbank.com. OLD NAVY #5934  SAN FRANCISCCA","Everyday Expenses:Spending Money","Everyday Expenses","Spending Money",,$0.00,$5.67,C,$3045.96
"Us Bank",,,06/23/2015,"Download from usbank.com. SQ *WORKSHOP CAFSan FranciscCA","Everyday Expenses:Spending Money","Everyday Expenses","Spending Money",,$6.00,$0.00,C,$3039.96
"Us Bank",,,06/23/2015,"Download from usbank.com. CHIPOTLE 1857   SAN FRANCISCCA","Everyday Expenses:Spending Money","Everyday Expenses","Spending Money",,$7.56,$0.00,C,$3032.40
"Us Bank",,,06/23/2015,"Download from usbank.com. Acorns.com","Savings Goals:Savings","Savings Goals","Savings",,$8.00,$0.00,C,$3024.40
"Us Bank",,,06/23/2015,"Download from usbank.com. PAYPAL","Monthly Bills:Web Stuff","Monthly Bills","Web Stuff",,$9.99,$0.00,C,$3014.41
"Us Bank",,,06/23/2015,"Download from usbank.com. Spotify USA     877-778-1161NY","Monthly Bills:Web Stuff","Monthly Bills","Web Stuff",,$9.99,$0.00,C,$3004.42
"Us Bank",,,06/23/2015,"Download from usbank.com. Amazon.com      AMZN.COM/BILWA","Everyday Expenses:Misc","Everyday Expenses","Misc",,$575.29,$0.00,C,$2429.13
"Us Bank",,,06/24/2015,"Download from usbank.com. BELLISSIMO PIZZASAN FRANCISCCA","Everyday Expenses:Spending Money","Everyday Expenses","Spending Money",,$7.00,$0.00,C,$2422.13
"Us Bank",,,06/24/2015,"Download from usbank.com. BAMBOO ASIA     SAN FRANCISCCA","Everyday Expenses:Spending Money","Everyday Expenses","Spending Money",,$9.73,$0.00,C,$2412.40
"Us Bank",,,06/24/2015,"Download from usbank.com. STARBUCKS CARD R800-782-7282WA","Everyday Expenses:Coffee Shop","Everyday Expenses","Coffee Shop",,$10.00,$0.00,C,$2402.40
"Us Bank",,,06/24/2015,"Download from usbank.com. SQ *ANOTHER CAFESan FranciscCA","Everyday Expenses:Coffee Shop","Everyday Expenses","Coffee Shop",,$10.82,$0.00,C,$2391.58
"Us Bank",,,06/24/2015,"Download from usbank.com. STEFFS          SAN FRANCISCCA","Everyday Expenses:Spending Money","Everyday Expenses","Spending Money",,$16.00,$0.00,C,$2375.58
"Us Bank",,,06/24/2015,"Download from usbank.com. FLY             SAN FRANCISCCA","Everyday Expenses:Spending Money","Everyday Expenses","Spending Money",,$19.94,$0.00,C,$2355.64
"Us Bank",,,06/24/2015,"Download from usbank.com. STEFFS          SAN FRANCISCCA","Everyday Expenses:Spending Money","Everyday Expenses","Spending Money",,$24.00,$0.00,C,$2331.64
"Us Bank",,,06/24/2015,"Download from usbank.com. PUBLIC BARBER SASAN FRANCISCCA","Everyday Expenses:Spending Money","Everyday Expenses","Spending Money",,$39.00,$0.00,C,$2292.64
"Us Bank",,,06/24/2015,"Download from usbank.com. SONGBIRD STUDIOSSAN FRANCISCCA","Everyday Expenses:Misc","Everyday Expenses","Misc",,$67.50,$0.00,C,$2225.14
"Us Bank",,,06/25/2015,"Download from usbank.com. LYFT   *RIDE WED855-280-0278CA","Everyday Expenses:Transportation","Everyday Expenses","Transportation",,$6.00,$0.00,C,$2219.14
"Us Bank",,,06/25/2015,"Download from usbank.com. LYFT   *RIDE MON855-280-0278CA","Everyday Expenses:Transportation","Everyday Expenses","Transportation",,$6.16,$0.00,C,$2212.98
"Us Bank",,,06/25/2015,"Download from usbank.com. HLU*Hulu 2274453HULU.COM/BILCA","Monthly Bills:Web Stuff","Monthly Bills","Web Stuff",,$7.99,$0.00,C,$2204.99
"Us Bank",,,06/25/2015,"Download from usbank.com. MILLER'S EAST COSAN FRANCISCCA","Everyday Expenses:Spending Money","Everyday Expenses","Spending Money",,$13.05,$0.00,C,$2191.94
"Us Bank",,,06/25/2015,"Download from usbank.com. PINCHES TACOS-LALAS VEGAS   NV","Everyday Expenses:Spending Money","Everyday Expenses","Spending Money",,$17.25,$0.00,C,$2174.69
"Us Bank",,,06/25/2015,"Download from usbank.com. DOLCE GELATO    SAN FRANCISCCA","Everyday Expenses:Spending Money","Everyday Expenses","Spending Money",,$17.58,$0.00,C,$2157.11
"Us Bank",,,06/26/2015,"Download from usbank.com. Sqwiggle Inc.","Everyday Expenses:Spending Money","Everyday Expenses","Spending Money",,$0.00,$44.99,C,$2202.10
"Us Bank",,,06/26/2015,"Download from usbank.com. SQ *WORKSHOP CAFSan FranciscCA","Everyday Expenses:Spending Money","Everyday Expenses","Spending Money",,$5.00,$0.00,C,$2197.10
"Us Bank",,,06/26/2015,"Download from usbank.com. SUSHI TOSUKI    SAN FRANCISCCA","Everyday Expenses:Spending Money","Everyday Expenses","Spending Money",,$7.60,$0.00,C,$2189.50
"Us Bank",,,06/26/2015,"Download from usbank.com. Acorns.com","Savings Goals:Savings","Savings Goals","Savings",,$9.18,$0.00,C,$2180.32
"Us Bank",,,06/26/2015,"Download from usbank.com. GROUPON INC     877-788-7858IL","Everyday Expenses:Spending Money","Everyday Expenses","Spending Money",,$12.00,$0.00,C,$2168.32
"Us Bank",,,06/26/2015,"Download from usbank.com. SQ *WORKSHOP CAFSan FranciscCA","Everyday Expenses:Spending Money","Everyday Expenses","Spending Money",,$15.00,$0.00,C,$2153.32
"Us Bank",,,06/26/2015,"Download from usbank.com. GUITAR CENTER #2SAN FRANCISCCA","Everyday Expenses:Spending Money","Everyday Expenses","Spending Money",,$25.00,$0.00,C,$2128.32
"Us Bank",,,06/29/2015,"Download from usbank.com. VENMO","Everyday Expenses:Spending Money","Everyday Expenses","Spending Money",,$0.00,$52.00,C,$2180.32
"Us Bank",,,06/29/2015,"Download from usbank.com. VICTORIA'S SECRESAN FRANCISCCA","Everyday Expenses:Clothing","Everyday Expenses","Clothing",,$0.00,$35.89,C,$2216.21
"Us Bank",,,06/29/2015,"Download from usbank.com. SQ *WORKSHOP CAFSan FranciscCA","Everyday Expenses:Spending Money","Everyday Expenses","Spending Money",,$2.25,$0.00,C,$2213.96
"Us Bank",,,06/29/2015,"Download from usbank.com. THE POSH BAGEL  SAN FRANCISCCA","Everyday Expenses:Spending Money","Everyday Expenses","Spending Money",,$5.50,$0.00,C,$2208.46
"Us Bank",,,06/29/2015,"Download from usbank.com. LYFT   *RIDE WED855-280-0278CA","Everyday Expenses:Transportation","Everyday Expenses","Transportation",,$6.00,$0.00,C,$2202.46
"Us Bank",,,06/29/2015,"Download from usbank.com. SQ *BLUE BOTTLE San FranciscCA","Everyday Expenses:Coffee Shop","Everyday Expenses","Coffee Shop",,$8.50,$0.00,C,$2193.96
"Us Bank",,,06/29/2015,"Download from usbank.com. WORKING GIRLS CASAN FRANCISCCA","Everyday Expenses:Spending Money","Everyday Expenses","Spending Money",,$9.95,$0.00,C,$2184.01
"Us Bank",,,06/29/2015,"Download from usbank.com. TARGET T2766    SAN FRANCISCCA","Savings Goals:House Stuff","Savings Goals","House Stuff",,$11.72,$0.00,C,$2172.29
"Us Bank",,,06/29/2015,"Download from usbank.com. IL CANE ROSSO   SAN FRANCISCCA","Everyday Expenses:Spending Money","Everyday Expenses","Spending Money",,$11.96,$0.00,C,$2160.33
"Us Bank",,,06/29/2015,"Download from usbank.com. GOTT'S ROADSIDE SAINT HELENACA","Everyday Expenses:Spending Money","Everyday Expenses","Spending Money",,$14.97,$0.00,C,$2145.36
"Us Bank",,,06/29/2015,"Download from usbank.com. SQ *UPCIDER     San FranciscCA","Everyday Expenses:Spending Money","Everyday Expenses","Spending Money",,$15.14,$0.00,C,$2130.22
"Us Bank",,,06/29/2015,"Download from usbank.com. SQ *UPCIDER     San FranciscCA","Everyday Expenses:Spending Money","Everyday Expenses","Spending Money",,$17.31,$0.00,C,$2112.91
"Us Bank",,,06/29/2015,"Download from usbank.com. SUTTER FINE FOODSAN FRANCISCCA","Everyday Expenses:Groceries","Everyday Expenses","Groceries",,$21.76,$0.00,C,$2091.15
"Us Bank",,,06/29/2015,"Download from usbank.com. COLE HARDWARE   SAN FRANCISCCA","Everyday Expenses:Household Goods","Everyday Expenses","Household Goods",,$27.18,$0.00,C,$2063.97
"Us Bank",,,06/29/2015,"Download from usbank.com. SUNDANCE KBB    SAN FRANCISCCA","Everyday Expenses:Spending Money","Everyday Expenses","Spending Money",,$28.10,$0.00,C,$2035.87
"Us Bank",,,06/29/2015,"Download from usbank.com. TRADER JOE'S #20SAN FRANCISCCA","Everyday Expenses:Groceries","Everyday Expenses","Groceries",,$29.89,$0.00,C,$2005.98
"Us Bank",,,06/29/2015,"Download from usbank.com. MILLION THAI RESSAN FRANCISCCA","Everyday Expenses:Spending Money","Everyday Expenses","Spending Money",,$30.12,$0.00,C,$1975.86
"Us Bank",,,06/29/2015,"Download from usbank.com. SUNDANCE KAB    818-889-8562CA","Everyday Expenses:Spending Money","Everyday Expenses","Spending Money",,$32.00,$0.00,C,$1943.86
"Us Bank",,,06/29/2015,"Download from usbank.com. VICTORIA'S SECRESAN FRANCISCCA","Everyday Expenses:Clothing","Everyday Expenses","Clothing",,$35.89,$0.00,C,$1907.97
"Us Bank",,,06/29/2015,"Download from usbank.com. GUITAR CENTER #2SAN FRANCISCCA","Everyday Expenses:Spending Money","Everyday Expenses","Spending Money",,$42.39,$0.00,C,$1865.58
"Us Bank",,,06/29/2015,"Download from usbank.com. ISOBUNE SUSHI SFSAN FRANCISCCA","Everyday Expenses:Spending Money","Everyday Expenses","Spending Money",,$56.16,$0.00,C,$1809.42
"Us Bank",,,06/29/2015,"Download from usbank.com. SQ *UPCIDER     San FranciscCA","Everyday Expenses:Spending Money","Everyday Expenses","Spending Money",,$58.90,$0.00,C,$1750.52
"Us Bank",,,06/29/2015,"Download from usbank.com. SQ *SUGAR SAN FRSan FranciscCA","Everyday Expenses:Spending Money","Everyday Expenses","Spending Money",,$72.00,$0.00,C,$1678.52
"Us Bank",,,06/29/2015,"Download from usbank.com. AMERICAN APPARELSAN FRANCISCCA","Everyday Expenses:Clothing","Everyday Expenses","Clothing",,$72.86,$0.00,C,$1605.66
"Us Bank",,,06/29/2015,"Download from usbank.com. WALGREENS 1300 BSAN FRANCISCCA","Everyday Expenses:Household Goods","Everyday Expenses","Household Goods",,$81.33,$0.00,C,$1524.33
"Us Bank",,,06/30/2015,"Download from usbank.com. SQWIGGLE INC","Income:Available this month","Income","Available this month",,$0.00,$1798.57,C,$3322.90
"Us Bank",,,06/30/2015,"Download from usbank.com. NEWS EXPRESS S30SAN FRANCISCCA","Everyday Expenses:Spending Money","Everyday Expenses","Spending Money",,$5.98,$0.00,C,$3316.92
"Us Bank",,,06/30/2015,"Download from usbank.com. WORKING GIRLS CASAN FRANCISCCA","Everyday Expenses:Spending Money","Everyday Expenses","Spending Money",,$9.95,$0.00,C,$3306.97
"Us Bank",,,06/30/2015,"Download from usbank.com. MAILCHIMP       MAILCHIMP.COGA","Monthly Bills:Web Stuff","Monthly Bills","Web Stuff",,$10.00,$0.00,C,$3296.97
"Us Bank",,,07/01/2015,"Download from usbank.com.","Everyday Expenses:Misc","Everyday Expenses","Misc",,$0.00,$300.00,C,$3596.97
"Us Bank",,,07/01/2015,"Download from usbank.com. CHIPOTLE 1857   SAN FRANCISCCA","Everyday Expenses:Spending Money","Everyday Expenses","Spending Money",,$7.56,$0.00,C,$3589.41
"Us Bank",,,07/01/2015,"Download from usbank.com. BAMBOO ASIA     SAN FRANCISCCA","Everyday Expenses:Spending Money","Everyday Expenses","Spending Money",,$9.73,$0.00,C,$3579.68
"Us Bank",,,07/01/2015,"Download from usbank.com. WALGREENS 1300 BSAN FRANCISCCA","Everyday Expenses:Household Goods","Everyday Expenses","Household Goods",,$11.22,$0.00,C,$3568.46
"Us Bank",,,07/01/2015,"Download from usbank.com. BART-CLIPPER POWSAN FRANCISCCA","Everyday Expenses:Transportation","Everyday Expenses","Transportation",,$16.00,$0.00,C,$3552.46
"Us Bank",,,07/01/2015,"Download from usbank.com. UBER            866-576-1039CA","Everyday Expenses:Misc","Everyday Expenses","Misc",,$25.00,$0.00,C,$3527.46
"Us Bank",,,07/01/2015,"Download from usbank.com.","Everyday Expenses:Spending Money","Everyday Expenses","Spending Money",,$30.00,$0.00,C,$3497.46
"Us Bank",,,07/01/2015,"Download from usbank.com. UBER            866-576-1039CA","Everyday Expenses:Misc","Everyday Expenses","Misc",,$43.13,$0.00,C,$3454.33
"Us Bank",,,07/01/2015,"Download from usbank.com. YELLOW CAB CO.  GARDENA     CA","Everyday Expenses:Misc","Everyday Expenses","Misc",,$69.42,$0.00,C,$3384.91
"Us Bank",,,07/02/2015,"Download from usbank.com. UBER            8665761039  CA","Everyday Expenses:Misc","Everyday Expenses","Misc",,$0.00,$25.00,C,$3409.91
"Us Bank",,,07/02/2015,"Download from usbank.com. T3 STARBUCKS L32LOS ANGELES CA","Everyday Expenses:Coffee Shop","Everyday Expenses","Coffee Shop",,$1.72,$0.00,C,$3408.19
"Us Bank",,,07/02/2015,"Download from usbank.com. QWENCH Q-007    LOS ANGELES CA","Everyday Expenses:Spending Money","Everyday Expenses","Spending Money",,$7.80,$0.00,C,$3400.39
"Us Bank",,,07/02/2015,"Download from usbank.com. STARBUCKS CARD R800-782-7282WA","Everyday Expenses:Coffee Shop","Everyday Expenses","Coffee Shop",,$10.00,$0.00,C,$3390.39
"Us Bank",,,07/02/2015,"Download from usbank.com. ICE HOUSE       SEGUIN      TX","Everyday Expenses:Spending Money","Everyday Expenses","Spending Money",,$13.60,$0.00,C,$3376.79
"Us Bank",,,07/02/2015,"Download from usbank.com. Acorns.com","Savings Goals:Savings","Savings Goals","Savings",,$14.35,$0.00,C,$3362.44
"Us Bank",,,07/02/2015,"Download from usbank.com. UBER TECHNOLOGIE866-576-1039CA","Everyday Expenses:Misc","Everyday Expenses","Misc",,$16.02,$0.00,C,$3346.42
"Us Bank",,,07/02/2015,"Download from usbank.com. UBER            866-576-1039CA","Everyday Expenses:Misc","Everyday Expenses","Misc",,$16.51,$0.00,C,$3329.91
"Us Bank",,,07/02/2015,"Download from usbank.com. BETTERMENT","Savings Goals:Savings","Savings Goals","Savings",,$150.00,$0.00,C,$3179.91
"Us Bank",,,07/02/2015,"Download from usbank.com. FIGUEROA HOTEL  LOS ANGELES CA","Everyday Expenses:Misc","Everyday Expenses","Misc",,$153.95,$0.00,C,$3025.96
"Us Bank",,,07/02/2015,"Download from usbank.com. Mosser Companies","Monthly Bills:Rent","Monthly Bills","Rent",,$1582.72,$0.00,C,$1443.24
"Us Bank",,,07/03/2015,"Download from usbank.com. MODCLOTH INC","Income:Available this month","Income","Available this month",,$0.00,$1507.86,C,$2951.10
"Us Bank",,,07/03/2015,"Download from usbank.com. OAK ROW-MARKET31OAKLAND     CA","Everyday Expenses:Spending Money","Everyday Expenses","Spending Money",,$3.38,$0.00,C,$2947.72
"Us Bank",,,07/03/2015,"Download from usbank.com. PETER RABBIT    HONDO       TX","Everyday Expenses:Spending Money","Everyday Expenses","Spending Money",,$5.81,$0.00,C,$2941.91
"Us Bank",,,07/03/2015,"Download from usbank.com. SWA INFLIGHT WIF800-435-9792CA","Everyday Expenses:Transportation","Everyday Expenses","Transportation",,$8.00,$0.00,C,$2933.91
"Us Bank",,,07/03/2015,"Download from usbank.com. STARBUCKS CARD R800-782-7282WA","Everyday Expenses:Coffee Shop","Everyday Expenses","Coffee Shop",,$10.00,$0.00,C,$2923.91
"Us Bank",,,07/03/2015,"Download from usbank.com. ICE HOUSE       SEGUIN      TX","Everyday Expenses:Spending Money","Everyday Expenses","Spending Money",,$16.85,$0.00,C,$2907.06
"Us Bank",,,07/03/2015,"Download from usbank.com. JASONS DELI NBS 830-620-7000TX","Everyday Expenses:Spending Money","Everyday Expenses","Spending Money",,$19.77,$0.00,C,$2887.29
"Us Bank",,,07/03/2015,"Download from usbank.com. ANDALE MEXICAN ROAKLAND     CA","Everyday Expenses:Spending Money","Everyday Expenses","Spending Money",,$21.56,$0.00,C,$2865.73
"Us Bank",,,07/03/2015,"Download from usbank.com. TREEHOUSE       800-928-2130FL","Monthly Bills:Web Stuff","Monthly Bills","Web Stuff",,$25.00,$0.00,C,$2840.73
"Us Bank",,,07/03/2015,"Download from usbank.com. CASA VIEJA TAQUESEGUIN      TX","Everyday Expenses:Spending Money","Everyday Expenses","Spending Money",,$35.25,$0.00,C,$2805.48
"Us Bank",,,07/03/2015,"Download from usbank.com. HEB #173        SEGUIN      TX","Everyday Expenses:Groceries","Everyday Expenses","Groceries",,$72.84,$0.00,C,$2732.64
"Us Bank",,,07/03/2015,"Download from usbank.com. CLASSPASS.COM CL888-493-5953NY","Everyday Expenses:Spending Money","Everyday Expenses","Spending Money",,$99.00,$0.00,C,$2633.64
"Us Bank",,,07/03/2015,"Download from usbank.com. SONGBIRD STUDIOSSAN FRANCISCCA","Everyday Expenses:Misc","Everyday Expenses","Misc",,$270.00,$0.00,C,$2363.64
"Us Bank",,,07/06/2015,"Download from usbank.com.","Everyday Expenses:Spending Money","Everyday Expenses","Spending Money",,$0.20,$0.00,C,$2363.44
"Us Bank",,,07/06/2015,"Download from usbank.com. APL* ITUNES.COM/866-712-7753CA","Everyday Expenses:Spending Money","Everyday Expenses","Spending Money",,$4.99,$0.00,C,$2358.45
"Us Bank",,,07/06/2015,"Download from usbank.com. LYFT   *RIDE SUN855-280-0278CA","Everyday Expenses:Transportation","Everyday Expenses","Transportation",,$8.72,$0.00,C,$2349.73
"Us Bank",,,07/06/2015,"Download from usbank.com. GHOST PERSONAL  +44207224282","Monthly Bills:Web Stuff","Monthly Bills","Web Stuff",,$10.00,$0.00,C,$2339.73
"Us Bank",,,07/06/2015,"Download from usbank.com. SOUTHWESTAIR*INFDALLAS      TX","Everyday Expenses:Spending Money","Everyday Expenses","Spending Money",,$10.00,$0.00,C,$2329.73
"Us Bank",,,07/06/2015,"Download from usbank.com. STARBUCKS CARD R800-782-7282WA","Everyday Expenses:Coffee Shop","Everyday Expenses","Coffee Shop",,$10.00,$0.00,C,$2319.73
"Us Bank",,,07/06/2015,"Download from usbank.com. Audible US      888-283-5051NJ","Monthly Bills:Web Stuff","Monthly Bills","Web Stuff",,$19.55,$0.00,C,$2300.18
"Us Bank",,,07/06/2015,"Download from usbank.com. AMERICAN FIREWORBASTROP     TX","Everyday Expenses:Spending Money","Everyday Expenses","Spending Money",,$31.85,$0.00,C,$2268.33
"Us Bank",,,07/06/2015,"Download from usbank.com. NATURAL BRIDGE WSAN ANTONIO TX","Everyday Expenses:Spending Money","Everyday Expenses","Spending Money",,$40.76,$0.00,C,$2227.57
"Us Bank",,,07/06/2015,"Download from usbank.com. SPROUTS FARMERS SAN ANTONIO TX","Everyday Expenses:Groceries","Everyday Expenses","Groceries",,$42.90,$0.00,C,$2184.67
"Us Bank",,,07/06/2015,"Download from usbank.com. MAC AND ERNIES RTARPLEY     TX","Everyday Expenses:Spending Money","Everyday Expenses","Spending Money",,$48.39,$0.00,C,$2136.28
"Us Bank",,,07/07/2015,"Download from usbank.com. Acorns.com","Savings Goals:Savings","Savings Goals","Savings",,$9.07,$0.00,C,$2127.21
"Us Bank",,,07/07/2015,"Download from usbank.com. SQ *WRIGHT BROS.Austin      TX","Everyday Expenses:Coffee Shop","Everyday Expenses","Coffee Shop",,$9.50,$0.00,C,$2117.71
"Us Bank",,,07/07/2015,"Download from usbank.com. SQ *WRIGHT BROS.Austin      TX","Everyday Expenses:Coffee Shop","Everyday Expenses","Coffee Shop",,$14.00,$0.00,C,$2103.71
"Us Bank",,,07/07/2015,"Download from usbank.com. BILL & ROSAS KK D HANIS     TX","Everyday Expenses:Spending Money","Everyday Expenses","Spending Money",,$41.70,$0.00,C,$2062.01
"Us Bank",,,07/07/2015,"Download from usbank.com. GP*BUFALINA     AUSTIN      TX","Everyday Expenses:Spending Money","Everyday Expenses","Spending Money",,$41.81,$0.00,C,$2020.20
"Us Bank",,,07/08/2015,"Download from usbank.com. CENOTE          AUSTIN      TX","Everyday Expenses:Coffee Shop","Everyday Expenses","Coffee Shop",,$3.25,$0.00,C,$2016.95
"Us Bank",,,07/08/2015,"Download from usbank.com. PAYPAL","Everyday Expenses:Transportation","Everyday Expenses","Transportation",,$5.22,$0.00,C,$2011.73
"Us Bank",,,07/08/2015,"Download from usbank.com. WALGREENS 1920 EAUSTIN      TX","Everyday Expenses:Household Goods","Everyday Expenses","Household Goods",,$10.93,$0.00,C,$2000.80
"Us Bank",,,07/08/2015,"Download from usbank.com. SQ *IRONWOOD BBQAustin      TX","Everyday Expenses:Spending Money","Everyday Expenses","Spending Money",,$14.95,$0.00,C,$1985.85
"Us Bank",,,07/08/2015,"Download from usbank.com. SQ *IRONWOOD BBQAustin      TX","Everyday Expenses:Spending Money","Everyday Expenses","Spending Money",,$15.00,$0.00,C,$1970.85
"Us Bank",,,07/09/2015,"Download from usbank.com. LYFT   *RIDE TUE855-280-0278CA","Everyday Expenses:Transportation","Everyday Expenses","Transportation",,$6.65,$0.00,C,$1964.20
"Us Bank",,,07/09/2015,"Download from usbank.com. SQ *CAFFE MEDICIAustin      TX","Everyday Expenses:Coffee Shop","Everyday Expenses","Coffee Shop",,$7.00,$0.00,C,$1957.20
"Us Bank",,,07/09/2015,"Download from usbank.com. ORANGE LEAFE 032AUSTIN      TX","Everyday Expenses:Spending Money","Everyday Expenses","Spending Money",,$8.17,$0.00,C,$1949.03
"Us Bank",,,07/09/2015,"Download from usbank.com. BUZZ MILL COFFEEAUSTIN      TX","Everyday Expenses:Coffee Shop","Everyday Expenses","Coffee Shop",,$8.25,$0.00,C,$1940.78
"Us Bank",,,07/09/2015,"Download from usbank.com. CASINO EL CAMINOAUSTIN      TX","Everyday Expenses:Spending Money","Everyday Expenses","Spending Money",,$23.00,$0.00,C,$1917.78
"Us Bank",,,07/09/2015,"Download from usbank.com. BUZZ MILL COFFEEAUSTIN      TX","Everyday Expenses:Spending Money","Everyday Expenses","Spending Money",,$36.00,$0.00,C,$1881.78
"Us Bank",,,07/09/2015,"Download from usbank.com. MODCLOTH INC.   888-4959699 CA","Everyday Expenses:Clothing","Everyday Expenses","Clothing",,$41.78,$0.00,C,$1840.00
"Us Bank",,,07/09/2015,"Download from usbank.com. SILO ON 7TH     AUSTIN      TX","Everyday Expenses:Spending Money","Everyday Expenses","Spending Money",,$44.44,$0.00,C,$1795.56
"Us Bank",,,07/10/2015,"Download from usbank.com. SHELL Service StAUSTIN      TX","Everyday Expenses:Spending Money","Everyday Expenses","Spending Money",,$2.39,$0.00,C,$1793.17
"Us Bank",,,07/10/2015,"Download from usbank.com. 071015PLUSTERM222 E 6TH ST    AUSTIN      TXUS1","Everyday Expenses:Spending Money","Everyday Expenses","Spending Money",,$2.50,$0.00,C,$1790.67
"Us Bank",,,07/10/2015,"Download from usbank.com. 071015PLUSTERM2001 BARTON SPRIAUSTIN      TXUS1","Everyday Expenses:Spending Money","Everyday Expenses","Spending Money",,$2.50,$0.00,C,$1788.17
"Us Bank",,,07/10/2015,"Download from usbank.com. LYFT   *RIDE THU855-280-0278CA","Everyday Expenses:Transportation","Everyday Expenses","Transportation",,$6.65,$0.00,C,$1781.52
"Us Bank",,,07/10/2015,"Download from usbank.com. LYFT   *RIDE THU855-280-0278CA","Everyday Expenses:Transportation","Everyday Expenses","Transportation",,$6.65,$0.00,C,$1774.87
"Us Bank",,,07/10/2015,"Download from usbank.com. SQ *VINTAGE HEARAustin      TX","Everyday Expenses:Coffee Shop","Everyday Expenses","Coffee Shop",,$7.75,$0.00,C,$1767.12
"Us Bank",,,07/10/2015,"Download from usbank.com. ROYAL BLUE GROCEAUSTIN      TX","Everyday Expenses:Groceries","Everyday Expenses","Groceries",,$8.50,$0.00,C,$1758.62
"Us Bank",,,07/10/2015,"Download from usbank.com. Acorns.com","Savings Goals:Savings","Savings Goals","Savings",,$9.99,$0.00,C,$1748.63
"Us Bank",,,07/10/2015,"Download from usbank.com. SQ *VERACRUZ ALLAustin      TX","Everyday Expenses:Spending Money","Everyday Expenses","Spending Money",,$11.28,$0.00,C,$1737.35
"Us Bank",,,07/10/2015,"Download from usbank.com. YELLOW JACKET SOAUSTIN      TX","Everyday Expenses:Spending Money","Everyday Expenses","Spending Money",,$12.33,$0.00,C,$1725.02
"Us Bank",,,07/10/2015,"Download from usbank.com. THE JACKALOPE   AUSTIN      TX","Everyday Expenses:Spending Money","Everyday Expenses","Spending Money",,$12.82,$0.00,C,$1712.20
"Us Bank",,,07/10/2015,"Download from usbank.com. 222 E 6TH ST    AUSTIN      TXUS1","Everyday Expenses:Spending Money","Everyday Expenses","Spending Money",,$24.50,$0.00,C,$1687.70
"Us Bank",,,07/10/2015,"Download from usbank.com. EASY TIGER      512-4678776 TX","Everyday Expenses:Spending Money","Everyday Expenses","Spending Money",,$36.40,$0.00,C,$1651.30
"Us Bank",,,07/10/2015,"Download from usbank.com. 2001 BARTON SPRIAUSTIN      TXUS1","Everyday Expenses:Spending Money","Everyday Expenses","Spending Money",,$42.50,$0.00,C,$1608.80
"Us Bank",,,07/10/2015,"Download from usbank.com. THE HIGHTOWER REAUSTIN      TX","Everyday Expenses:Spending Money","Everyday Expenses","Spending Money",,$55.81,$0.00,C,$1552.99
"Us Bank",,,07/13/2015,"Download from usbank.com. SQ *BLUE BOTTLE San FranciscCA","Everyday Expenses:Coffee Shop","Everyday Expenses","Coffee Shop",,$5.00,$0.00,C,$1547.99
"Us Bank",,,07/13/2015,"Download from usbank.com. LYFT   *RIDE FRI855-280-0278CA","Everyday Expenses:Transportation","Everyday Expenses","Transportation",,$6.31,$0.00,C,$1541.68
"Us Bank",,,07/13/2015,"Download from usbank.com. LYFT   *RIDE SAT855-280-0278CA","Everyday Expenses:Transportation","Everyday Expenses","Transportation",,$6.65,$0.00,C,$1535.03
"Us Bank",,,07/13/2015,"Download from usbank.com. LYFT   *RIDE WED855-280-0278CA","Everyday Expenses:Transportation","Everyday Expenses","Transportation",,$6.70,$0.00,C,$1528.33
"Us Bank",,,07/13/2015,"Download from usbank.com. LYFT   *RIDE FRI855-280-0278CA","Everyday Expenses:Transportation","Everyday Expenses","Transportation",,$7.43,$0.00,C,$1520.90
"Us Bank",,,07/13/2015,"Download from usbank.com. AUSTIN PARKING MAUSTIN      TX","Everyday Expenses:Transportation","Everyday Expenses","Transportation",,$8.00,$0.00,C,$1512.90
"Us Bank",,,07/13/2015,"Download from usbank.com. BUFFER          4155390176  CA","Monthly Bills:Web Stuff","Monthly Bills","Web Stuff",,$10.00,$0.00,C,$1502.90
"Us Bank",,,07/13/2015,"Download from usbank.com. RECESS ARCADE BA512-6989852 TX","Everyday Expenses:Spending Money","Everyday Expenses","Spending Money",,$14.00,$0.00,C,$1488.90
"Us Bank",,,07/13/2015,"Download from usbank.com. BLENDERS & BOWLSAUSTIN      TX","Everyday Expenses:Spending Money","Everyday Expenses","Spending Money",,$14.88,$0.00,C,$1474.02
"Us Bank",,,07/13/2015,"Download from usbank.com. Audible         888-283-5051NJ","Monthly Bills:Web Stuff","Monthly Bills","Web Stuff",,$14.95,$0.00,C,$1459.07
"Us Bank",,,07/13/2015,"Download from usbank.com. PAYPAL","Everyday Expenses:Transportation","Everyday Expenses","Transportation",,$16.91,$0.00,C,$1442.16
"Us Bank",,,07/13/2015,"Download from usbank.com. CENOTE          AUSTIN      TX","Everyday Expenses:Coffee Shop","Everyday Expenses","Coffee Shop",,$20.57,$0.00,C,$1421.59
"Us Bank",,,07/13/2015,"Download from usbank.com. THE GINGER MAN  AUSTIN      TX","Everyday Expenses:Spending Money","Everyday Expenses","Spending Money",,$20.68,$0.00,C,$1400.91
"Us Bank",,,07/13/2015,"Download from usbank.com. Audible US      888-283-5051NJ","Monthly Bills:Web Stuff","Monthly Bills","Web Stuff",,$22.05,$0.00,C,$1378.86
"Us Bank",,,07/13/2015,"Download from usbank.com. DNC TRAVEL - AUSAUSTIN      TX","Everyday Expenses:Transportation","Everyday Expenses","Transportation",,$23.11,$0.00,C,$1355.75
"Us Bank",,,07/13/2015,"Download from usbank.com. THE GINGER MAN  AUSTIN      TX","Everyday Expenses:Spending Money","Everyday Expenses","Spending Money",,$24.57,$0.00,C,$1331.18
"Us Bank",,,07/13/2015,"Download from usbank.com. PAYPAL","Everyday Expenses:Transportation","Everyday Expenses","Transportation",,$24.84,$0.00,C,$1306.34
"Us Bank",,,07/13/2015,"Download from usbank.com. WALGREENS 1300 BSAN FRANCISCCA","Everyday Expenses:Household Goods","Everyday Expenses","Household Goods",,$38.55,$0.00,C,$1267.79
"Us Bank",,,07/13/2015,"Download from usbank.com. BOULDIN CREEK COAUSTIN      TX","Everyday Expenses:Spending Money","Everyday Expenses","Spending Money",,$39.93,$0.00,C,$1227.86
"Us Bank",,,07/13/2015,"Download from usbank.com. VENMO           855-812-4430NY","Everyday Expenses:Spending Money","Everyday Expenses","Spending Money",,$61.00,$0.00,C,$1166.86
"Us Bank",,,07/13/2015,"Download from usbank.com. TRADER JOE'S #20SAN FRANCISCCA","Everyday Expenses:Groceries","Everyday Expenses","Groceries",,$110.82,$0.00,C,$1056.04
"Us Bank",,,07/14/2015,"Download from usbank.com. Acorns.com","Savings Goals:Savings","Savings Goals","Savings",,$5.57,$0.00,C,$1050.47
"Us Bank",,,07/14/2015,"Download from usbank.com. ONIGILLY        SAN FRANCISCCA","Everyday Expenses:Spending Money","Everyday Expenses","Spending Money",,$9.50,$0.00,C,$1040.97
"Us Bank",,,07/14/2015,"Download from usbank.com. LYFT   *RIDE SAT855-280-0278CA","Everyday Expenses:Transportation","Everyday Expenses","Transportation",,$12.80,$0.00,C,$1028.17
"Us Bank",,,07/14/2015,"Download from usbank.com. 0282 PLANET FITNSAN FRANCISCCA","Everyday Expenses:Health & Fitness","Everyday Expenses","Health & Fitness",,$20.00,$0.00,C,$1008.17
"Us Bank",,,07/14/2015,"Download from usbank.com. BLUE DAHLIA BISTAUSTIN      TX","Everyday Expenses:Spending Money","Everyday Expenses","Spending Money",,$28.96,$0.00,C,$979.21
"Us Bank",,,07/15/2015,"Download from usbank.com. SQWIGGLE INC","Income:Available this month","Income","Available this month",,$0.00,$1798.57,C,$2777.78
"Us Bank",,,07/15/2015,"Download from usbank.com. PROSPER MARKETPL","Everyday Expenses:Spending Money","Everyday Expenses","Spending Money",,$0.00,$97.96,C,$2875.74
"Us Bank",,,07/15/2015,"Download from usbank.com. AMAZON MKTPLACE AMZN.COM/BILWA","Everyday Expenses:Spending Money","Everyday Expenses","Spending Money",,$6.97,$0.00,C,$2868.77
"Us Bank",,,07/15/2015,"Download from usbank.com. 0282 PLANET FITNSAN FRANCISCCA","Everyday Expenses:Health & Fitness","Everyday Expenses","Health & Fitness",,$20.00,$0.00,C,$2848.77
"Us Bank",,,07/15/2015,"Download from usbank.com. PROSPER MARKETPL","Everyday Expenses:Spending Money","Everyday Expenses","Spending Money",,$97.96,$0.00,C,$2750.81
"Us Bank",,,07/15/2015,"Download from usbank.com. ATT","Monthly Bills:Cell Phone","Monthly Bills","Cell Phone",,$142.73,$0.00,C,$2608.08
"Us Bank",,,07/16/2015,"Download from usbank.com. Acorns.com","Savings Goals:Savings","Savings Goals","Savings",,$9.93,$0.00,C,$2598.15
"Us Bank",,,07/16/2015,"Download from usbank.com. VENMO","Everyday Expenses:Spending Money","Everyday Expenses","Spending Money",,$16.00,$0.00,C,$2582.15
"Us Bank",,,07/16/2015,"Download from usbank.com. TARGET T3201    SAN FRANCISCCA---- You Requested $20.00 in Cash Back","Everyday Expenses:Household Goods","Everyday Expenses","Household Goods",,$20.75,$0.00,C,$2561.40
"Us Bank",,,07/16/2015,"Download from usbank.com. BETTERMENT","Savings Goals:Savings","Savings Goals","Savings",,$150.00,$0.00,C,$2411.40
"Us Bank",,,07/17/2015,"Download from usbank.com. MODCLOTH INC","Income:Available this month","Income","Available this month",,$0.00,$1827.48,C,$4238.88
"Us Bank",,,07/17/2015,"Download from usbank.com. BART-CLIPPER 19TOAKLAND     CA","Everyday Expenses:Transportation","Everyday Expenses","Transportation",,$2.00,$0.00,C,$4236.88
"Us Bank",,,07/17/2015,"Download from usbank.com. SQ *BLUE BOTTLE San FranciscCA","Everyday Expenses:Coffee Shop","Everyday Expenses","Coffee Shop",,$4.00,$0.00,C,$4232.88
"Us Bank",,,07/17/2015,"Download from usbank.com. CHIPOTLE 1857   SAN FRANCISCCA","Everyday Expenses:Spending Money","Everyday Expenses","Spending Money",,$8.86,$0.00,C,$4224.02
"Us Bank",,,07/17/2015,"Download from usbank.com. PLANET FIT","Everyday Expenses:Health & Fitness","Everyday Expenses","Health & Fitness",,$19.99,$0.00,C,$4204.03
"Us Bank",,,07/17/2015,"Download from usbank.com. BT TASKRABBIT F888-661-8105CA","Everyday Expenses:Misc","Everyday Expenses","Misc",,$131.25,$0.00,C,$4072.78
"Us Bank",,,07/17/2015,"Download from usbank.com. 7246","Debt:Eric's Credit Card","Debt","Eric's Credit Card",,$300.00,$0.00,C,$3772.78
"Us Bank",,,07/20/2015,"Download from usbank.com. Amazon Video On 866-216-1072WA","Everyday Expenses:Spending Money","Everyday Expenses","Spending Money",,$2.99,$0.00,C,$3769.79
"Us Bank",,,07/20/2015,"Download from usbank.com. PAYPAL","Everyday Expenses:Transportation","Everyday Expenses","Transportation",,$9.99,$0.00,C,$3759.80
"Us Bank",,,07/20/2015,"Download from usbank.com. TARGET T0328    Dublin      CA---- You Requested $10.00 in Cash Back","Everyday Expenses:Household Goods","Everyday Expenses","Household Goods",,$15.79,$0.00,C,$3744.01
"Us Bank",,,07/21/2015,"Download from usbank.com. 072015PLUSTERM300 KEARNY STREESAN FRANCISCCAUS1","Everyday Expenses:Spending Money","Everyday Expenses","Spending Money",,$2.50,$0.00,C,$3741.51
"Us Bank",,,07/21/2015,"Download from usbank.com. Acorns.com","Savings Goals:Savings","Savings Goals","Savings",,$6.15,$0.00,C,$3735.36
"Us Bank",,,07/21/2015,"Download from usbank.com. 300 KEARNY STREESAN FRANCISCCAUS1","Everyday Expenses:Spending Money","Everyday Expenses","Spending Money",,$22.99,$0.00,C,$3712.37
"Us Bank",,,07/22/2015,"Download from usbank.com. PROSPER MARKETPL","Everyday Expenses:Misc","Everyday Expenses","Misc",,$0.00,$102.42,C,$3814.79
"Us Bank",,,07/22/2015,"Download from usbank.com. PAYPAL","Everyday Expenses:Spending Money","Everyday Expenses","Spending Money",,$0.00,$30.63,C,$3845.42
"Us Bank",,,07/22/2015,"Download from usbank.com.","Everyday Expenses:Spending Money","Everyday Expenses","Spending Money",,$0.00,$6.95,C,$3852.37
"Us Bank",,,07/22/2015,"Download from usbank.com.","Everyday Expenses:Spending Money","Everyday Expenses","Spending Money",,$6.95,$0.00,C,$3845.42
"Us Bank",,,07/23/2015,"Download from usbank.com. Acorns.com","Savings Goals:Savings","Savings Goals","Savings",,$0.00,$460.10,C,$4305.52
"Us Bank",,,07/23/2015,"Download from usbank.com. Amazon Video On 866-216-1072WA","Everyday Expenses:Spending Money","Everyday Expenses","Spending Money",,$1.99,$0.00,C,$4303.53
"Us Bank",,,07/23/2015,"Download from usbank.com. PAYPAL","Monthly Bills:Web Stuff","Monthly Bills","Web Stuff",,$9.99,$0.00,C,$4293.54
"Us Bank",,,07/23/2015,"Download from usbank.com. Spotify USA     877-778-1161NY","Monthly Bills:Web Stuff","Monthly Bills","Web Stuff",,$9.99,$0.00,C,$4283.55
"Us Bank",,,07/23/2015,"Download from usbank.com. MR HOLMES BAKEHOSAN FRANCISCCA","Everyday Expenses:Spending Money","Everyday Expenses","Spending Money",,$23.93,$0.00,C,$4259.62
"Us Bank",,,07/24/2015,"Download from usbank.com. AMAZONDIGITALSVC866-216-1072WA","Everyday Expenses:Spending Money","Everyday Expenses","Spending Money",,$1.99,$0.00,C,$4257.63
"Us Bank",,,07/24/2015,"Download from usbank.com. Amazon Video On 866-216-1072WA","Everyday Expenses:Spending Money","Everyday Expenses","Spending Money",,$1.99,$0.00,C,$4255.64
"Us Bank",,,07/24/2015,"Download from usbank.com. MODCLOTH INC.   888-4959699 CA","Everyday Expenses:Clothing","Everyday Expenses","Clothing",,$30.63,$0.00,C,$4225.01
"Us Bank",,,07/24/2015,"Download from usbank.com. BETTERMENT","Savings Goals:Savings","Savings Goals","Savings",,$460.10,$0.00,C,$3764.91
"Us Bank",,,07/24/2015,"Download from usbank.com. CAPITAL ONE","Pre-YNAB Debt:Venture Card","Pre-YNAB Debt","Venture Card",,$935.51,$0.00,C,$2829.40
"Us Bank",,,07/27/2015,"Download from usbank.com. 072715PLUSTERM2399  MARKET ST SAN FRANCISCCAUS1","Everyday Expenses:Spending Money","Everyday Expenses","Spending Money",,$2.50,$0.00,C,$2826.90
"Us Bank",,,07/27/2015,"Download from usbank.com. VENMO","Everyday Expenses:Spending Money","Everyday Expenses","Spending Money",,$7.50,$0.00,C,$2819.40
"Us Bank",,,07/27/2015,"Download from usbank.com. 2399  MARKET ST SAN FRANCISCCAUS1","Everyday Expenses:Spending Money","Everyday Expenses","Spending Money",,$43.50,$0.00,C,$2775.90
"Us Bank",,,07/29/2015,"Download from usbank.com. CAPITAL ONE","Pre-YNAB Debt:Venture Card","Pre-YNAB Debt","Venture Card",,$402.22,$0.00,C,$2373.68
"Us Bank",,,07/30/2015,"Download from usbank.com. MAILCHIMP       MAILCHIMP.COGA","Monthly Bills:Web Stuff","Monthly Bills","Web Stuff",,$10.00,$0.00,C,$2363.68
"Us Bank",,,07/31/2015,"Download from usbank.com. MODCLOTH INC","Income:Available this month","Income","Available this month",,$0.00,$1981.50,C,$4345.18
"Us Bank",,,07/31/2015,"Download from usbank.com. SQWIGGLE INC","Income:Available this month","Income","Available this month",,$0.00,$1798.57,C,$6143.75
"Us Bank",,,08/03/2015,"Download from usbank.com. SONGBIRD STUDIOSSAN FRANCISCCA","Everyday Expenses:Misc","Everyday Expenses","Misc",,$270.00,$0.00,C,$5873.75
"Us Bank",,,08/04/2015,"Download from usbank.com. Amazon Video On 866-216-1072WA","Everyday Expenses:Spending Money","Everyday Expenses","Spending Money",,$2.99,$0.00,C,$5870.76
"Us Bank",,,08/04/2015,"Download from usbank.com. BETTERMENT","Savings Goals:Savings","Savings Goals","Savings",,$150.00,$0.00,C,$5720.76
"Us Bank",,,08/05/2015,"Download from usbank.com. Amazon Video On 866-216-1072WA","Everyday Expenses:Spending Money","Everyday Expenses","Spending Money",,$0.00,$2.99,C,$5723.75
"Us Bank",,,08/05/2015,"Download from usbank.com. Amazon Video On 866-216-1072WA","Everyday Expenses:Spending Money","Everyday Expenses","Spending Money",,$1.99,$0.00,C,$5721.76
"Us Bank",,,08/05/2015,"Download from usbank.com. CAPITAL ONE","Pre-YNAB Debt:Venture Card","Pre-YNAB Debt","Venture Card",,$769.63,$0.00,C,$4952.13
"Us Bank",,,08/10/2015,"Download from usbank.com. VENMO","Everyday Expenses:Spending Money","Everyday Expenses","Spending Money",,$0.00,$21.31,C,$4973.44
"Us Bank",,,08/10/2015,"Download from usbank.com. Amazon Video On 866-216-1072WA","Everyday Expenses:Spending Money","Everyday Expenses","Spending Money",,$3.99,$0.00,C,$4969.45
"Us Bank",,,08/10/2015,"Download from usbank.com. CAPITAL ONE","Pre-YNAB Debt:Venture Card","Pre-YNAB Debt","Venture Card",,$998.88,$0.00,C,$3970.57
"Us Bank",,,08/11/2015,"Download from usbank.com. LYFT   *RIDE MON855-280-0278CA","Everyday Expenses:Transportation","Everyday Expenses","Transportation",,$9.05,$0.00,C,$3961.52
"Us Bank",,,08/11/2015,"Download from usbank.com. Mosser Companies","Monthly Bills:Rent","Monthly Bills","Rent",,$1629.03,$0.00,C,$2332.49
"Us Bank",,,08/12/2015,"Download from usbank.com. VENMO","Everyday Expenses:Spending Money","Everyday Expenses","Spending Money",,$8.00,$0.00,C,$2324.49
"Us Bank",,,08/12/2015,"Download from usbank.com. WALGREENS 100 SASAN FRANCISCCA---- You Requested $20.00 in Cash Back","Everyday Expenses:Household Goods","Everyday Expenses","Household Goods",,$21.02,$0.00,C,$2303.47
"Us Bank",,,08/13/2015,"Download from usbank.com. BUFFER          415-539-0176CA","Monthly Bills:Web Stuff","Monthly Bills","Web Stuff",,$10.00,$0.00,C,$2293.47
"Us Bank",,,08/13/2015,"Download from usbank.com. US BANK SAN FRANSAN FRANCISCCAUS1","Everyday Expenses:Spending Money","Everyday Expenses","Spending Money",,$80.00,$0.00,C,$2213.47
"Us Bank",,,08/13/2015,"Download from usbank.com. CAPITAL ONE","Pre-YNAB Debt:Venture Card","Pre-YNAB Debt","Venture Card",,$491.33,$0.00,C,$1722.14
"Us Bank",,,08/14/2015,"Download from usbank.com. SQWIGGLE INC","Income:Available this month","Income","Available this month",,$0.00,$1798.57,C,$3520.71
"Us Bank",,,08/14/2015,"Download from usbank.com. MODCLOTH INC","Income:Available this month","Income","Available this month",,$0.00,$1623.16,C,$5143.87
"Us Bank",,,08/14/2015,"Download from usbank.com. 7246","Debt:Eric's Credit Card","Debt","Eric's Credit Card",,$400.00,$0.00,C,$4743.87
"Us Bank",,,08/17/2015,"Download from usbank.com. PAYPAL","Monthly Bills:Web Stuff","Monthly Bills","Web Stuff",,$30.00,$0.00,C,$4713.87
"Us Bank",,,08/17/2015,"Download from usbank.com. VENMO           855-812-4430NY","Everyday Expenses:Spending Money","Everyday Expenses","Spending Money",,$87.00,$0.00,C,$4626.87
"Us Bank",,,08/17/2015,"Download from usbank.com. CAPITAL ONE","Pre-YNAB Debt:Venture Card","Pre-YNAB Debt","Venture Card",,$180.75,$0.00,C,$4446.12
"Us Bank",,,08/18/2015,"Download from usbank.com. AMAZON MKTPLACE AMZN.COM/BILWA","Everyday Expenses:Spending Money","Everyday Expenses","Spending Money",,$73.80,$0.00,C,$4372.32
"Us Bank",,,08/18/2015,"Download from usbank.com. BETTERMENT","Savings Goals:Savings","Savings Goals","Savings",,$150.00,$0.00,C,$4222.32
"Us Bank",,,08/18/2015,"Download from usbank.com. CAPITAL ONE","Pre-YNAB Debt:Venture Card","Pre-YNAB Debt","Venture Card",,$288.96,$0.00,C,$3933.36
"Us Bank",,,08/20/2015,"Cash Deposit","Income:Available next month","Income","Available next month",,$0.00,$480.00,U,$4413.36
"Us Bank",,,08/20/2015,"Download from usbank.com. VENMO","Everyday Expenses:Misc","Everyday Expenses","Misc",,$0.00,$75.00,C,$4488.36
"Us Bank",,,08/20/2015,"Download from usbank.com. CAPITAL ONE","Pre-YNAB Debt:Venture Card","Pre-YNAB Debt","Venture Card",,$909.48,$0.00,C,$3578.88
"Us Bank",,,08/24/2015,"Download from usbank.com.","Everyday Expenses:Spending Money","Everyday Expenses","Spending Money",,$0.00,$6.95,C,$3585.83
"Us Bank",,,08/24/2015,"Download from usbank.com.","Everyday Expenses:Spending Money","Everyday Expenses","Spending Money",,$6.95,$0.00,C,$3578.88
"Us Bank",,,08/24/2015,"Download from usbank.com. PAYPAL","Monthly Bills:Web Stuff","Monthly Bills","Web Stuff",,$9.99,$0.00,C,$3568.89
"Us Bank",,,08/25/2015,"Download from usbank.com. VENMO","Everyday Expenses:Misc","Everyday Expenses","Misc",,$0.00,$362.44,C,$3931.33
"Us Bank",,,08/25/2015,"Download from usbank.com. VENMO","Everyday Expenses:Misc","Everyday Expenses","Misc",,$0.00,$37.00,C,$3968.33
"Us Bank",,,08/25/2015,"Download from usbank.com. 082415PLUSTERM3159 16TH ST    SAN FRANCISCCAUS1","Everyday Expenses:Spending Money","Everyday Expenses","Spending Money",,$2.50,$0.00,C,$3965.83
"Us Bank",,,08/25/2015,"Download from usbank.com. PEET'S #30202   SAN FRANCISCCA","Everyday Expenses:Coffee Shop","Everyday Expenses","Coffee Shop",,$4.35,$0.00,C,$3961.48
"Us Bank",,,08/25/2015,"Download from usbank.com. CHIPOTLE 1857   SAN FRANCISCCA","Everyday Expenses:Spending Money","Everyday Expenses","Spending Money",,$8.32,$0.00,C,$3953.16
"Us Bank",,,08/25/2015,"Download from usbank.com. 3159 16TH ST    SAN FRANCISCCAUS1","Everyday Expenses:Spending Money","Everyday Expenses","Spending Money",,$42.89,$0.00,C,$3910.27
"Us Bank",,,08/26/2015,"Download from usbank.com. VENMO","Everyday Expenses:Misc","Everyday Expenses","Misc",,$0.00,$91.00,C,$4001.27
"Us Bank",,,08/26/2015,"Download from usbank.com. BROWNIES HARDWARSAN FRANCISCCA","Everyday Expenses:Household Goods","Everyday Expenses","Household Goods",,$1.95,$0.00,C,$3999.32
"Us Bank",,,08/26/2015,"Download from usbank.com. CAPITAL ONE","Pre-YNAB Debt:Venture Card","Pre-YNAB Debt","Venture Card",,$952.38,$0.00,C,$3046.94
"Us Bank",,,08/27/2015,"Download from usbank.com. PAYPAL","Everyday Expenses:Misc","Everyday Expenses","Misc",,$0.00,$68.00,C,$3114.94
"Us Bank",,,08/27/2015,"Download from usbank.com. BART-CLIPPER POWSAN FRANCISCCA","Everyday Expenses:Transportation","Everyday Expenses","Transportation",,$20.00,$0.00,C,$3094.94
"Us Bank",,,08/28/2015,"Download from usbank.com. MODCLOTH INC","Income:Available this month","Income","Available this month",,$0.00,$1518.05,C,$4612.99
"Us Bank",,,08/28/2015,"Download from usbank.com. 082815PLUSTERM816 P ST        LINCOLN     NEUS1","Everyday Expenses:Spending Money","Everyday Expenses","Spending Money",,$2.50,$0.00,C,$4610.49
"Us Bank",,,08/28/2015,"Download from usbank.com. 816 P ST        LINCOLN     NEUS1","Everyday Expenses:Spending Money","Everyday Expenses","Spending Money",,$81.00,$0.00,C,$4529.49
"Us Bank",,,08/31/2015,"Download from usbank.com. SQWIGGLE INC","Income:Available this month","Income","Available this month",,$0.00,$1798.57,C,$6328.06
"Us Bank",,,09/01/2015,"Download from usbank.com. APL* ITUNES.COM/866-712-7753CA","Everyday Expenses:Spending Money","Everyday Expenses","Spending Money",,$3.99,$0.00,C,$6324.07
"Us Bank",,,09/01/2015,"Download from usbank.com. CAPITAL ONE","Pre-YNAB Debt:Venture Card","Pre-YNAB Debt","Venture Card",,$1346.01,$0.00,C,$4978.06
"Us Bank",,,09/02/2015,"Download from usbank.com. BETTERMENT","Savings Goals:Savings","Savings Goals","Savings",,$150.00,$0.00,C,$4828.06
"Us Bank",,,09/02/2015,"Download from usbank.com. Mosser Companies","Monthly Bills:Rent","Monthly Bills","Rent",,$1612.53,$0.00,C,$3215.53
"Us Bank",,,09/08/2015,"Download from usbank.com. VENMO","Everyday Expenses:Misc","Everyday Expenses","Misc",,$7.00,$0.00,C,$3208.53
"Us Bank",,,09/10/2015,"Download from usbank.com. VENMO","Everyday Expenses:Misc","Everyday Expenses","Misc",,$0.00,$262.52,C,$3471.05
"Us Bank",,,09/11/2015,"Download from usbank.com. MODCLOTH INC","Income:Available this month","Income","Available this month",,$0.00,$1518.05,C,$4989.10
"Us Bank",,,09/11/2015,"Download from usbank.com. 7246","Debt:Eric's Credit Card","Debt","Eric's Credit Card",,$200.00,$0.00,C,$4789.10
"Us Bank",,,09/14/2015,"Download from usbank.com. VENMO","Everyday Expenses:Misc","Everyday Expenses","Misc",,$0.63,$0.00,C,$4788.47
"Us Bank",,,09/14/2015,"Download from usbank.com. VENMO","Everyday Expenses:Misc","Everyday Expenses","Misc",,$18.08,$0.00,C,$4770.39
"Us Bank",,,09/14/2015,"Download from usbank.com. PGANDE","Monthly Bills:Utilities","Monthly Bills","Utilities",,$53.20,$0.00,C,$4717.19
"Us Bank",,,09/14/2015,"Download from usbank.com. VENMO","Everyday Expenses:Misc","Everyday Expenses","Misc",,$58.26,$0.00,C,$4658.93
"Us Bank",,,09/14/2015,"Download from usbank.com. CAPITAL ONE","Pre-YNAB Debt:Venture Card","Pre-YNAB Debt","Venture Card",,$2349.10,$0.00,C,$2309.83
"Us Bank",,,09/15/2015,"Download from usbank.com. SQWIGGLE INC","Income:Available this month","Income","Available this month",,$0.00,$1798.57,C,$4108.40
"Us Bank",,,09/16/2015,"Download from usbank.com. AIRBNB PAYMENTS","Everyday Expenses:Spending Money","Everyday Expenses","Spending Money",,$0.00,$0.02,C,$4108.42
"Us Bank",,,09/16/2015,"Download from usbank.com. BETTERMENT","Savings Goals:Savings","Savings Goals","Savings",,$150.00,$0.00,C,$3958.42
"Us Bank",,,09/16/2015,"Download from usbank.com. CAPITAL ONE","Pre-YNAB Debt:Venture Card","Pre-YNAB Debt","Venture Card",,$493.22,$0.00,C,$3465.20
"Us Bank",,,09/17/2015,"Download from usbank.com. PLANET FIT","Everyday Expenses:Health & Fitness","Everyday Expenses","Health & Fitness",,$19.99,$0.00,C,$3445.21
"Us Bank",,,09/18/2015,"Download from usbank.com. APL* ITUNES.COM/866-712-7753CA","Everyday Expenses:Spending Money","Everyday Expenses","Spending Money",,$4.99,$0.00,C,$3440.22
"Us Bank",,,09/18/2015,"Download from usbank.com. VENMO","Everyday Expenses:Misc","Everyday Expenses","Misc",,$12.93,$0.00,C,$3427.29
"Us Bank",,,09/21/2015,"Download from usbank.com.","Income:Available this month","Income","Available this month",,$0.00,$402.36,C,$3829.65
"Us Bank",,,09/21/2015,"Download from usbank.com. BETTERMENT","Savings Goals:Savings","Savings Goals","Savings",,$500.00,$0.00,C,$3329.65
"Us Bank",,,09/22/2015,"Download from usbank.com. AIRBNB PAYMENTS","Income:Available this month","Income","Available this month",,$0.00,$291.00,C,$3620.65
"Us Bank",,,09/22/2015,"Download from usbank.com. BETTERMENT","Savings Goals:Savings","Savings Goals","Savings",,$202.36,$0.00,C,$3418.29
"Us Bank",,,09/22/2015,"Download from usbank.com. CAPITAL ONE","Pre-YNAB Debt:Venture Card","Pre-YNAB Debt","Venture Card",,$705.11,$0.00,C,$2713.18
"Us Bank",,,09/22/2015,"Download from usbank.com. FRANCHISE TAX BO","Debt:Fucking Taxes","Debt","Fucking Taxes",,$986.57,$0.00,C,$1726.61
"Us Bank",,,09/23/2015,"Download from usbank.com. PAYPAL","Income:Available this month","Income","Available this month",,$0.00,$66.89,C,$1793.50
"Us Bank",,,09/23/2015,"Download from usbank.com. PAYPAL","Income:Available this month","Income","Available this month",,$0.00,$40.00,C,$1833.50
"Us Bank",,,09/23/2015,"Download from usbank.com.","Income:Available this month","Income","Available this month",,$0.00,$6.95,C,$1840.45
"Us Bank",,,09/23/2015,"Download from usbank.com. PAYPAL","Everyday Expenses:Misc","Everyday Expenses","Misc",,$5.00,$0.00,C,$1835.45
"Us Bank",,,09/23/2015,"Download from usbank.com.","Income:Available this month","Income","Available this month",,$6.95,$0.00,C,$1828.50
"Us Bank",,,09/23/2015,"Download from usbank.com. PAYPAL","Monthly Bills:Web Stuff","Monthly Bills","Web Stuff",,$9.99,$0.00,C,$1818.51
"Us Bank",,,09/24/2015,"Download from usbank.com. PAYPAL","Everyday Expenses:Misc","Everyday Expenses","Misc",,$60.00,$0.00,C,$1758.51
"Us Bank",,,09/25/2015,"Download from usbank.com. MODCLOTH INC","Income:Available this month","Income","Available this month",,$0.00,$1684.31,C,$3442.82
"Us Bank",,,09/25/2015,"Download from usbank.com. FIVERR.COM","Everyday Expenses:Misc","Everyday Expenses","Misc",,$5.50,$0.00,C,$3437.32
"Us Bank",,,09/25/2015,"Download from usbank.com. VENMO","Savings Goals:Vacation & Travel","Savings Goals","Vacation & Travel",,$57.96,$0.00,C,$3379.36
"Us Bank",,,09/25/2015,"Download from usbank.com. US BANK SAN FRANSAN FRANCISCCAUS1","Everyday Expenses:Spending Money","Everyday Expenses","Spending Money",,$100.00,$0.00,C,$3279.36
"Us Bank",,,09/25/2015,"Download from usbank.com. PAYPAL","Everyday Expenses:Misc","Everyday Expenses","Misc",,$108.00,$0.00,C,$3171.36
"Us Bank",,,09/25/2015,"Download from usbank.com. CAPITAL ONE","Pre-YNAB Debt:Venture Card","Pre-YNAB Debt","Venture Card",,$267.50,$0.00,C,$2903.86
"Us Bank",,,09/28/2015,"Download from usbank.com. 7246","Debt:Eric's Credit Card","Debt","Eric's Credit Card",,$500.00,$0.00,C,$2403.86
"Us Bank",,,09/29/2015,"Download from usbank.com. AMAZON DIG660329","Everyday Expenses:Spending Money","Everyday Expenses","Spending Money",,$0.00,$0.57,C,$2404.43
"Us Bank",,,09/29/2015,"Download from usbank.com. CAPITAL ONE","Pre-YNAB Debt:Venture Card","Pre-YNAB Debt","Venture Card",,$439.72,$0.00,C,$1964.71
"Us Bank",,,09/30/2015,"Download from usbank.com. SQWIGGLE INC","Income:Available this month","Income","Available this month",,$0.00,$1798.57,C,$3763.28
"Us Bank",,,10/01/2015,"Download from usbank.com. PLANET FIT","Everyday Expenses:Health & Fitness","Everyday Expenses","Health & Fitness",,$39.00,$0.00,C,$3724.28
"Us Bank",,,10/01/2015,"Download from usbank.com. CAPITAL ONE","Pre-YNAB Debt:Venture Card","Pre-YNAB Debt","Venture Card",,$521.13,$0.00,C,$3203.15
"Us Bank",,,10/02/2015,"Download from usbank.com. PAYPAL","Everyday Expenses:Misc","Everyday Expenses","Misc",,$8.72,$0.00,C,$3194.43
"Us Bank",,,10/02/2015,"Download from usbank.com. BETTERMENT","Savings Goals:Savings","Savings Goals","Savings",,$50.00,$0.00,C,$3144.43
"Us Bank",,,10/02/2015,"Download from usbank.com. BETTERMENT","Savings Goals:Savings","Savings Goals","Savings",,$100.00,$0.00,C,$3044.43
"Us Bank",,,10/02/2015,"Download from usbank.com. Mosser Companies","Monthly Bills:Rent","Monthly Bills","Rent",,$1612.53,$0.00,C,$1431.90
"Us Bank",,,10/05/2015,"Download from usbank.com. GOOGLE*ADWS","Monthly Bills:Web Stuff","Monthly Bills","Web Stuff",,$0.38,$0.00,C,$1431.52
"Us Bank",,,10/05/2015,"Download from usbank.com. LYFT   *RIDE SUN8552800278  CA","Everyday Expenses:Transportation","Everyday Expenses","Transportation",,$24.72,$0.00,C,$1406.80
"Us Bank",,,10/05/2015,"Download from usbank.com. PAYPAL","Monthly Bills:Web Stuff","Monthly Bills","Web Stuff",,$50.39,$0.00,C,$1356.41
"Us Bank",,,10/07/2015,"Download from usbank.com. VENMO","Income:Available this month","Income","Available this month",,$0.00,$14.00,C,$1370.41
"Us Bank",,,10/08/2015,"Download from usbank.com. CAPITAL ONE","Pre-YNAB Debt:Venture Card","Pre-YNAB Debt","Venture Card",,$500.00,$0.00,C,$870.41
"Us Bank",,,10/09/2015,"Download from usbank.com. MODCLOTH INC","Income:Available this month","Income","Available this month",,$0.00,$1684.30,U,$2554.71
"Us Bank",,,10/13/2015,"Download from usbank.com. VENMO-0","Income:Available this month","Income","Available this month",,$0.00,$181.63,C,$2736.34
"Us Bank",,,10/13/2015,"Download from usbank.com. VENMO-0","Income:Available this month","Income","Available this month",,$0.00,$62.49,C,$2798.83
"Us Bank",,,10/13/2015,"Download from usbank.com. SANTA CRUZ PAY Bwww.parkmobiCA","Everyday Expenses:Transportation","Everyday Expenses","Transportation",,$3.40,$0.00,C,$2795.43
"Us Bank",,,10/13/2015,"Download from usbank.com. SANTA CRUZ PAY Bwww.parkmobiCA","Everyday Expenses:Transportation","Everyday Expenses","Transportation",,$5.35,$0.00,C,$2790.08
"Us Bank",,,10/13/2015,"Download from usbank.com. 7246","Debt:Eric's Credit Card","Debt","Eric's Credit Card",,$500.00,$0.00,C,$2290.08
"Us Bank",,,10/13/2015,"Download from usbank.com. CAPITAL ONE","Pre-YNAB Debt:Venture Card","Pre-YNAB Debt","Venture Card",,$568.43,$0.00,C,$1721.65
"Us Bank",,,10/14/2015,"Download from usbank.com. CAPITAL ONE","Pre-YNAB Debt:Venture Card","Pre-YNAB Debt","Venture Card",,$396.66,$0.00,C,$1324.99
"Us Bank",,,10/15/2015,"Download from usbank.com. SQWIGGLE INC","Income:Available this month","Income","Available this month",,$0.00,$1798.57,U,$3123.56
"Us Bank",,,10/15/2015,"Electronic Deposit Paypal","Savings Goals:Savings","Savings Goals","Savings",,$0.00,$338.58,U,$3462.14
"Us Bank",,,10/16/2015,"Download from usbank.com. BETTERMENT SEC","Savings Goals:Savings","Savings Goals","Savings",,$50.00,$0.00,C,$3412.14
"Us Bank",,,10/16/2015,"Download from usbank.com. BETTERMENT SEC","Savings Goals:Savings","Savings Goals","Savings",,$100.00,$0.00,C,$3312.14
"Us Bank",,,10/16/2015,"Download from usbank.com. BETTERMENT SEC","Savings Goals:Savings","Savings Goals","Savings",,$338.58,$0.00,C,$2973.56
"Us Bank",,,10/19/2015,"Electronic Deposit Paypal","Income:Available this month","Income","Available this month","camera sale",$0.00,$1688.26,C,$4661.82
"Us Bank",,,10/19/2015,"Download from usbank.com. WALGREENS 1300 BSAN FRANCISCCA---- You Requested $20.00 in Cash Back","Everyday Expenses:Household Goods","Everyday Expenses","Household Goods",,$23.25,$0.00,C,$4638.57
"Us Bank",,,10/19/2015,"Download from usbank.com. VENMO-2","Everyday Expenses:Spending Money","Everyday Expenses","Spending Money",,$120.00,$0.00,C,$4518.57
"Us Bank",,,10/19/2015,"Internet Banking Payment To Credit Card 7246","Debt:Eric's Credit Card","Debt","Eric's Credit Card",,$1456.67,$0.00,C,$3061.90
"Us Bank",,,10/20/2015,"Download from usbank.com. VENMO-0","Income:Available this month","Income","Available this month",,$0.00,$20.00,C,$3081.90
"Us Bank",,,10/21/2015,"Download from usbank.com. CAPITAL ONE","Pre-YNAB Debt:Venture Card","Pre-YNAB Debt","Venture Card",,$1006.52,$0.00,U,$2075.38
"Us Bank",,,10/22/2015,"Download from usbank.com. PAYPAL","Income:Available this month","Income","Available this month",,$0.00,$46.75,C,$2122.13
"Us Bank",,,10/22/2015,"Download from usbank.com. PROSPER MARKETPL","Everyday Expenses:Misc","Everyday Expenses","Misc",,$117.51,$0.00,C,$2004.62
"Us Bank",,,10/23/2015,"Download from usbank.com. MODCLOTH INC","Income:Available this month","Income","Available this month",,$0.00,$1684.31,C,$3688.93
"Us Bank",,,10/23/2015,"Download from usbank.com.","Income:Available this month","Income","Available this month",,$0.00,$6.95,C,$3695.88
"Us Bank",,,10/23/2015,"Download from usbank.com.","Income:Available this month","Income","Available this month",,$6.95,$0.00,C,$3688.93
"Us Bank",,,10/23/2015,"Download from usbank.com. PAYPAL","Monthly Bills:Web Stuff","Monthly Bills","Web Stuff",,$9.99,$0.00,C,$3678.94
"Us Bank",,,10/23/2015,"Download from usbank.com. SUPER DUPER KEARSAN FRANCISCCA","Everyday Expenses:Spending Money","Everyday Expenses","Spending Money",,$13.42,$0.00,C,$3665.52
"Us Bank",,,10/23/2015,"Download from usbank.com. CHASE",,,,,$36.49,$0.00,C,$3629.03
"Us Bank",,,10/26/2015,"Download from usbank.com. BART-CLIPPER CIVSAN FRANCISCCA","Everyday Expenses:Transportation","Everyday Expenses","Transportation",,$5.50,$0.00,C,$3623.53
"Us Bank",,,10/26/2015,"Download from usbank.com. BETTERMENT SEC","Savings Goals:Savings","Savings Goals","Savings",,$500.00,$0.00,C,$3123.53
"Us Bank",,,10/26/2015,"Download from usbank.com. CAPITAL ONE","Pre-YNAB Debt:Venture Card","Pre-YNAB Debt","Venture Card",,$568.43,$0.00,C,$2555.10
"Us Bank",,,10/28/2015,"Download from usbank.com.","Income:Available this month","Income","Available this month",,$0.00,$375.00,C,$2930.10
"Us Bank",,,10/28/2015,"Download from usbank.com. VENMO-0","Income:Available this month","Income","Available this month",,$0.00,$114.35,C,$3044.45
"Us Bank",,,10/28/2015,"Download from usbank.com. Banana Visa","Everyday Expenses:Spending Money","Everyday Expenses","Spending Money",,$113.89,$0.00,C,$2930.56
"Us Bank",,,10/28/2015,"Download from usbank.com. CAPITAL ONE","Pre-YNAB Debt:Venture Card","Pre-YNAB Debt","Venture Card",,$418.29,$0.00,C,$2512.27
"Us Bank",,,10/29/2015,"Download from usbank.com. BETTERMENT SEC","Savings Goals:Savings","Savings Goals","Savings",,$375.00,$0.00,C,$2137.27
"Us Bank",,,10/30/2015,"Download from usbank.com. SQWIGGLE INC","Income:Available this month","Income","Available this month",,$0.00,$1798.57,C,$3935.84
"Us Bank",,,10/30/2015,"Download from usbank.com. PROSPER MARKETPL","Everyday Expenses:Misc","Everyday Expenses","Misc",,$0.00,$137.78,C,$4073.62
"Us Bank",,,10/30/2015,"Download from usbank.com. BART-CLIPPER CIVSAN FRANCISCCA","Everyday Expenses:Transportation","Everyday Expenses","Transportation",,$7.65,$0.00,C,$4065.97
"Us Bank",,,10/30/2015,"Download from usbank.com. BART-CLIPPER CIVSAN FRANCISCCA","Everyday Expenses:Transportation","Everyday Expenses","Transportation",,$8.65,$0.00,C,$4057.32
"Us Bank",,,11/02/2015,"Download from usbank.com. AMAZON DIG669632","Everyday Expenses:Spending Money","Everyday Expenses","Spending Money",,$0.00,$0.57,C,$4057.89
"Us Bank",,,11/02/2015,"Download from usbank.com. PAYPAL","Income:Available this month","Income","Available this month",,$2.35,$0.00,C,$4055.54
"Us Bank",,,11/02/2015,"Download from usbank.com. CAPITAL ONE","Pre-YNAB Debt:Venture Card","Pre-YNAB Debt","Venture Card",,$469.12,$0.00,C,$3586.42
"Us Bank",,,11/02/2015,"Download from usbank.com. BETTERMENT SEC","Savings Goals:Savings","Savings Goals","Savings",,$1000.00,$0.00,C,$2586.42
"Us Bank",,,11/03/2015,"Download from usbank.com. GOOGLE*ADWS","Monthly Bills:Web Stuff","Monthly Bills","Web Stuff",,$8.74,$0.00,C,$2577.68
"Us Bank",,,11/03/2015,"Download from usbank.com. BETTERMENT SEC","Savings Goals:Savings","Savings Goals","Savings",,$150.00,$0.00,C,$2427.68
"Us Bank",,,11/03/2015,"Download from usbank.com. CAPITAL ONE","Pre-YNAB Debt:Venture Card","Pre-YNAB Debt","Venture Card",,$784.11,$0.00,C,$1643.57
"Us Bank",,,11/03/2015,"Download from usbank.com. Mosser Companies","Monthly Bills:Rent","Monthly Bills","Rent",,$1612.53,$0.00,C,$31.04
"Us Bank",,,11/04/2015,"Download from usbank.com. VENMO-0","Income:Available this month","Income","Available this month",,$0.00,$1573.53,C,$1604.57
"Us Bank",,,11/04/2015,"Download from usbank.com. VENMO-0","Income:Available this month","Income","Available this month",,$0.00,$321.96,C,$1926.53
"Us Bank",,,11/05/2015,"Download from usbank.com. CAPITAL ONE","Pre-YNAB Debt:Venture Card","Pre-YNAB Debt","Venture Card",,$475.71,$0.00,C,$1450.82
"Us Bank",,,11/06/2015,"Electronic Deposit Modcloth Inc","Income:Available this month","Income","Available this month",,$0.00,$1684.31,C,$3135.13
"Us Bank",,,11/06/2015,"Download from usbank.com. CAPITAL ONE","Pre-YNAB Debt:Venture Card","Pre-YNAB Debt","Venture Card",,$475.71,$0.00,C,$2659.42
"Us Bank",,,11/09/2015,"Download from usbank.com. VENMO           855-812-4430NY","Income:Available this month","Income","Available this month",,$23.33,$0.00,C,$2636.09
"Us Bank",,,11/09/2015,"Download from usbank.com. CAPITAL ONE","Pre-YNAB Debt:Venture Card","Pre-YNAB Debt","Venture Card",,$210.29,$0.00,C,$2425.80
"Us Bank",,,11/09/2015,"Download from usbank.com. BETTERMENT SEC","Savings Goals:Savings","Savings Goals","Savings",,$700.00,$0.00,C,$1725.80
"Us Bank",,,11/10/2015,"Download from usbank.com. 7246","Everyday Expenses:Spending Money","Everyday Expenses","Spending Money","",$10.00,$0.00,C,$1715.80
"Us Bank",,,11/12/2015,"Download from usbank.com. PAYPAL","Monthly Bills:Web Stuff","Monthly Bills","Web Stuff",,$5.00,$0.00,C,$1710.80
"Us Bank",,,11/12/2015,"Download from usbank.com. CAPITAL ONE","Pre-YNAB Debt:Venture Card","Pre-YNAB Debt","Venture Card",,$1000.00,$0.00,C,$710.80
"Us Bank",,,11/13/2015,"Download from usbank.com. SQWIGGLE INC","Income:Available this month","Income","Available this month",,$0.00,$1798.57,C,$2509.37
"Us Bank",,,11/13/2015,"Download from usbank.com. VENMO-0","Everyday Expenses:Misc","Everyday Expenses","Misc",,$0.00,$122.50,C,$2631.87
"Us Bank",,,11/16/2015,"Download from usbank.com.","Income:Available this month","Income","Available this month",,$0.00,$1013.00,C,$3644.87
"Us Bank",,,11/16/2015,"Download from usbank.com. VENMO-0","Everyday Expenses:Misc","Everyday Expenses","Misc",,$0.00,$80.00,C,$3724.87
"Us Bank",,,11/16/2015,"Download from usbank.com.","Income:Available this month","Income","Available this month",,$0.50,$0.00,C,$3724.37
"Us Bank",,,11/16/2015,"Download from usbank.com. CAPITAL ONE","Pre-YNAB Debt:Venture Card","Pre-YNAB Debt","Venture Card",,$157.39,$0.00,C,$3566.98
"Us Bank",,,11/17/2015,"Download from usbank.com. BETTERMENT SEC","Savings Goals:Savings","Savings Goals","Savings",,$150.00,$0.00,U,$3416.98
"Us Bank",,,11/17/2015,"Download from usbank.com. CAPITAL ONE","Pre-YNAB Debt:Venture Card","Pre-YNAB Debt","Venture Card",,$753.35,$0.00,U,$2663.63
"Us Bank",,,11/18/2015,"Download from usbank.com. BETTERMENT SEC","Savings Goals:Savings","Savings Goals","Savings",,$500.00,$0.00,C,$2163.63
"Us Bank",,,11/18/2015,"Download from usbank.com. CAPITAL ONE","Pre-YNAB Debt:Venture Card","Pre-YNAB Debt","Venture Card",,$611.12,$0.00,C,$1552.51
"Us Bank",,,11/19/2015,"Electronic Deposit Modcloth Inc","Income:Available this month","Income","Available this month",,$0.00,$1757.98,C,$3310.49
"Us Bank",,,11/19/2015,"Electronic Deposit Paypal","Income:Available this month","Income","Available this month",,$0.00,$44.69,C,$3355.18
"Us Bank",,,11/19/2015,"Debit Purchase Walgreens 1301 Olincoln Ne---- You Requested $5.00 in Cash Back","Everyday Expenses:Household Goods","Everyday Expenses","Household Goods",,$17.59,$0.00,U,$3337.59
"Us Bank",,,11/19/2015,"Download from usbank.com. BARCLAYS BANK DE","Income:Available this month","Income","Available this month","Taxes for Amir checl",$250.00,$0.00,U,$3087.59
"Us Bank",,,11/20/2015,"Download from usbank.com. 112015PLUSTERM408 S 11TH ST   LINCOLN     NEUS1","Everyday Expenses:Spending Money","Everyday Expenses","Spending Money",,$2.50,$0.00,C,$3085.09
"Us Bank",,,11/20/2015,"Download from usbank.com. 408 S 11TH ST   LINCOLN     NEUS1","Everyday Expenses:Spending Money","Everyday Expenses","Spending Money",,$42.00,$0.00,C,$3043.09
"Us Bank",,,11/23/2015,"Download from usbank.com. PAYPAL","Monthly Bills:Web Stuff","Monthly Bills","Web Stuff",,$9.99,$0.00,C,$3033.10
"Us Bank",,,11/23/2015,"Download from usbank.com. VENMO-2","Everyday Expenses:Spending Money","Everyday Expenses","Spending Money",,$15.00,$0.00,C,$3018.10
"Us Bank",,,11/23/2015,"Download from usbank.com. VENMO-2","Everyday Expenses:Spending Money","Everyday Expenses","Spending Money",,$22.65,$0.00,C,$2995.45
"Us Bank",,,11/23/2015,"Download from usbank.com. VENMO-2","Everyday Expenses:Spending Money","Everyday Expenses","Spending Money",,$55.00,$0.00,C,$2940.45
"Us Bank",,,11/23/2015,"Download from usbank.com. CAPITAL ONE","Pre-YNAB Debt:Venture Card","Pre-YNAB Debt","Venture Card",,$202.67,$0.00,C,$2737.78
"Us Bank",,,11/23/2015,"Download from usbank.com. BETTERMENT SEC","Savings Goals:Savings","Savings Goals","Savings",,$1000.00,$0.00,C,$1737.78
"Us Bank",,,11/24/2015,"Download from usbank.com.","Income:Available this month","Income","Available this month",,$0.00,$6.95,C,$1744.73
"Us Bank",,,11/24/2015,"Download from usbank.com. APL* ITUNES.COM/866-712-7753CA","Everyday Expenses:Spending Money","Everyday Expenses","Spending Money",,$1.99,$0.00,C,$1742.74
"Us Bank",,,11/24/2015,"Download from usbank.com. PAYPAL","Everyday Expenses:Spending Money","Everyday Expenses","Spending Money",,$2.78,$0.00,C,$1739.96
"Us Bank",,,11/24/2015,"Download from usbank.com.","Income:Available this month","Income","Available this month",,$6.95,$0.00,C,$1733.01
"Us Bank",,,11/24/2015,"Download from usbank.com. CAPITAL ONE","Pre-YNAB Debt:Venture Card","Pre-YNAB Debt","Venture Card",,$212.57,$0.00,C,$1520.44
"Us Bank",,,11/30/2015,"Download from usbank.com. SQWIGGLE INC","Income:Available this month","Income","Available this month",,$0.00,$1798.57,C,$3319.01
"Us Bank",,,12/02/2015,"Download from usbank.com. VENMO-0","Monthly Bills:Rent","Monthly Bills","Rent",,$0.00,$1650.36,C,$4969.37
"Us Bank",,,12/02/2015,"Download from usbank.com. VENMO-0","Everyday Expenses:Misc","Everyday Expenses","Misc",,$0.00,$74.00,C,$5043.37
"Us Bank",,,12/02/2015,"Download from usbank.com. BETTERMENT SEC","Savings Goals:Savings","Savings Goals","Savings",,$500.00,$0.00,C,$4543.37
"Us Bank",,,12/02/2015,"Download from usbank.com. CAPITAL ONE","Pre-YNAB Debt:Venture Card","Pre-YNAB Debt","Venture Card",,$877.12,$0.00,C,$3666.25
"Us Bank",,,12/02/2015,"Download from usbank.com. Mosser Companies","Monthly Bills:Rent","Monthly Bills","Rent",,$1612.53,$0.00,C,$2053.72
"Us Bank",,,12/03/2015,"Download from usbank.com. VENMO-2","Everyday Expenses:Spending Money","Everyday Expenses","Spending Money",,$108.00,$0.00,C,$1945.72
"Us Bank",,,12/04/2015,"Download from usbank.com. MODCLOTH INC","Income:Available this month","Income","Available this month",,$0.00,$1684.31,C,$3630.03
"Us Bank",,,12/08/2015,"Download from usbank.com. CAPITAL ONE","Pre-YNAB Debt:Venture Card","Pre-YNAB Debt","Venture Card",,$451.02,$0.00,C,$3179.01
"Us Bank",,,12/09/2015,"Download from usbank.com. VENMO-0","Everyday Expenses:Misc","Everyday Expenses","Misc",,$0.00,$43.99,C,$3223.00
"Us Bank",,,12/10/2015,"Download from usbank.com. VENMO-0","Everyday Expenses:Misc","Everyday Expenses","Misc",,$0.00,$30.00,C,$3253.00
"Us Bank",,,12/10/2015,"Download from usbank.com. PAYPAL","Everyday Expenses:Spending Money","Everyday Expenses","Spending Money",,$0.00,$27.30,C,$3280.30
"Us Bank",,,12/10/2015,"Download from usbank.com. VENMO           855-812-4430NY","Income:Available this month","Income","Available this month",,$10.00,$0.00,C,$3270.30
"Us Bank",,,12/10/2015,"Download from usbank.com. CAPITAL ONE","Pre-YNAB Debt:Venture Card","Pre-YNAB Debt","Venture Card",,$201.18,$0.00,C,$3069.12
"Us Bank",,,12/10/2015,"Download from usbank.com. BETTERMENT SEC","Savings Goals:Savings","Savings Goals","Savings",,$1000.00,$0.00,C,$2069.12
"Us Bank",,,12/11/2015,"Download from usbank.com. PAYONEER INC.","Income:Available this month","Income","Available this month",,$0.00,$1075.65,C,$3144.77
"Us Bank",,,12/11/2015,"Download from usbank.com. VENMO-2","Everyday Expenses:Spending Money","Everyday Expenses","Spending Money",,$92.00,$0.00,C,$3052.77
"Us Bank",,,12/14/2015,"Download from usbank.com. VENMO-2","Everyday Expenses:Spending Money","Everyday Expenses","Spending Money",,$20.00,$0.00,C,$3032.77
"Us Bank",,,12/14/2015,"Download from usbank.com. VENMO-2","Everyday Expenses:Spending Money","Everyday Expenses","Spending Money",,$92.38,$0.00,C,$2940.39
"Us Bank",,,12/14/2015,"Download from usbank.com. PAYPAL","Everyday Expenses:Spending Money","Everyday Expenses","Spending Money",,$110.00,$0.00,C,$2830.39
"Us Bank",,,12/15/2015,"Download from usbank.com. SQWIGGLE INC","Income:Available this month","Income","Available this month",,$0.00,$1798.57,C,$4628.96
"Us Bank",,,12/15/2015,"Download from usbank.com. CAPITAL ONE","Pre-YNAB Debt:Venture Card","Pre-YNAB Debt","Venture Card",,$651.56,$0.00,C,$3977.40
"Amazon Credit Card",,,06/21/2015,"Starting Balance","Pre-YNAB Debt:Amazon Credit Card","Pre-YNAB Debt","Amazon Credit Card",,$0.00,$0.00,C,$0.00
"Amazon Credit Card",,,06/21/2015,"Test","Everyday Expenses:Spending Money","Everyday Expenses","Spending Money",,$5.00,$0.00,U,-$5.00
"Venture Card",,,07/14/2015,"Starting Balance","Pre-YNAB Debt:Venture Card","Pre-YNAB Debt","Venture Card",,$0.00,$59.97,C,$59.97
"Venture Card",,,07/14/2015,"KABUKI RESTAURANT SAN FRANCISCO","Everyday Expenses:Spending Money","Everyday Expenses","Spending Money","6548: KABUKI RESTAURANT SAN FRANCISCO CA 94115 US",$19.00,$0.00,C,$40.97
"Venture Card",,,07/14/2015,"0282 PLANET FITNESS SAN FRANCISC","Everyday Expenses:Health & Fitness","Everyday Expenses","Health & Fitness","6548: 0282 PLANET FITNESS SAN FRANCISCO CA 94114 US",$40.97,$0.00,C,$0.00
"Venture Card",,,07/16/2015,"GETAROUND 8664382768 CA 94103 US","Everyday Expenses:Transportation","Everyday Expenses","Transportation","6548: GETAROUND 8664382768 CA 94103 US",$0.00,$73.00,C,$73.00
"Venture Card",,,07/16/2015,"GETAROUND WWW.GETAROUND CA 94103","Everyday Expenses:Transportation","Everyday Expenses","Transportation","6548: GETAROUND WWW.GETAROUND CA 94103 US",$73.00,$0.00,C,$0.00
"Venture Card",,,07/16/2015,"GETAROUND WWW.GETAROUND CA 94103","Everyday Expenses:Transportation","Everyday Expenses","Transportation","6548: GETAROUND WWW.GETAROUND CA 94103 US",$83.50,$0.00,C,-$83.50
"Venture Card",,,07/17/2015,"SUSHI TOSUKI SAN FRANCISCO CA 94","Everyday Expenses:Spending Money","Everyday Expenses","Spending Money","6548: SUSHI TOSUKI SAN FRANCISCO CA 94104 US",$7.60,$0.00,C,-$91.10
"Venture Card",,,07/17/2015,"SQ *BIBIMBAR San Francisco CA 94","Everyday Expenses:Spending Money","Everyday Expenses","Spending Money","6548: SQ *BIBIMBAR San Francisco CA 94104 US",$9.79,$0.00,C,-$100.89
"Venture Card",,,07/17/2015,"ADY*Spotify USA 646-8375380 NY 1","Monthly Bills:Web Stuff","Monthly Bills","Web Stuff","6548: ADY*Spotify USA 646-8375380 NY 10011 US",$9.99,$0.00,C,-$110.88
"Venture Card",,,07/17/2015,"SUTTER FINE FOOD SAN FRANCISCO C","Everyday Expenses:Groceries","Everyday Expenses","Groceries","6548: SUTTER FINE FOOD SAN FRANCISCO CA 94109 US",$10.10,$0.00,C,-$120.98
"Venture Card",,,07/17/2015,"DOLCE GELATO SAN FRANCISCO CA 94","Everyday Expenses:Spending Money","Everyday Expenses","Spending Money","6548: DOLCE GELATO SAN FRANCISCO CA 94109 US",$17.38,$0.00,C,-$138.36
"Venture Card",,,07/17/2015,"CLASSPASS.COM 888-493-5953 NY 10","Everyday Expenses:Health & Fitness","Everyday Expenses","Health & Fitness","6548: CLASSPASS.COM 888-493-5953 NY 10001 US",$20.00,$0.00,C,-$158.36
"Venture Card",,,07/17/2015,"FEIST WINES FEIST.MYSHOPI CA 956","Everyday Expenses:Spending Money","Everyday Expenses","Spending Money","6548: FEIST WINES FEIST.MYSHOPI CA 95601 US",$53.75,$0.00,C,-$212.11
"Venture Card",,,07/18/2015,"SQ *BLUE BOTTLE COFFEE, M San Fr","Everyday Expenses:Coffee Shop","Everyday Expenses","Coffee Shop","6548: SQ *BLUE BOTTLE COFFEE, M San Francisco CA 94108 US",$14.25,$0.00,C,-$226.36
"Venture Card",,,07/18/2015,"SQ *FEIST WINES Amador City CA 9","Everyday Expenses:Spending Money","Everyday Expenses","Spending Money","6548: SQ *FEIST WINES Amador City CA 95601 US",$16.15,$0.00,C,-$242.51
"Venture Card",,,07/18/2015,"SQ *FEIST WINES Amador City CA 9","Everyday Expenses:Spending Money","Everyday Expenses","Spending Money","6548: SQ *FEIST WINES Amador City CA 95601 US",$27.00,$0.00,C,-$269.51
"Venture Card",,,07/18/2015,"SQ *DIGGINS CAFE Amador City CA","Everyday Expenses:Spending Money","Everyday Expenses","Spending Money","6548: SQ *DIGGINS CAFE Amador City CA 95601 US",$33.45,$0.00,C,-$302.96
"Venture Card",,,07/18/2015,"SQ *FEIST WINES Amador City CA 9","Everyday Expenses:Spending Money","Everyday Expenses","Spending Money","6548: SQ *FEIST WINES Amador City CA 95601 US",$37.26,$0.00,C,-$340.22
"Venture Card",,,07/18/2015,"WALGREENS #13666 SAN FRANCISCO C","Everyday Expenses:Household Goods","Everyday Expenses","Household Goods","6548: WALGREENS #13666 SAN FRANCISCO CA 94109 US",$41.94,$0.00,C,-$382.16
"Venture Card",,,07/18/2015,"IMPERIAL HOTEL OF AMAD AMADOR CI","Everyday Expenses:Spending Money","Everyday Expenses","Spending Money","6548: IMPERIAL HOTEL OF AMAD AMADOR CITY CA 95601 US",$155.88,$0.00,C,-$538.04
"Venture Card",,,07/19/2015,"GETAROUND 866-438-2768 CA 94103","Everyday Expenses:Transportation","Everyday Expenses","Transportation","6548: GETAROUND 866-438-2768 CA 94103 US",$7.50,$0.00,C,-$545.54
"Venture Card",,,07/19/2015,"GUITAR CENTER #220 SAN FRANCISCO","Everyday Expenses:Spending Money","Everyday Expenses","Spending Money","6548: GUITAR CENTER #220 SAN FRANCISCO CA 94109 US",$14.12,$0.00,C,-$559.66
"Venture Card",,,07/19/2015,"IMPERIAL HOTEL OF AMAD AMADOR CI","Everyday Expenses:Spending Money","Everyday Expenses","Spending Money","6548: IMPERIAL HOTEL OF AMAD AMADOR CITY CA 95601 US",$17.00,$0.00,C,-$576.66
"Venture Card",,,07/19/2015,"CHIPOTLE 1013 DUBLIN CA 94568 US","Everyday Expenses:Spending Money","Everyday Expenses","Spending Money","6548: CHIPOTLE 1013 DUBLIN CA 94568 US",$18.51,$0.00,C,-$595.17
"Venture Card",,,07/19/2015,"NARA SUSHI SAN FRANCISCO CA 9410","Everyday Expenses:Spending Money","Everyday Expenses","Spending Money","6548: NARA SUSHI SAN FRANCISCO CA 94109 US",$24.75,$0.00,C,-$619.92
"Venture Card",,,07/19/2015,"QUIK STOP #0003 Q80 OAKLAND CA 9","Everyday Expenses:Transportation","Everyday Expenses","Transportation","6548: QUIK STOP #0003 Q80 OAKLAND CA 94610 US",$25.00,$0.00,C,-$644.92
"Venture Card",,,07/19/2015,"BROWNIES HARDWARE STORE SAN FRAN","Everyday Expenses:Spending Money","Everyday Expenses","Spending Money","6548: BROWNIES HARDWARE STORE SAN FRANCISCO CA 94109 US",$33.31,$0.00,C,-$678.23
"Venture Card",,,07/19/2015,"TRADER JOE'S #200 QPS SAN FRANCI","Everyday Expenses:Groceries","Everyday Expenses","Groceries","6548: TRADER JOE'S #200 QPS SAN FRANCISCO CA 94109 US",$57.66,$0.00,C,-$735.89
"Venture Card",,,07/20/2015,"CHIPOTLE 1857 SAN FRANCISCO CA 9","Everyday Expenses:Spending Money","Everyday Expenses","Spending Money","6548: CHIPOTLE 1857 SAN FRANCISCO CA 94104 US",$8.32,$0.00,C,-$744.21
"Venture Card",,,07/20/2015,"STARBUCKS CARD RELOAD 800-782-72","Everyday Expenses:Coffee Shop","Everyday Expenses","Coffee Shop","6548: STARBUCKS CARD RELOAD 800-782-7282 WA 98134 US",$10.00,$0.00,C,-$754.21
"Venture Card",,,07/20/2015,"BITE SAN FRANCISCO CA 94109 US","Everyday Expenses:Spending Money","Everyday Expenses","Spending Money","6548: BITE SAN FRANCISCO CA 94109 US",$19.99,$0.00,C,-$774.20
"Venture Card",,,07/21/2015,"SQ *BLUE BOTTLE COFFEE San Franc","Everyday Expenses:Coffee Shop","Everyday Expenses","Coffee Shop","6548: SQ *BLUE BOTTLE COFFEE San Francisco CA 94104 US",$4.25,$0.00,C,-$778.45
"Venture Card",,,07/21/2015,"SUSHI TOSUKI SAN FRANCISCO CA 94","Everyday Expenses:Spending Money","Everyday Expenses","Spending Money","6548: SUSHI TOSUKI SAN FRANCISCO CA 94104 US",$7.60,$0.00,C,-$786.05
"Venture Card",,,07/21/2015,"SQ *BIBIMBAR San Francisco CA 94","Everyday Expenses:Spending Money","Everyday Expenses","Spending Money","6548: SQ *BIBIMBAR San Francisco CA 94104 US",$9.24,$0.00,C,-$795.29
"Venture Card",,,07/21/2015,"CHIPOTLE 1857 SAN FRANCISCO CA 9","Everyday Expenses:Spending Money","Everyday Expenses","Spending Money","6548: CHIPOTLE 1857 SAN FRANCISCO CA 94104 US",$19.25,$0.00,C,-$814.54
"Venture Card",,,07/21/2015,"ETSY.COM 888-961-4798 NY 11201 U","Everyday Expenses:Spending Money","Everyday Expenses","Spending Money","6548: ETSY.COM 888-961-4798 NY 11201 US",$61.00,$0.00,C,-$875.54
"Venture Card",,,07/22/2015,"SPOONROCKET.COM 510-921-9929 CA","Everyday Expenses:Spending Money","Everyday Expenses","Spending Money","6548: SPOONROCKET.COM 510-921-9929 CA 94703 US",$8.93,$0.00,C,-$884.47
"Venture Card",,,07/22/2015,"WALGREENS #13666 SAN FRANCISCO C","Everyday Expenses:Household Goods","Everyday Expenses","Household Goods","6548: WALGREENS #13666 SAN FRANCISCO CA 94109 US",$17.38,$0.00,C,-$901.85
"Venture Card",,,07/23/2015,"CAPITAL ONE ONLINE PYMT AuthDate","Pre-YNAB Debt:Venture Card","Pre-YNAB Debt","Venture Card","6548: CAPITAL ONE ONLINE PYMT AuthDate 23-JUL",$0.00,$935.51,C,$33.66
"Venture Card",,,07/23/2015,"Coffee Bar Montgomery SF CA 9410","Everyday Expenses:Coffee Shop","Everyday Expenses","Coffee Shop","7622: Coffee Bar Montgomery SF CA 94104 US",$4.64,$0.00,C,$29.02
"Venture Card",,,07/23/2015,"BAMBOO ASIA SAN FRANCISCO CA 941","Everyday Expenses:Spending Money","Everyday Expenses","Spending Money","6548: BAMBOO ASIA SAN FRANCISCO CA 94104 US",$9.73,$0.00,C,$19.29
"Venture Card",,,07/24/2015,"SQ *CUP A JOE COFFE SAN FRANCISC","Everyday Expenses:Coffee Shop","Everyday Expenses","Coffee Shop","6548: SQ *CUP A JOE COFFE SAN FRANCISCO CA 94109 US",$2.25,$0.00,C,$17.04
"Venture Card",,,07/24/2015,"SQ *CUP A JOE COFFE SAN FRANCISC","Everyday Expenses:Coffee Shop","Everyday Expenses","Coffee Shop","7622: SQ *CUP A JOE COFFE SAN FRANCISCO CA 94109 US",$5.50,$0.00,C,$11.54
"Venture Card",,,07/24/2015,"HLU*Hulu 22744533-U HULU.COM/BIL","Monthly Bills:Web Stuff","Monthly Bills","Web Stuff","6548: HLU*Hulu 22744533-U HULU.COM/BILL CA 90064 US",$7.99,$0.00,C,$3.55
"Venture Card",,,07/24/2015,"BISTRO BURGER BUSH SAN FRANCISCO","Everyday Expenses:Spending Money","Everyday Expenses","Spending Money","6548: BISTRO BURGER BUSH SAN FRANCISCO CA 94104 US",$12.24,$0.00,C,-$8.69
"Venture Card",,,07/24/2015,"FLY SAN FRANCISCO CA 94109 US","Everyday Expenses:Spending Money","Everyday Expenses","Spending Money","7622: FLY SAN FRANCISCO CA 94109 US",$31.58,$0.00,C,-$40.27
"Venture Card",,,07/24/2015,"TARGET 00032011 SAN FRANCISCO CA","Everyday Expenses:Household Goods","Everyday Expenses","Household Goods","7622: TARGET 00032011 SAN FRANCISCO CA 94104 US",$105.11,$0.00,C,-$145.38
"Venture Card",,,07/25/2015,"SQ *WORKSHOP CAFE San Francisco","Everyday Expenses:Coffee Shop","Everyday Expenses","Coffee Shop","7622: SQ *WORKSHOP CAFE San Francisco CA 94104 US",$4.00,$0.00,C,-$149.38
"Venture Card",,,07/25/2015,"UBER 866-576-1039 CA 94105 US","Everyday Expenses:Transportation","Everyday Expenses","Transportation","6548: UBER 866-576-1039 CA 94105 US",$7.00,$0.00,C,-$156.38
"Venture Card",,,07/25/2015,"CHIPOTLE 1857 SAN FRANCISCO CA 9","Everyday Expenses:Spending Money","Everyday Expenses","Spending Money","6548: CHIPOTLE 1857 SAN FRANCISCO CA 94104 US",$10.06,$0.00,C,-$166.44
"Venture Card",,,07/25/2015,"CHIPOTLE 1230 SAN FRANCISCO CA 9","Everyday Expenses:Spending Money","Everyday Expenses","Spending Money","7622: CHIPOTLE 1230 SAN FRANCISCO CA 94102 US",$19.68,$0.00,C,-$186.12
"Venture Card",,,07/25/2015,"WALGREENS #13666 SAN FRANCISCO C","Everyday Expenses:Household Goods","Everyday Expenses","Household Goods","7622: WALGREENS #13666 SAN FRANCISCO CA 94109 US",$21.18,$0.00,C,-$207.30
"Venture Card",,,07/26/2015,"UBER TECHNOLOGIES INC 866-576-10","Everyday Expenses:Transportation","Everyday Expenses","Transportation","6548: UBER TECHNOLOGIES INC 866-576-1039 CA 94103 US",$7.00,$0.00,C,-$214.30
"Venture Card",,,07/26/2015,"BROWNIES HARDWARE STORE SAN FRAN","Everyday Expenses:Household Goods","Everyday Expenses","Household Goods","6548: BROWNIES HARDWARE STORE SAN FRANCISCO CA 94109 US",$10.32,$0.00,C,-$224.62
"Venture Card",,,07/26/2015,"HOUSE RULES SAN FRANCISCO CA 941","Everyday Expenses:Spending Money","Everyday Expenses","Spending Money","7622: HOUSE RULES SAN FRANCISCO CA 94109 US",$28.02,$0.00,C,-$252.64
"Venture Card",,,07/26/2015,"SUTTER FINE FOOD SAN FRANCISCO C","Everyday Expenses:Groceries","Everyday Expenses","Groceries","7622: SUTTER FINE FOOD SAN FRANCISCO CA 94109 US",$31.00,$0.00,C,-$283.64
"Venture Card",,,07/26/2015,"GUITAR CENTER #220 SAN FRANCISCO","Everyday Expenses:Misc","Everyday Expenses","Misc","6548: GUITAR CENTER #220 SAN FRANCISCO CA 94109 US",$60.66,$0.00,C,-$344.30
"Venture Card",,,07/26/2015,"TRADER JOE'S #200 QPS SAN FRANCI","Everyday Expenses:Groceries","Everyday Expenses","Groceries","7622: TRADER JOE'S #200 QPS SAN FRANCISCO CA 94109 US",$86.63,$0.00,C,-$430.93
"Venture Card",,,07/27/2015,"SQ *CONTRABAND COFFEE IMM San Fr","Everyday Expenses:Coffee Shop","Everyday Expenses","Coffee Shop","6548: SQ *CONTRABAND COFFEE IMM San Francisco CA 94104 US",$3.00,$0.00,C,-$433.93
"Venture Card",,,07/27/2015,"CAFE AMBROSIA SAN FRANCISCO CA 9","Everyday Expenses:Spending Money","Everyday Expenses","Spending Money","7622: CAFE AMBROSIA SAN FRANCISCO CA 94104 US",$3.50,$0.00,C,-$437.43
"Venture Card",,,07/27/2015,"LYFT *RIDE MON 5PM 855-280-0278","Everyday Expenses:Transportation","Everyday Expenses","Transportation","6548: LYFT *RIDE MON 5PM 855-280-0278 CA 94104 US",$5.00,$0.00,C,-$442.43
"Venture Card",,,07/27/2015,"SQ *CUP A JOE COFFE SAN FRANCISC","Everyday Expenses:Coffee Shop","Everyday Expenses","Coffee Shop","7622: SQ *CUP A JOE COFFE SAN FRANCISCO CA 94109 US",$6.50,$0.00,C,-$448.93
"Venture Card",,,07/27/2015,"SQ *MOKA COFFEE San Francisco CA","Everyday Expenses:Spending Money","Everyday Expenses","Spending Money","6548: SQ *MOKA COFFEE San Francisco CA 94109 US",$9.00,$0.00,C,-$457.93
"Venture Card",,,07/27/2015,"FRESHROLL SAN FRANCISCO CA 94104","Everyday Expenses:Spending Money","Everyday Expenses","Spending Money","7622: FRESHROLL SAN FRANCISCO CA 94104 US",$9.51,$0.00,C,-$467.44
"Venture Card",,,07/27/2015,"BART-CLIPPER MONTGOMERY 51046469","Everyday Expenses:Transportation","Everyday Expenses","Transportation","7622: BART-CLIPPER MONTGOMERY 5104646979 CA 94104 US",$9.60,$0.00,C,-$477.04
"Venture Card",,,07/28/2015,"CAPITAL ONE ONLINE PYMT AuthDate","Pre-YNAB Debt:Venture Card","Pre-YNAB Debt","Venture Card","6548: CAPITAL ONE ONLINE PYMT AuthDate 28-JUL",$0.00,$402.22,C,-$74.82
"Venture Card",,,07/28/2015,"LYFT *RIDE MON 5PM 855-280-0278","Everyday Expenses:Transportation","Everyday Expenses","Transportation","6548: LYFT *RIDE MON 5PM 855-280-0278 CA 94104 US",$6.00,$0.00,C,-$80.82
"Venture Card",,,07/28/2015,"SQ *CAFE ME San Francisco CA 941","Everyday Expenses:Spending Money","Everyday Expenses","Spending Money","6548: SQ *CAFE ME San Francisco CA 94104 US",$6.52,$0.00,C,-$87.34
"Venture Card",,,07/29/2015,"SPOONROCKET.COM 510-921-9929 CA","Everyday Expenses:Spending Money","Everyday Expenses","Spending Money","6548: SPOONROCKET.COM 510-921-9929 CA 94703 US",$8.65,$0.00,C,-$95.99
"Venture Card",,,07/29/2015,"TRADER JOE'S #200 QPS SAN FRANCI","Everyday Expenses:Groceries","Everyday Expenses","Groceries","6548: TRADER JOE'S #200 QPS SAN FRANCISCO CA 94109 US",$37.88,$0.00,C,-$133.87
"Venture Card",,,07/30/2015,"WORKING GIRLS CAFE #2 SAN FRANCI","Everyday Expenses:Spending Money","Everyday Expenses","Spending Money","6548: WORKING GIRLS CAFE #2 SAN FRANCISCO CA 94108 US",$10.82,$0.00,C,-$144.69
"Venture Card",,,07/31/2015,"SQ *ANOTHER CAFE San Francisco C","Everyday Expenses:Coffee Shop","Everyday Expenses","Coffee Shop","7622: SQ *ANOTHER CAFE San Francisco CA 94104 US",$8.59,$0.00,C,-$153.28
"Venture Card",,,07/31/2015,"SPOONROCKET.COM 5109219929 CA 94","Everyday Expenses:Spending Money","Everyday Expenses","Spending Money","7622: SPOONROCKET.COM 5109219929 CA 94703 US",$17.45,$0.00,C,-$170.73
"Venture Card",,,07/31/2015,"SQ *ESTELA'S San Francisco CA 94","Everyday Expenses:Spending Money","Everyday Expenses","Spending Money","6548: SQ *ESTELA'S San Francisco CA 94109 US",$20.12,$0.00,C,-$190.85
"Venture Card",,,07/31/2015,"BEVERAGES & MORE #71 SAN FRANCIS","Everyday Expenses:Spending Money","Everyday Expenses","Spending Money","7622: BEVERAGES & MORE #71 SAN FRANCISCO CA 94109 US",$24.90,$0.00,C,-$215.75
"Venture Card",,,07/31/2015,"WALGREENS #5618 SAN FRANCISCO CA","Everyday Expenses:Household Goods","Everyday Expenses","Household Goods","7622: WALGREENS #5618 SAN FRANCISCO CA 94104 US",$26.06,$0.00,C,-$241.81
"Venture Card",,,08/01/2015,"SHELL OIL 57444597009 SAN FRANCI","Everyday Expenses:Transportation","Everyday Expenses","Transportation","6548: SHELL OIL 57444597009 SAN FRANCISCO CA 94124 US",$2.07,$0.00,C,-$243.88
"Venture Card",,,08/01/2015,"GETAROUND 866-438-2768 CA 94103","Everyday Expenses:Transportation","Everyday Expenses","Transportation","6548: GETAROUND 866-438-2768 CA 94103 US",$5.62,$0.00,C,-$249.50
"Venture Card",,,08/01/2015,"WALGREENS #13666 SAN FRANCISCO C","Everyday Expenses:Household Goods","Everyday Expenses","Household Goods","7622: WALGREENS #13666 SAN FRANCISCO CA 94109 US",$8.15,$0.00,C,-$257.65
"Venture Card",,,08/01/2015,"BOUDIN 424 MACY'S SAN FRANCISCO","Everyday Expenses:Spending Money","Everyday Expenses","Spending Money","6548: BOUDIN 424 MACY'S SAN FRANCISCO CA 94102 US",$8.29,$0.00,C,-$265.94
"Venture Card",,,08/01/2015,"GETAROUND 866-438-2768 CA 94103","Everyday Expenses:Transportation","Everyday Expenses","Transportation","6548: GETAROUND 866-438-2768 CA 94103 US",$9.75,$0.00,C,-$275.69
"Venture Card",,,08/01/2015,"HARRY'S BAR SAN FRANCISCO CA 941","Everyday Expenses:Spending Money","Everyday Expenses","Spending Money","7622: HARRY'S BAR SAN FRANCISCO CA 94115 US",$29.14,$0.00,C,-$304.83
"Venture Card",,,08/01/2015,"KYOTO SUSHI SAN FRANCISCO CA 941","Everyday Expenses:Spending Money","Everyday Expenses","Spending Money","7622: KYOTO SUSHI SAN FRANCISCO CA 94109 US",$42.99,$0.00,C,-$347.82
"Venture Card",,,08/01/2015,"LOWES #03095* SAN FRANCISCO CA 9","Everyday Expenses:Misc","Everyday Expenses","Misc","6548: LOWES #03095* SAN FRANCISCO CA 94124 US",$152.89,$0.00,C,-$500.71
"Venture Card",,,08/02/2015,"MUSTAFIO'S PIZZA SAN FRANCISCO C","Everyday Expenses:Spending Money","Everyday Expenses","Spending Money","6548: MUSTAFIO'S PIZZA SAN FRANCISCO CA 94109 US",$7.79,$0.00,C,-$508.50
"Venture Card",,,08/02/2015,"SQ *CONTRABAND COFFEE IMM San Fr","Everyday Expenses:Coffee Shop","Everyday Expenses","Coffee Shop","6548: SQ *CONTRABAND COFFEE IMM San Francisco CA 94109 US",$8.50,$0.00,C,-$517.00
"Venture Card",,,08/02/2015,"SUTTER FINE FOOD SAN FRANCISCO C","Everyday Expenses:Groceries","Everyday Expenses","Groceries","7622: SUTTER FINE FOOD SAN FRANCISCO CA 94109 US",$9.99,$0.00,C,-$526.99
"Venture Card",,,08/02/2015,"BITTERS, BOCK AND RYE SAN FRANCI","Everyday Expenses:Spending Money","Everyday Expenses","Spending Money","6548: BITTERS, BOCK AND RYE SAN FRANCISCO CA 94109 US",$38.00,$0.00,C,-$564.99
"Venture Card",,,08/02/2015,"WALGREENS #13666 SAN FRANCISCO C","Everyday Expenses:Household Goods","Everyday Expenses","Household Goods","7622: WALGREENS #13666 SAN FRANCISCO CA 94109 US",$45.67,$0.00,C,-$610.66
"Venture Card",,,08/02/2015,"CLASSPASS.COM CLASSPAS 888-493-5","Everyday Expenses:Health & Fitness","Everyday Expenses","Health & Fitness","7622: CLASSPASS.COM CLASSPAS 888-493-5953 NY 10001 US",$99.00,$0.00,C,-$709.66
"Venture Card",,,08/03/2015,"PEET'S #30202 SAN FRANCISCO CA 9","Everyday Expenses:Coffee Shop","Everyday Expenses","Coffee Shop","6548: PEET'S #30202 SAN FRANCISCO CA 94108 US",$0.92,$0.00,C,-$710.58
"Venture Card",,,08/03/2015,"SQ *BLUE BOTTLE COFFEE San Franc","Everyday Expenses:Coffee Shop","Everyday Expenses","Coffee Shop","7622: SQ *BLUE BOTTLE COFFEE San Francisco CA 94104 US",$3.00,$0.00,C,-$713.58
"Venture Card",,,08/03/2015,"CHIPOTLE 1857 SAN FRANCISCO CA 9","Everyday Expenses:Spending Money","Everyday Expenses","Spending Money","6548: CHIPOTLE 1857 SAN FRANCISCO CA 94104 US",$8.32,$0.00,C,-$721.90
"Venture Card",,,08/03/2015,"FRESHROLL SAN FRANCISCO CA 94104","Everyday Expenses:Spending Money","Everyday Expenses","Spending Money","7622: FRESHROLL SAN FRANCISCO CA 94104 US",$9.51,$0.00,C,-$731.41
"Venture Card",,,08/03/2015,"AMZ*BeautifiedSkinandW SAN FRANC","Everyday Expenses:Spending Money","Everyday Expenses","Spending Money","7622: AMZ*BeautifiedSkinandW SAN FRANCISCO CA 94109 US",$65.00,$0.00,C,-$796.41
"Venture Card",,,08/03/2015,"WHOLEFDS FRK 10044 SAN FRANCISCO","Everyday Expenses:Groceries","Everyday Expenses","Groceries","7622: WHOLEFDS FRK 10044 SAN FRANCISCO CA 94109 US",$106.14,$0.00,C,-$902.55
"Venture Card",,,08/04/2015,"CAPITAL ONE ONLINE PYMT AuthDate","Pre-YNAB Debt:Venture Card","Pre-YNAB Debt","Venture Card","6548: CAPITAL ONE ONLINE PYMT AuthDate 04-AUG",$0.00,$769.63,C,-$132.92
"Venture Card",,,08/04/2015,"WORKING GIRLS CAFE #2 SAN FRANCI","Everyday Expenses:Spending Money","Everyday Expenses","Spending Money","6548: WORKING GIRLS CAFE #2 SAN FRANCISCO CA 94108 US",$10.82,$0.00,C,-$143.74
"Venture Card",,,08/04/2015,"URBAN-OUTFITTERS-DIR #219 972-55","Everyday Expenses:Clothing","Everyday Expenses","Clothing","7622: URBAN-OUTFITTERS-DIR #219 972-550-2751 PA 19112 US",$58.71,$0.00,C,-$202.45
"Venture Card",,,08/05/2015,"SQ *CONTRABAND COFFEE IMM San Fr","Everyday Expenses:Coffee Shop","Everyday Expenses","Coffee Shop","6548: SQ *CONTRABAND COFFEE IMM San Francisco CA 94109 US",$6.75,$0.00,C,-$209.20
"Venture Card",,,08/05/2015,"SPOONROCKET.COM 510-921-9929 CA","Everyday Expenses:Spending Money","Everyday Expenses","Spending Money","6548: SPOONROCKET.COM 510-921-9929 CA 94703 US",$8.65,$0.00,C,-$217.85
"Venture Card",,,08/05/2015,"GHOST PERSONAL +442072242824 000","Monthly Bills:Web Stuff","Monthly Bills","Web Stuff","6548: GHOST PERSONAL +442072242824 00000 GB",$10.00,$0.00,C,-$227.85
"Venture Card",,,08/05/2015,"AMAZON MKTPLACE PMTS AMZN.COM/BI","Everyday Expenses:Spending Money","Everyday Expenses","Spending Money","7622: AMAZON MKTPLACE PMTS AMZN.COM/BILL WA 98109 US",$22.49,$0.00,C,-$250.34
"Venture Card",,,08/05/2015,"SOUTHWES 5262132164876 800-435-9","Savings Goals:Vacation & Travel","Savings Goals","Vacation & Travel","7622: SOUTHWES 5262132164876 800-435-9792 TX 75235 US",$676.00,$0.00,C,-$926.34
"Venture Card",,,08/06/2015,"SQ *BLUE BOTTLE COFFEE San Franc","Everyday Expenses:Coffee Shop","Everyday Expenses","Coffee Shop","7622: SQ *BLUE BOTTLE COFFEE San Francisco CA 94104 US",$4.25,$0.00,C,-$930.59
"Venture Card",,,08/06/2015,"CHIPOTLE 1857 SAN FRANCISCO CA 9","Everyday Expenses:Spending Money","Everyday Expenses","Spending Money","6548: CHIPOTLE 1857 SAN FRANCISCO CA 94104 US",$8.32,$0.00,C,-$938.91
"Venture Card",,,08/06/2015,"BITE SAN FRANCISCO CA 94109 US","Everyday Expenses:Spending Money","Everyday Expenses","Spending Money","7622: BITE SAN FRANCISCO CA 94109 US",$20.53,$0.00,C,-$959.44
"Venture Card",,,08/06/2015,"BIERE RESTAURANT & LOU SAN FRANC","Everyday Expenses:Spending Money","Everyday Expenses","Spending Money","7622: BIERE RESTAURANT & LOU SAN FRANCISCO CA 94105 US",$57.79,$0.00,C,-$1017.23
"Venture Card",,,08/07/2015,"LYFT *RIDE FRI 6PM 855-280-0278","Everyday Expenses:Transportation","Everyday Expenses","Transportation","6548: LYFT *RIDE FRI 6PM 855-280-0278 CA 94104 US",$6.00,$0.00,C,-$1023.23
"Venture Card",,,08/07/2015,"LYFT *RIDE FRI 10PM 855-280-0278","Everyday Expenses:Transportation","Everyday Expenses","Transportation","6548: LYFT *RIDE FRI 10PM 855-280-0278 CA 94104 US",$6.00,$0.00,C,-$1029.23
"Venture Card",,,08/07/2015,"LYFT *RIDE THU 9PM 855-280-0278","Everyday Expenses:Transportation","Everyday Expenses","Transportation","6548: LYFT *RIDE THU 9PM 855-280-0278 CA 94104 US",$6.00,$0.00,C,-$1035.23
"Venture Card",,,08/07/2015,"SQ *MAYO & MUSTARD San Francisco","Everyday Expenses:Spending Money","Everyday Expenses","Spending Money","6548: SQ *MAYO & MUSTARD San Francisco CA 94133 US",$10.90,$0.00,C,-$1046.13
"Venture Card",,,08/07/2015,"DNA PIZZA SAN FRANCISC CA 94103","Everyday Expenses:Spending Money","Everyday Expenses","Spending Money","6548: DNA PIZZA SAN FRANCISC CA 94103 US",$13.00,$0.00,C,-$1059.13
"Venture Card",,,08/07/2015,"DNA PIZZA SAN FRANCISC CA 94103","Everyday Expenses:Spending Money","Everyday Expenses","Spending Money","6548: DNA PIZZA SAN FRANCISC CA 94103 US",$14.00,$0.00,C,-$1073.13
"Venture Card",,,08/07/2015,"SQ *CUPCAKE COVE San Francisco C","Everyday Expenses:Spending Money","Everyday Expenses","Spending Money","7622: SQ *CUPCAKE COVE San Francisco CA 94104 US",$15.00,$0.00,C,-$1088.13
"Venture Card",,,08/07/2015,"DNA PIZZA SAN FRANCISC CA 94103","Everyday Expenses:Spending Money","Everyday Expenses","Spending Money","6548: DNA PIZZA SAN FRANCISC CA 94103 US",$27.77,$0.00,C,-$1115.90
"Venture Card",,,08/07/2015,"MODCLOTH INC. 888-4959699 CA 941","Everyday Expenses:Clothing","Everyday Expenses","Clothing","7622: MODCLOTH INC. 888-4959699 CA 94104 US",$115.35,$0.00,C,-$1231.25
"Venture Card",,,08/08/2015,"CAPITAL ONE ONLINE PYMT AuthDate","Pre-YNAB Debt:Venture Card","Pre-YNAB Debt","Venture Card","6548: CAPITAL ONE ONLINE PYMT AuthDate 08-AUG",$0.00,$998.88,C,-$232.37
"Venture Card",,,08/08/2015,"CREDIT-TRAVEL REWARD","Pre-YNAB Debt:Venture Card","Pre-YNAB Debt","Venture Card","6548: CREDIT-TRAVEL REWARD",$0.00,$462.15,C,$229.78
"Venture Card",,,08/08/2015,"APL* ITUNES.COM/BILL 866-712-775","Everyday Expenses:Spending Money","Everyday Expenses","Spending Money","6548: APL* ITUNES.COM/BILL 866-712-7753 CA 95014 US",$2.99,$0.00,C,$226.79
"Venture Card",,,08/08/2015,"SHELL OIL 57444597009 SAN FRANCI","Everyday Expenses:Transportation","Everyday Expenses","Transportation","6548: SHELL OIL 57444597009 SAN FRANCISCO CA 94124 US",$3.03,$0.00,C,$223.76
"Venture Card",,,08/08/2015,"GETAROUND 866-438-2768 CA 94103","Everyday Expenses:Transportation","Everyday Expenses","Transportation","6548: GETAROUND 866-438-2768 CA 94103 US",$10.00,$0.00,C,$213.76
"Venture Card",,,08/08/2015,"STARBUCKS #05517 SAN FRAN San Fr","Everyday Expenses:Coffee Shop","Everyday Expenses","Coffee Shop","6548: STARBUCKS #05517 SAN FRAN San Francisco CA 94109 US",$10.00,$0.00,C,$203.76
"Venture Card",,,08/08/2015,"LOWES #03095* SAN FRANCISCO CA 9","Everyday Expenses:Misc","Everyday Expenses","Misc","6548: LOWES #03095* SAN FRANCISCO CA 94124 US",$13.03,$0.00,C,$190.73
"Venture Card",,,08/08/2015,"GETAROUND 866-438-2768 CA 94103","Everyday Expenses:Transportation","Everyday Expenses","Transportation","6548: GETAROUND 866-438-2768 CA 94103 US",$21.00,$0.00,C,$169.73
"Venture Card",,,08/08/2015,"GRUBSTAKE INC SAN FRANCISCO CA 9","Everyday Expenses:Spending Money","Everyday Expenses","Spending Money","7622: GRUBSTAKE INC SAN FRANCISCO CA 94109 US",$26.69,$0.00,C,$143.04
"Venture Card",,,08/08/2015,"NARA SUSHI SAN FRANCISCO CA 9410","Everyday Expenses:Spending Money","Everyday Expenses","Spending Money","6548: NARA SUSHI SAN FRANCISCO CA 94109 US",$52.88,$0.00,C,$90.16
"Venture Card",,,08/08/2015,"MODCLOTH 888-495-9699 CA 94107 U","Everyday Expenses:Clothing","Everyday Expenses","Clothing","7622: MODCLOTH 888-495-9699 CA 94107 US",$68.44,$0.00,C,$21.72
"Venture Card",,,08/08/2015,"WALGREENS #13666 SAN FRANCISCO C","Everyday Expenses:Household Goods","Everyday Expenses","Household Goods","7622: WALGREENS #13666 SAN FRANCISCO CA 94109 US",$72.82,$0.00,C,-$51.10
"Venture Card",,,08/08/2015,"COMCAST CALIFORNIA 800-COMCAST C","Monthly Bills:Internet","Monthly Bills","Internet","6548: COMCAST CALIFORNIA 800-COMCAST CA 94551 US",$77.83,$0.00,C,-$128.93
"Venture Card",,,08/08/2015,"LOWES #03095* SAN FRANCISCO CA 9","Everyday Expenses:Misc","Everyday Expenses","Misc","7622: LOWES #03095* SAN FRANCISCO CA 94124 US",$271.37,$0.00,C,-$400.30
"Venture Card",,,08/09/2015,"BROWNIES HARDWARE STORE SAN FRAN","Everyday Expenses:Household Goods","Everyday Expenses","Household Goods","6548: BROWNIES HARDWARE STORE SAN FRANCISCO CA 94109 US",$10.95,$0.00,C,-$411.25
"Venture Card",,,08/09/2015,"CHEESE PLUS SAN FRANCISCO CA 941","Everyday Expenses:Spending Money","Everyday Expenses","Spending Money","6548: CHEESE PLUS SAN FRANCISCO CA 94109 US",$23.25,$0.00,C,-$434.50
"Venture Card",,,08/10/2015,"Coffee Bar Montgomery SF CA 9410","Everyday Expenses:Coffee Shop","Everyday Expenses","Coffee Shop","6548: Coffee Bar Montgomery SF CA 94104 US",$4.64,$0.00,C,-$439.14
"Venture Card",,,08/10/2015,"BELLISSIMO PIZZA SAN FRANCISCO C","Everyday Expenses:Spending Money","Everyday Expenses","Spending Money","7622: BELLISSIMO PIZZA SAN FRANCISCO CA 94109 US",$7.00,$0.00,C,-$446.14
"Venture Card",,,08/10/2015,"CHIPOTLE 1857 SAN FRANCISCO CA 9","Everyday Expenses:Spending Money","Everyday Expenses","Spending Money","6548: CHIPOTLE 1857 SAN FRANCISCO CA 94104 US",$8.32,$0.00,C,-$454.46
"Venture Card",,,08/10/2015,"SPOONROCKET.COM 510-921-9929 CA","Everyday Expenses:Spending Money","Everyday Expenses","Spending Money","6548: SPOONROCKET.COM 510-921-9929 CA 94703 US",$8.65,$0.00,C,-$463.11
"Venture Card",,,08/10/2015,"Coffee Bar Montgomery SF CA 9410","Everyday Expenses:Coffee Shop","Everyday Expenses","Coffee Shop","7622: Coffee Bar Montgomery SF CA 94104 US",$8.76,$0.00,C,-$471.87
"Venture Card",,,08/10/2015,"MUNCHERY, INC. 888-458-5376 CA 9","Everyday Expenses:Spending Money","Everyday Expenses","Spending Money","7622: MUNCHERY, INC. 888-458-5376 CA 94110 US",$10.66,$0.00,C,-$482.53
"Venture Card",,,08/10/2015,"SQ *COUNTRY GRILL San Francisco","Everyday Expenses:Spending Money","Everyday Expenses","Spending Money","7622: SQ *COUNTRY GRILL San Francisco CA 94104 US",$11.00,$0.00,C,-$493.53
"Venture Card",,,08/11/2015,"THE POSH BAGEL SAN FRANCISCO CA","Everyday Expenses:Spending Money","Everyday Expenses","Spending Money","7622: THE POSH BAGEL SAN FRANCISCO CA 94108 US",$5.50,$0.00,C,-$499.03
"Venture Card",,,08/11/2015,"SF SOUP CO MONTGOMERY ST SAN FRA","Everyday Expenses:Spending Money","Everyday Expenses","Spending Money","7622: SF SOUP CO MONTGOMERY ST SAN FRANCISCO CA 94104 US",$6.24,$0.00,C,-$505.27
"Venture Card",,,08/11/2015,"BAMBOO ASIA SAN FRANCISCO CA 941","Everyday Expenses:Spending Money","Everyday Expenses","Spending Money","7622: BAMBOO ASIA SAN FRANCISCO CA 94104 US",$9.73,$0.00,C,-$515.00
"Venture Card",,,08/11/2015,"SUTTER FINE FOOD SAN FRANCISCO C","Everyday Expenses:Groceries","Everyday Expenses","Groceries","7622: SUTTER FINE FOOD SAN FRANCISCO CA 94109 US",$11.97,$0.00,C,-$526.97
"Venture Card",,,08/12/2015,"CAPITAL ONE ONLINE PYMT AuthDate","Pre-YNAB Debt:Venture Card","Pre-YNAB Debt","Venture Card","6548: CAPITAL ONE ONLINE PYMT AuthDate 11-AUG",$0.00,$491.33,C,-$35.64
"Venture Card",,,08/12/2015,"SOUTHWES 5262134146388 800-435-9","Savings Goals:Vacation & Travel","Savings Goals","Vacation & Travel","7622: SOUTHWES 5262134146388 800-435-9792 TX 75235 US",$8.00,$0.00,C,-$43.64
"Venture Card",,,08/12/2015,"CHIPOTLE 0839 SAN FRANCISCO CA 9","Everyday Expenses:Spending Money","Everyday Expenses","Spending Money","7622: CHIPOTLE 0839 SAN FRANCISCO CA 94104 US",$10.82,$0.00,C,-$54.46
"Venture Card",,,08/12/2015,"Audible 888-283-5051 NJ 07470 US","Monthly Bills:Web Stuff","Monthly Bills","Web Stuff","6548: Audible 888-283-5051 NJ 07470 US",$14.95,$0.00,C,-$69.41
"Venture Card",,,08/12/2015,"MR HOLMES BAKEHOUSE SAN FRANCISC","Everyday Expenses:Spending Money","Everyday Expenses","Spending Money","7622: MR HOLMES BAKEHOUSE SAN FRANCISCO CA 94109 US",$34.80,$0.00,C,-$104.21
"Venture Card",,,08/12/2015,"TRADER JOE'S #200 QPS SAN FRANCI","Everyday Expenses:Groceries","Everyday Expenses","Groceries","6548: TRADER JOE'S #200 QPS SAN FRANCISCO CA 94109 US",$51.37,$0.00,C,-$155.58
"Venture Card",,,08/13/2015,"SF SOUP CO MONTGOMERY ST SAN FRA","Everyday Expenses:Spending Money","Everyday Expenses","Spending Money","7622: SF SOUP CO MONTGOMERY ST SAN FRANCISCO CA 94104 US",$9.35,$0.00,C,-$164.93
"Venture Card",,,08/13/2015,"WORKING GIRLS CAFE #2 SAN FRANCI","Everyday Expenses:Spending Money","Everyday Expenses","Spending Money","6548: WORKING GIRLS CAFE #2 SAN FRANCISCO CA 94108 US",$10.82,$0.00,C,-$175.75
"Venture Card",,,08/13/2015,"CVS/PHARMACY #10080 SAN FRANCISC","Everyday Expenses:Household Goods","Everyday Expenses","Household Goods","6548: CVS/PHARMACY #10080 SAN FRANCISCO CA 94109 US",$15.00,$0.00,C,-$190.75
"Venture Card",,,08/14/2015,"CAPITAL ONE ONLINE PYMT AuthDate","Pre-YNAB Debt:Venture Card","Pre-YNAB Debt","Venture Card","6548: CAPITAL ONE ONLINE PYMT AuthDate 14-AUG",$0.00,$180.75,C,-$10.00
"Venture Card",,,08/14/2015,"ORDERAHEAD AYOLA (KEAR ORDERAHEA","Everyday Expenses:Spending Money","Everyday Expenses","Spending Money","7622: ORDERAHEAD AYOLA (KEAR ORDERAHEADAPP CA 94103 US",$8.16,$0.00,C,-$18.16
"Venture Card",,,08/14/2015,"SPOONROCKET.COM 510-921-9929 CA","Everyday Expenses:Spending Money","Everyday Expenses","Spending Money","6548: SPOONROCKET.COM 510-921-9929 CA 94703 US",$17.29,$0.00,C,-$35.45
"Venture Card",,,08/14/2015,"GETAROUND 866-438-2768 CA 94103","Everyday Expenses:Transportation","Everyday Expenses","Transportation","6548: GETAROUND 866-438-2768 CA 94103 US",$59.00,$0.00,C,-$94.45
"Venture Card",,,08/14/2015,"AT&T*BILL PAYMENT 800-331-0500 T","Monthly Bills:Cell Phone","Monthly Bills","Cell Phone","6548: AT&T*BILL PAYMENT 800-331-0500 TX 75202 US",$142.70,$0.00,C,-$237.15
"Venture Card",,,08/15/2015,"WHOLEFDS FRK 10044 SAN FRANCISCO","Everyday Expenses:Groceries","Everyday Expenses","Groceries","6548: WHOLEFDS FRK 10044 SAN FRANCISCO CA 94109 US",$4.25,$0.00,C,-$241.40
"Venture Card",,,08/15/2015,"THE BOVINE BAKERY INC PT REYES S","Everyday Expenses:Spending Money","Everyday Expenses","Spending Money","7622: THE BOVINE BAKERY INC PT REYES STA CA 94956 US",$10.25,$0.00,C,-$251.65
"Venture Card",,,08/15/2015,"CHEVRON 00090030 SAN FRANCISCO C","Everyday Expenses:Transportation","Everyday Expenses","Transportation","6548: CHEVRON 00090030 SAN FRANCISCO CA 94109 US",$15.05,$0.00,C,-$266.70
"Venture Card",,,08/15/2015,"FLY SAN FRANCISCO CA 94109 US","Everyday Expenses:Spending Money","Everyday Expenses","Spending Money","7622: FLY SAN FRANCISCO CA 94109 US",$33.60,$0.00,C,-$300.30
"Venture Card",,,08/15/2015,"WHOLEFDS FRK 10044 SAN FRANCISCO","Everyday Expenses:Groceries","Everyday Expenses","Groceries","7622: WHOLEFDS FRK 10044 SAN FRANCISCO CA 94109 US",$39.49,$0.00,C,-$339.79
"Venture Card",,,08/15/2015,"BRENDA'S FRENCH SO SAN FRANCISCO","Everyday Expenses:Spending Money","Everyday Expenses","Spending Money","6548: BRENDA'S FRENCH SO SAN FRANCISCO CA 94102 US",$73.23,$0.00,C,-$413.02
"Venture Card",,,08/16/2015,"MEL'S DRIVE-IN #3 SAN FRANCISCO","Everyday Expenses:Spending Money","Everyday Expenses","Spending Money","7622: MEL'S DRIVE-IN #3 SAN FRANCISCO CA 94109 US",$18.39,$0.00,C,-$431.41
"Venture Card",,,08/16/2015,"AMC VAN NESS 14 #0434 SAN FRANCI","Everyday Expenses:Spending Money","Everyday Expenses","Spending Money","7622: AMC VAN NESS 14 #0434 SAN FRANCISCO CA 94109 US",$21.58,$0.00,C,-$452.99
"Venture Card",,,08/16/2015,"RYE SAN FRANCISCO CA 94102 US","Everyday Expenses:Spending Money","Everyday Expenses","Spending Money","6548: RYE SAN FRANCISCO CA 94102 US",$67.81,$0.00,C,-$520.80
"Venture Card",,,08/16/2015,"TRADER JOE'S #200 QPS SAN FRANCI","Everyday Expenses:Groceries","Everyday Expenses","Groceries","6548: TRADER JOE'S #200 QPS SAN FRANCISCO CA 94109 US",$102.95,$0.00,C,-$623.75
"Venture Card",,,08/17/2015,"CAPITAL ONE ONLINE PYMT AuthDate","Pre-YNAB Debt:Venture Card","Pre-YNAB Debt","Venture Card","6548: CAPITAL ONE ONLINE PYMT AuthDate 16-AUG",$0.00,$288.96,C,-$334.79
"Venture Card",,,08/17/2015,"PEET'S #30202 SAN FRANCISCO CA 9","Everyday Expenses:Coffee Shop","Everyday Expenses","Coffee Shop","6548: PEET'S #30202 SAN FRANCISCO CA 94108 US",$1.42,$0.00,C,-$336.21
"Venture Card",,,08/17/2015,"SQ *BEANSTALK CAFE San Francisco","Everyday Expenses:Coffee Shop","Everyday Expenses","Coffee Shop","7622: SQ *BEANSTALK CAFE San Francisco CA 94104 US",$4.00,$0.00,C,-$340.21
"Venture Card",,,08/17/2015,"CHIPOTLE 1857 SAN FRANCISCO CA 9","Everyday Expenses:Spending Money","Everyday Expenses","Spending Money","6548: CHIPOTLE 1857 SAN FRANCISCO CA 94104 US",$8.32,$0.00,C,-$348.53
"Venture Card",,,08/17/2015,"ADY*Spotify USA 646-8375380 NY 1","Monthly Bills:Web Stuff","Monthly Bills","Web Stuff","6548: ADY*Spotify USA 646-8375380 NY 10011 US",$9.99,$0.00,C,-$358.52
"Venture Card",,,08/17/2015,"CAFE MADELEINE - CALIF SAN FRANC","Everyday Expenses:Spending Money","Everyday Expenses","Spending Money","7622: CAFE MADELEINE - CALIF SAN FRANCISCO CA 94121 US",$10.25,$0.00,C,-$368.77
"Venture Card",,,08/17/2015,"ROUND THE CLOCK MARKET SAN FRANC","Everyday Expenses:Spending Money","Everyday Expenses","Spending Money","7622: ROUND THE CLOCK MARKET SAN FRANCISCO CA 94109 US",$10.86,$0.00,C,-$379.63
"Venture Card",,,08/17/2015,"AMAZON MKTPLACE PMTS AMZN.COM/BI","Everyday Expenses:Misc","Everyday Expenses","Misc","6548: AMAZON MKTPLACE PMTS AMZN.COM/BILL WA 98109 US",$490.99,$0.00,C,-$870.62
"Venture Card",,,08/18/2015,"PEET'S #30202 SAN FRANCISCO CA 9","Everyday Expenses:Coffee Shop","Everyday Expenses","Coffee Shop","6548: PEET'S #30202 SAN FRANCISCO CA 94108 US",$1.42,$0.00,C,-$872.04
"Venture Card",,,08/18/2015,"SQ *BLUE BOTTLE COFFEE San Franc","Everyday Expenses:Coffee Shop","Everyday Expenses","Coffee Shop","7622: SQ *BLUE BOTTLE COFFEE San Francisco CA 94104 US",$4.25,$0.00,C,-$876.29
"Venture Card",,,08/18/2015,"CHIPOTLE 1857 SAN FRANCISCO CA 9","Everyday Expenses:Spending Money","Everyday Expenses","Spending Money","6548: CHIPOTLE 1857 SAN FRANCISCO CA 94104 US",$8.32,$0.00,C,-$884.61
"Venture Card",,,08/19/2015,"CAPITAL ONE ONLINE PYMT AuthDate","Pre-YNAB Debt:Venture Card","Pre-YNAB Debt","Venture Card","6548: CAPITAL ONE ONLINE PYMT AuthDate 19-AUG",$0.00,$909.48,C,$24.87
"Venture Card",,,08/19/2015,"SQ *BLUE BOTTLE COFFEE San Franc","Everyday Expenses:Coffee Shop","Everyday Expenses","Coffee Shop","7622: SQ *BLUE BOTTLE COFFEE San Francisco CA 94104 US",$8.25,$0.00,C,$16.62
"Venture Card",,,08/19/2015,"Dropbox*2X2LLD69NW3Q db.tt/cchel","Monthly Bills:Web Stuff","Monthly Bills","Web Stuff","6548: Dropbox*2X2LLD69NW3Q db.tt/cchelp CA 94107 US",$9.99,$0.00,C,$6.63
"Venture Card",,,08/19/2015,"Audible US 888-283-5051 NJ 07470","Monthly Bills:Web Stuff","Monthly Bills","Web Stuff","6548: Audible US 888-283-5051 NJ 07470 US",$10.46,$0.00,C,-$3.83
"Venture Card",,,08/20/2015,"WORKING GIRLS CAFE #2 SAN FRANCI","Everyday Expenses:Spending Money","Everyday Expenses","Spending Money","6548: WORKING GIRLS CAFE #2 SAN FRANCISCO CA 94108 US",$10.82,$0.00,C,-$14.65
"Venture Card",,,08/20/2015,"AIRBNB INC 415-800-5959 CA 94103","Savings Goals:Vacation & Travel","Savings Goals","Vacation & Travel","7622: AIRBNB INC 415-800-5959 CA 94103 US",$801.00,$0.00,C,-$815.65
"Venture Card",,,08/21/2015,"CHIPOTLE 1857 SAN FRANCISCO CA 9","Everyday Expenses:Spending Money","Everyday Expenses","Spending Money","6548: CHIPOTLE 1857 SAN FRANCISCO CA 94104 US",$8.32,$0.00,C,-$823.97
"Venture Card",,,08/21/2015,"PAOJAO DUMPLING AND NO SAN FRANC","Everyday Expenses:Spending Money","Everyday Expenses","Spending Money","7622: PAOJAO DUMPLING AND NO SAN FRANCISCO CA 94104 US",$10.33,$0.00,C,-$834.30
"Venture Card",,,08/21/2015,"SUTTER FINE FOOD SAN FRANCISCO C","Everyday Expenses:Groceries","Everyday Expenses","Groceries","7622: SUTTER FINE FOOD SAN FRANCISCO CA 94109 US",$15.18,$0.00,C,-$849.48
"Venture Card",,,08/21/2015,"MODCLOTH 888-495-9699 CA 94107 U","Everyday Expenses:Clothing","Everyday Expenses","Clothing","7622: MODCLOTH 888-495-9699 CA 94107 US",$68.44,$0.00,C,-$917.92
"Venture Card",,,08/22/2015,"SUTTER FINE FOOD SAN FRANCISCO C","Everyday Expenses:Groceries","Everyday Expenses","Groceries","7622: SUTTER FINE FOOD SAN FRANCISCO CA 94109 US",$5.99,$0.00,C,-$923.91
"Venture Card",,,08/22/2015,"BROWNIES HARDWARE STORE SAN FRAN","Everyday Expenses:Household Goods","Everyday Expenses","Household Goods","6548: BROWNIES HARDWARE STORE SAN FRANCISCO CA 94109 US",$9.77,$0.00,C,-$933.68
"Venture Card",,,08/22/2015,"ADY*Spotify USA 646-8375380 NY 1","Monthly Bills:Web Stuff","Monthly Bills","Web Stuff","7622: ADY*Spotify USA 646-8375380 NY 10011 US",$9.99,$0.00,C,-$943.67
"Venture Card",,,08/22/2015,"WALGREENS #13666 SAN FRANCISCO C","Everyday Expenses:Household Goods","Everyday Expenses","Household Goods","7622: WALGREENS #13666 SAN FRANCISCO CA 94109 US",$19.42,$0.00,C,-$963.09
"Venture Card",,,08/22/2015,"SQ *NEW VILLAGE CAFE San Francis","Everyday Expenses:Spending Money","Everyday Expenses","Spending Money","7622: SQ *NEW VILLAGE CAFE San Francisco CA 94109 US",$23.45,$0.00,C,-$986.54
"Venture Card",,,08/22/2015,"TRADER JOE'S #200 QPS SAN FRANCI","Everyday Expenses:Groceries","Everyday Expenses","Groceries","7622: TRADER JOE'S #200 QPS SAN FRANCISCO CA 94109 US",$39.35,$0.00,C,-$1025.89
"Venture Card",,,08/22/2015,"WALGREENS #13666 SAN FRANCISCO C","Everyday Expenses:Household Goods","Everyday Expenses","Household Goods","6548: WALGREENS #13666 SAN FRANCISCO CA 94109 US",$57.88,$0.00,C,-$1083.77
"Venture Card",,,08/23/2015,"SQ *BLUE BOTTLE COFFEE, F San Fr","Everyday Expenses:Coffee Shop","Everyday Expenses","Coffee Shop","7622: SQ *BLUE BOTTLE COFFEE, F San Francisco CA 94105 US",$8.50,$0.00,C,-$1092.27
"Venture Card",,,08/23/2015,"TRADER JOE'S #200 QPS SAN FRANCI","Everyday Expenses:Groceries","Everyday Expenses","Groceries","7622: TRADER JOE'S #200 QPS SAN FRANCISCO CA 94109 US",$20.53,$0.00,C,-$1112.80
"Venture Card",,,08/23/2015,"NARA SUSHI SAN FRANCISCO CA 9410","Everyday Expenses:Spending Money","Everyday Expenses","Spending Money","6548: NARA SUSHI SAN FRANCISCO CA 94109 US",$79.81,$0.00,C,-$1192.61
"Venture Card",,,08/23/2015,"CAJUN ENCOUNTERS SLIDELL LA 7046","Savings Goals:Vacation & Travel","Savings Goals","Vacation & Travel","7622: CAJUN ENCOUNTERS SLIDELL LA 70461 US",$110.00,$0.00,C,-$1302.61
"Venture Card",,,08/24/2015,"SF SOUP CO MONTGOMERY ST SAN FRA","Everyday Expenses:Spending Money","Everyday Expenses","Spending Money","7622: SF SOUP CO MONTGOMERY ST SAN FRANCISCO CA 94104 US",$3.35,$0.00,C,-$1305.96
"Venture Card",,,08/24/2015,"LYFT *RIDE MON 6PM 855-280-0278","Everyday Expenses:Transportation","Everyday Expenses","Transportation","6548: LYFT *RIDE MON 6PM 855-280-0278 CA 94104 US",$6.66,$0.00,C,-$1312.62
"Venture Card",,,08/24/2015,"LYFT *RIDE MON 9PM 855-280-0278","Everyday Expenses:Spending Money","Everyday Expenses","Spending Money","6548: LYFT *RIDE MON 9PM 855-280-0278 CA 94104 US",$6.70,$0.00,C,-$1319.32
"Venture Card",,,08/24/2015,"HLU*Hulu 22744533-U HULU.COM/BIL","Monthly Bills:Web Stuff","Monthly Bills","Web Stuff","6548: HLU*Hulu 22744533-U HULU.COM/BILL CA 90064 US",$7.99,$0.00,C,-$1327.31
"Venture Card",,,08/24/2015,"TACOLICIOUS II SAN FRANCISCO CA","Everyday Expenses:Spending Money","Everyday Expenses","Spending Money","7622: TACOLICIOUS II SAN FRANCISCO CA 94131 US",$47.57,$0.00,C,-$1374.88
"Venture Card",,,08/24/2015,"AMAZON MKTPLACE PMTS AMZN.COM/BI","Everyday Expenses:Misc","Everyday Expenses","Misc","6548: AMAZON MKTPLACE PMTS AMZN.COM/BILL WA 98109 US",$504.99,$0.00,C,-$1879.87
"Venture Card",,,08/25/2015,"CAPITAL ONE ONLINE PYMT AuthDate","Pre-YNAB Debt:Venture Card","Pre-YNAB Debt","Venture Card","6548: CAPITAL ONE ONLINE PYMT AuthDate 24-AUG",$0.00,$952.38,C,-$927.49
"Venture Card",,,08/25/2015,"SQ *BLUE BOTTLE COFFEE San Franc","Everyday Expenses:Coffee Shop","Everyday Expenses","Coffee Shop","7622: SQ *BLUE BOTTLE COFFEE San Francisco CA 94104 US",$4.25,$0.00,C,-$931.74
"Venture Card",,,08/25/2015,"GROUPON INC 877-788-7858 IL 6065","Everyday Expenses:Spending Money","Everyday Expenses","Spending Money","7622: GROUPON INC 877-788-7858 IL 60654 US",$13.99,$0.00,C,-$945.73
"Venture Card",,,08/25/2015,"URBAN-OUTFITTERS-DIR #219 972-55","Everyday Expenses:Clothing","Everyday Expenses","Clothing","7622: URBAN-OUTFITTERS-DIR #219 972-550-2751 PA 19112 US",$62.47,$0.00,C,-$1008.20
"Venture Card",,,08/26/2015,"PEET'S #30202 SAN FRANCISCO CA 9","Everyday Expenses:Coffee Shop","Everyday Expenses","Coffee Shop","6548: PEET'S #30202 SAN FRANCISCO CA 94108 US",$0.92,$0.00,C,-$1009.12
"Venture Card",,,08/26/2015,"CHIPOTLE 1857 SAN FRANCISCO CA 9","Everyday Expenses:Spending Money","Everyday Expenses","Spending Money","6548: CHIPOTLE 1857 SAN FRANCISCO CA 94104 US",$8.32,$0.00,C,-$1017.44
"Venture Card",,,08/26/2015,"FRESHROLL SAN FRANCISCO CA 94104","Everyday Expenses:Spending Money","Everyday Expenses","Spending Money","7622: FRESHROLL SAN FRANCISCO CA 94104 US",$9.51,$0.00,C,-$1026.95
"Venture Card",,,08/26/2015,"CINTA AVEDA INSTITUTE SAN FRANCI","Everyday Expenses:Spending Money","Everyday Expenses","Spending Money","7622: CINTA AVEDA INSTITUTE SAN FRANCISCO CA 94108 US",$34.25,$0.00,C,-$1061.20
"Venture Card",,,08/26/2015,"PUBLIC BARBER SALON LL SAN FRANC","Everyday Expenses:Spending Money","Everyday Expenses","Spending Money","6548: PUBLIC BARBER SALON LL SAN FRANCISCO CA 94102 US",$46.00,$0.00,C,-$1107.20
"Venture Card",,,08/27/2015,"EUROCAFE ST265 CHICAGO IL 37214","Everyday Expenses:Coffee Shop","Everyday Expenses","Coffee Shop","7622: EUROCAFE ST265 CHICAGO IL 37214 US",$5.09,$0.00,C,-$1112.29
"Venture Card",,,08/27/2015,"SOUTHWESTAIR*INFLIGHT DALLAS TX","Savings Goals:Vacation & Travel","Savings Goals","Vacation & Travel","6548: SOUTHWESTAIR*INFLIGHT DALLAS TX 75235 US",$10.00,$0.00,C,-$1122.29
"Venture Card",,,08/27/2015,"Audible US 888-283-5051 NJ 07470","Monthly Bills:Web Stuff","Monthly Bills","Web Stuff","6548: Audible US 888-283-5051 NJ 07470 US",$14.55,$0.00,C,-$1136.84
"Venture Card",,,08/27/2015,"KING WAH EXPRESS CHICAGO IL 6063","Everyday Expenses:Spending Money","Everyday Expenses","Spending Money","6548: KING WAH EXPRESS CHICAGO IL 60638 US",$18.79,$0.00,C,-$1155.63
"Venture Card",,,08/27/2015,"WM SUPERCENTER #1943 LINCOLN NE","Everyday Expenses:Groceries","Everyday Expenses","Groceries","6548: WM SUPERCENTER #1943 LINCOLN NE 68521 US",$46.48,$0.00,C,-$1202.11
"Venture Card",,,08/27/2015,"WALGREENS #13666 SAN FRANCISCO C","Everyday Expenses:Household Goods","Everyday Expenses","Household Goods","7622: WALGREENS #13666 SAN FRANCISCO CA 94109 US",$63.27,$0.00,C,-$1265.38
"Venture Card",,,08/28/2015,"BARRYMORES LOUNGE LINCOLN NE 685","Everyday Expenses:Spending Money","Everyday Expenses","Spending Money","7622: BARRYMORES LOUNGE LINCOLN NE 68508 US",$8.10,$0.00,C,-$1273.48
"Venture Card",,,08/28/2015,"AMU MANU LINCOLN NE 68508 US","Everyday Expenses:Spending Money","Everyday Expenses","Spending Money","7622: AMU MANU LINCOLN NE 68508 US",$19.46,$0.00,C,-$1292.94
"Venture Card",,,08/28/2015,"SQ *CRESCENT MOON COFFEE Lincoln","Everyday Expenses:Spending Money","Everyday Expenses","Spending Money","6548: SQ *CRESCENT MOON COFFEE Lincoln NE 68508 US",$20.66,$0.00,C,-$1313.60
"Venture Card",,,08/28/2015,"BREAD AND CUP LINCOLN NE 68508 U","Everyday Expenses:Spending Money","Everyday Expenses","Spending Money","7622: BREAD AND CUP LINCOLN NE 68508 US",$53.33,$0.00,C,-$1366.93
"Venture Card",,,08/29/2015,"SPOONROCKET.COM 510-921-9929 CA","Everyday Expenses:Spending Money","Everyday Expenses","Spending Money","6548: SPOONROCKET.COM 510-921-9929 CA 94703 US",$5.48,$0.00,C,-$1372.41
"Venture Card",,,08/29/2015,"JOYSTICKS LINCOLN NE 68508 US","Everyday Expenses:Spending Money","Everyday Expenses","Spending Money","7622: JOYSTICKS LINCOLN NE 68508 US",$21.00,$0.00,C,-$1393.41
"Venture Card",,,08/29/2015,"SQ *CULTIVA Lincoln NE 68508 US","Everyday Expenses:Spending Money","Everyday Expenses","Spending Money","7622: SQ *CULTIVA Lincoln NE 68508 US",$24.72,$0.00,C,-$1418.13
"Venture Card",,,08/29/2015,"ASOS US SALES LLC WWW.ASOS.COM D","Everyday Expenses:Clothing","Everyday Expenses","Clothing","7622: ASOS US SALES LLC WWW.ASOS.COM DE 19904 US",$42.10,$0.00,C,-$1460.23
"Venture Card",,,08/29/2015,"MODCLOTH 888-495-9699 CA 94107 U","Everyday Expenses:Clothing","Everyday Expenses","Clothing","7622: MODCLOTH 888-495-9699 CA 94107 US",$65.85,$0.00,C,-$1526.08
"Venture Card",,,08/30/2015,"PANERA BREAD #1374 LINCOLN NE 68","Everyday Expenses:Spending Money","Everyday Expenses","Spending Money","7622: PANERA BREAD #1374 LINCOLN NE 68508 US",$4.69,$0.00,C,-$1530.77
"Venture Card",,,08/30/2015,"EZ GO AMOCO BLUE SPRINGS MO 6401","Everyday Expenses:Transportation","Everyday Expenses","Transportation","7622: EZ GO AMOCO BLUE SPRINGS MO 64015 US",$8.25,$0.00,C,-$1539.02
"Venture Card",,,08/30/2015,"EZ GO AMOCO BLUE SPRINGS MO 6401","Everyday Expenses:Transportation","Everyday Expenses","Transportation","7622: EZ GO AMOCO BLUE SPRINGS MO 64015 US",$21.59,$0.00,C,-$1560.61
"Venture Card",,,08/30/2015,"CRACKER BARREL #365 LINCO LINCOL","Everyday Expenses:Spending Money","Everyday Expenses","Spending Money","7622: CRACKER BARREL #365 LINCO LINCOLN NE 68521 US",$23.92,$0.00,C,-$1584.53
"Venture Card",,,08/30/2015,"LEADBELLY LINCOLN NE 68508 US","Everyday Expenses:Spending Money","Everyday Expenses","Spending Money","6548: LEADBELLY LINCOLN NE 68508 US",$46.13,$0.00,C,-$1630.66
"Venture Card",,,08/31/2015,"CAPITAL ONE ONLINE PYMT AuthDate","Pre-YNAB Debt:Venture Card","Pre-YNAB Debt","Venture Card","6548: CAPITAL ONE ONLINE PYMT AuthDate 31-AUG",$0.00,$1346.01,C,-$284.65
"Venture Card",,,08/31/2015,"GETAROUND 866-438-2768 CA 94103","Everyday Expenses:Transportation","Everyday Expenses","Transportation","6548: GETAROUND 866-438-2768 CA 94103 US",$8.75,$0.00,C,-$293.40
"Venture Card",,,08/31/2015,"Audible US 888-283-5051 NJ 07470","Monthly Bills:Web Stuff","Monthly Bills","Web Stuff","6548: Audible US 888-283-5051 NJ 07470 US",$15.87,$0.00,C,-$309.27
"Venture Card",,,08/31/2015,"PANERA BREAD #1044 FESTUS MO 630","Everyday Expenses:Spending Money","Everyday Expenses","Spending Money","7622: PANERA BREAD #1044 FESTUS MO 63028 US",$19.78,$0.00,C,-$329.05
"Venture Card",,,08/31/2015,"GULF OIL 92054567 DE SOTO MO 630","Everyday Expenses:Transportation","Everyday Expenses","Transportation","7622: GULF OIL 92054567 DE SOTO MO 63020 US",$23.19,$0.00,C,-$352.24
"Venture Card",,,08/31/2015,"EUROPEAN WAX CENTER SUN SAINT LO","Everyday Expenses:Spending Money","Everyday Expenses","Spending Money","7622: EUROPEAN WAX CENTER SUN SAINT LOUIS MO 63127 US",$54.00,$0.00,C,-$406.24
"Venture Card",,,09/01/2015,"PANERA BREAD #1044 FESTUS MO 630","Everyday Expenses:Spending Money","Everyday Expenses","Spending Money","6548: PANERA BREAD #1044 FESTUS MO 63028 US",$18.58,$0.00,C,-$424.82
"Venture Card",,,09/01/2015,"WM SUPERCENTER #69 FESTUS MO 630","Everyday Expenses:Groceries","Everyday Expenses","Groceries","6548: WM SUPERCENTER #69 FESTUS MO 63028 US",$49.00,$0.00,C,-$473.82
"Venture Card",,,09/01/2015,"FAT BOYS SALOON & GRILL DE SOTO","Everyday Expenses:Spending Money","Everyday Expenses","Spending Money","6548: FAT BOYS SALOON & GRILL DE SOTO MO 63020 US",$84.76,$0.00,C,-$558.58
"Venture Card",,,09/02/2015,"GULF OIL 92054567 DE SOTO MO 630","Everyday Expenses:Transportation","Everyday Expenses","Transportation","6548: GULF OIL 92054567 DE SOTO MO 63020 US",$10.00,$0.00,C,-$568.58
"Venture Card",,,09/02/2015,"CHICK-FIL-A #02629 ARNOLD MO 630","Everyday Expenses:Spending Money","Everyday Expenses","Spending Money","7622: CHICK-FIL-A #02629 ARNOLD MO 63010 US",$15.17,$0.00,C,-$583.75
"Venture Card",,,09/02/2015,"GULF OIL 92054567 DE SOTO MO 630","Everyday Expenses:Transportation","Everyday Expenses","Transportation","7622: GULF OIL 92054567 DE SOTO MO 63020 US",$21.78,$0.00,C,-$605.53
"Venture Card",,,09/02/2015,"AMAZON MKTPLACE PMTS AMZN.COM/BI","Everyday Expenses:Spending Money","Everyday Expenses","Spending Money","6548: AMAZON MKTPLACE PMTS AMZN.COM/BILL WA 98109 US",$28.40,$0.00,C,-$633.93
"Venture Card",,,09/02/2015,"CLASSPASS.COM CLASSPAS 917-831-4","Everyday Expenses:Health & Fitness","Everyday Expenses","Health & Fitness","7622: CLASSPASS.COM CLASSPAS 917-831-4414 NY 10001 US",$99.00,$0.00,C,-$732.93
"Venture Card",,,09/03/2015,"PANERA BREAD #1044 FESTUS MO 630","Everyday Expenses:Spending Money","Everyday Expenses","Spending Money","6548: PANERA BREAD #1044 FESTUS MO 63028 US",$22.81,$0.00,C,-$755.74
"Venture Card",,,09/03/2015,"Amazon.com AMZN.COM/BILL WA 9810","Everyday Expenses:Spending Money","Everyday Expenses","Spending Money","6548: Amazon.com AMZN.COM/BILL WA 98101 US",$94.99,$0.00,C,-$850.73
"Venture Card",,,09/03/2015,"AMAZON MKTPLACE PMTS AMZN.COM/BI","Everyday Expenses:Misc","Everyday Expenses","Misc","6548: AMAZON MKTPLACE PMTS AMZN.COM/BILL WA 98109 US",$529.99,$0.00,C,-$1380.72
"Venture Card",,,09/04/2015,"HUCK'S FOOD & FUEL STO POPLAR BL","Everyday Expenses:Spending Money","Everyday Expenses","Spending Money","7622: HUCK'S FOOD & FUEL STO POPLAR BLUFF MO 63901 US",$17.09,$0.00,C,-$1397.81
"Venture Card",,,09/04/2015,"DEXTER BAR B QUE POPULAR POPLAR","Everyday Expenses:Spending Money","Everyday Expenses","Spending Money","6548: DEXTER BAR B QUE POPULAR POPLAR BLUFF MO 63901 US",$19.00,$0.00,C,-$1416.81
"Venture Card",,,09/04/2015,"BOOTHEEL YOUTH MUSEUM MALDEN MO","Everyday Expenses:Spending Money","Everyday Expenses","Spending Money","7622: BOOTHEEL YOUTH MUSEUM MALDEN MO 63863 US",$24.00,$0.00,C,-$1440.81
"Venture Card",,,09/04/2015,"SONIC DRIVE IN #2471 MALDEN MO 6","Everyday Expenses:Spending Money","Everyday Expenses","Spending Money","7622: SONIC DRIVE IN #2471 MALDEN MO 63863 US",$26.58,$0.00,C,-$1467.39
"Venture Card",,,09/04/2015,"SQ *FRONTIER Poplar Bluff MO 639","Everyday Expenses:Spending Money","Everyday Expenses","Spending Money","7622: SQ *FRONTIER Poplar Bluff MO 63901 US",$37.51,$0.00,C,-$1504.90
"Venture Card",,,09/05/2015,"THE BEE HIVE POPLAR BLUFF MO 639","Everyday Expenses:Spending Money","Everyday Expenses","Spending Money","7622: THE BEE HIVE POPLAR BLUFF MO 63901 US",$5.40,$0.00,C,-$1510.30
"Venture Card",,,09/05/2015,"GHOST PERSONAL +442072242824 000","Monthly Bills:Web Stuff","Monthly Bills","Web Stuff","6548: GHOST PERSONAL +442072242824 00000 GB",$10.00,$0.00,C,-$1520.30
"Venture Card",,,09/05/2015,"THE JUICE CAFE POPLAR BLUF MO 63","Everyday Expenses:Spending Money","Everyday Expenses","Spending Money","7622: THE JUICE CAFE POPLAR BLUF MO 63901 US",$11.85,$0.00,C,-$1532.15
"Venture Card",,,09/05/2015,"TIOS MEXICAN BAR & GRILL POPLAR","Everyday Expenses:Spending Money","Everyday Expenses","Spending Money","7622: TIOS MEXICAN BAR & GRILL POPLAR BLUFF MO 63901 US",$35.48,$0.00,C,-$1567.63
"Venture Card",,,09/06/2015,"COMPANY CORNING VALERO CORNING A","Everyday Expenses:Spending Money","Everyday Expenses","Spending Money","6548: COMPANY CORNING VALERO CORNING AR 72422 US",$2.91,$0.00,C,-$1570.54
"Venture Card",,,09/06/2015,"SMOOTHIE KING #0959 MCCOMB MS 39","Everyday Expenses:Spending Money","Everyday Expenses","Spending Money","7622: SMOOTHIE KING #0959 MCCOMB MS 39648 US",$4.98,$0.00,C,-$1575.52
"Venture Card",,,09/06/2015,"LOVES TRAVEL S00052084 CANTON MS","Everyday Expenses:Transportation","Everyday Expenses","Transportation","6548: LOVES TRAVEL S00052084 CANTON MS 39046 US",$8.06,$0.00,C,-$1583.58
"Venture Card",,,09/06/2015,"SUBWAY 00055269 POPLAR BLUFF MO","Everyday Expenses:Spending Money","Everyday Expenses","Spending Money","7622: SUBWAY 00055269 POPLAR BLUFF MO 63901 US",$16.85,$0.00,C,-$1600.43
"Venture Card",,,09/07/2015,"STILL PERKIN NEW ORLEANS LA 7013","Everyday Expenses:Spending Money","Everyday Expenses","Spending Money","7622: STILL PERKIN NEW ORLEANS LA 70130 US",$5.86,$0.00,C,-$1606.29
"Venture Card",,,09/07/2015,"WHOLEFDS ABS 10143 NEW ORLEANS L","Everyday Expenses:Groceries","Everyday Expenses","Groceries","6548: WHOLEFDS ABS 10143 NEW ORLEANS LA 70115 US",$18.52,$0.00,C,-$1624.81
"Venture Card",,,09/07/2015,"THE SWAMP NEW ORLEANS LA 70130 U","Savings Goals:Vacation & Travel","Savings Goals","Vacation & Travel","7622: THE SWAMP NEW ORLEANS LA 70130 US",$21.00,$0.00,C,-$1645.81
"Venture Card",,,09/07/2015,"THE BEACH ON BOURBON NEW ORLEANS",,,,"7622: THE BEACH ON BOURBON NEW ORLEANS LA 70130 US",$25.25,$0.00,C,-$1671.06
"Venture Card",,,09/07/2015,"THE BEACH ON BOURBON NEW ORLEANS",,,,"7622: THE BEACH ON BOURBON NEW ORLEANS LA 70130 US",$32.50,$0.00,C,-$1703.56
"Venture Card",,,09/07/2015,"THE BEACH ON BOURBON NEW ORLEANS",,,,"7622: THE BEACH ON BOURBON NEW ORLEANS LA 70130 US",$32.50,$0.00,C,-$1736.06
"Venture Card",,,09/07/2015,"WHOLEFDS ABS 10143 NEW ORLEANS L","Everyday Expenses:Groceries","Everyday Expenses","Groceries","6548: WHOLEFDS ABS 10143 NEW ORLEANS LA 70115 US",$35.23,$0.00,C,-$1771.29
"Venture Card",,,09/07/2015,"LA BAYOU NEW ORLEANS LA 70130 US","Everyday Expenses:Spending Money","Everyday Expenses","Spending Money","6548: LA BAYOU NEW ORLEANS LA 70130 US",$64.62,$0.00,C,-$1835.91
"Venture Card",,,09/07/2015,"EMERILS NEW ORLEANS LA 70130 US","Everyday Expenses:Spending Money","Everyday Expenses","Spending Money","6548: EMERILS NEW ORLEANS LA 70130 US",$325.47,$0.00,C,-$2161.38
"Venture Card",,,09/08/2015,"STARBUCKS #18830 NEW ORLE New Or","Everyday Expenses:Coffee Shop","Everyday Expenses","Coffee Shop","6548: STARBUCKS #18830 NEW ORLE New Orleans LA 70119 US",$2.91,$0.00,C,-$2164.29
"Venture Card",,,09/08/2015,"AMAZON MKTPLACE PMTS AMZN.COM/BI","Everyday Expenses:Spending Money","Everyday Expenses","Spending Money","6548: AMAZON MKTPLACE PMTS AMZN.COM/BILL WA 98109 US",$22.04,$0.00,C,-$2186.33
"Venture Card",,,09/08/2015,"THE STORE NEW ORLEANS LA 70112 U","Everyday Expenses:Spending Money","Everyday Expenses","Spending Money","6548: THE STORE NEW ORLEANS LA 70112 US",$24.97,$0.00,C,-$2211.30
"Venture Card",,,09/08/2015,"COMCAST CALIFORNIA 800-COMCAST C","Monthly Bills:Internet","Monthly Bills","Internet","6548: COMCAST CALIFORNIA 800-COMCAST CA 94551 US",$77.83,$0.00,C,-$2289.13
"Venture Card",,,09/10/2015,"CAJUN ENCOUNTERS","Savings Goals:Vacation & Travel","Savings Goals","Vacation & Travel","CAJUN ENCOUNTERS",$11.09,$0.00,C,-$2300.22
"Venture Card",,,09/10/2015,"PREMIUM PARKING 296","Savings Goals:Vacation & Travel","Savings Goals","Vacation & Travel","PREMIUM PARKING 296",$25.00,$0.00,C,-$2325.22
"Venture Card",,,09/11/2015,"CAPITAL ONE ONLINE PYMT AuthDate 10-S EP","Pre-YNAB Debt:Venture Card","Pre-YNAB Debt","Venture Card","CAPITAL ONE ONLINE PYMT AuthDate 10-S EP",$0.00,$2349.10,C,$23.88
"Venture Card",,,09/11/2015,"PURCHASE ADJUSTMENT","Pre-YNAB Debt:Venture Card","Pre-YNAB Debt","Venture Card","PURCHASE ADJUSTMENT",$0.00,$32.50,C,$56.38
"Venture Card",,,09/11/2015,"BIG EASY DAIQUIRI","Everyday Expenses:Spending Money","Everyday Expenses","Spending Money","BIG EASY DAIQUIRI",$5.00,$0.00,C,$51.38
"Venture Card",,,09/11/2015,"TERRAZU","Everyday Expenses:Spending Money","Everyday Expenses","Spending Money","TERRAZU",$9.82,$0.00,C,$41.56
"Venture Card",,,09/11/2015,"LAFITTES BLACKSMITH SHOP","Everyday Expenses:Spending Money","Everyday Expenses","Spending Money","LAFITTES BLACKSMITH SHOP",$13.00,$0.00,C,$28.56
"Venture Card",,,09/11/2015,"ARBYS 7495","Everyday Expenses:Spending Money","Everyday Expenses","Spending Money","ARBYS 7495",$15.17,$0.00,C,$13.39
"Venture Card",,,09/11/2015,"THE BEACH ON BOURBON","Everyday Expenses:Spending Money","Everyday Expenses","Spending Money","THE BEACH ON BOURBON",$18.00,$0.00,C,-$4.61
"Venture Card",,,09/11/2015,"FUNKY 544","Everyday Expenses:Spending Money","Everyday Expenses","Spending Money","FUNKY 544",$25.75,$0.00,C,-$30.36
"Venture Card",,,09/11/2015,"OLD ABSINTHE HOUSE","Everyday Expenses:Spending Money","Everyday Expenses","Spending Money","OLD ABSINTHE HOUSE",$32.00,$0.00,C,-$62.36
"Venture Card",,,09/11/2015,"EMMELINE BOUTIQUE","Everyday Expenses:Clothing","Everyday Expenses","Clothing","EMMELINE BOUTIQUE",$32.84,$0.00,C,-$95.20
"Venture Card",,,09/12/2015,"SHELL OIL 57543619209","Everyday Expenses:Transportation","Everyday Expenses","Transportation","SHELL OIL 57543619209",$1.88,$0.00,C,-$97.08
"Venture Card",,,09/12/2015,"CHEVRON 00305803","Everyday Expenses:Transportation","Everyday Expenses","Transportation","CHEVRON 00305803",$2.76,$0.00,C,-$99.84
"Venture Card",,,09/12/2015,"WALGREENS #5624","Everyday Expenses:Household Goods","Everyday Expenses","Household Goods","WALGREENS #5624",$11.91,$0.00,C,-$111.75
"Venture Card",,,09/12/2015,"WM SUPERCENTER #37","Everyday Expenses:Spending Money","Everyday Expenses","Spending Money","WM SUPERCENTER #37",$14.39,$0.00,C,-$126.14
"Venture Card",,,09/12/2015,"BREAK TIME 3125","Everyday Expenses:Spending Money","Everyday Expenses","Spending Money","BREAK TIME 3125",$24.75,$0.00,C,-$150.89
"Venture Card",,,09/12/2015,"SHOGUN JAPANESE STEAK & S","Everyday Expenses:Spending Money","Everyday Expenses","Spending Money","SHOGUN JAPANESE STEAK & S",$55.67,$0.00,C,-$206.56
"Venture Card",,,09/14/2015,"SPOONROCKET.COM","Everyday Expenses:Spending Money","Everyday Expenses","Spending Money","SPOONROCKET.COM",$0.00,$5.48,C,-$201.08
"Venture Card",,,09/14/2015,"SQ *CONTRABAND COFFEE IMM","Everyday Expenses:Coffee Shop","Everyday Expenses","Coffee Shop","SQ *CONTRABAND COFFEE IMM",$7.50,$0.00,C,-$208.58
"Venture Card",,,09/14/2015,"CHIPOTLE 2209","Everyday Expenses:Spending Money","Everyday Expenses","Spending Money","CHIPOTLE 2209",$14.61,$0.00,C,-$223.19
"Venture Card",,,09/14/2015,"Audible","Monthly Bills:Web Stuff","Monthly Bills","Web Stuff","Audible",$14.95,$0.00,C,-$238.14
"Venture Card",,,09/14/2015,"UBER TECHNOLOGIES INC","Everyday Expenses:Transportation","Everyday Expenses","Transportation","UBER TECHNOLOGIES INC",$21.02,$0.00,C,-$259.16
"Venture Card",,,09/14/2015,"CRACKER BARREL #536 FERGU","Everyday Expenses:Spending Money","Everyday Expenses","Spending Money","CRACKER BARREL #536 FERGU",$26.43,$0.00,C,-$285.59
"Venture Card",,,09/14/2015,"TRADER JOE'S #200 QPS","Everyday Expenses:Groceries","Everyday Expenses","Groceries","TRADER JOE'S #200 QPS",$35.44,$0.00,C,-$321.03
"Venture Card",,,09/14/2015,"TRADER JOE'S #200 QPS","Everyday Expenses:Groceries","Everyday Expenses","Groceries","TRADER JOE'S #200 QPS",$36.20,$0.00,C,-$357.23
"Venture Card",,,09/14/2015,"JOURNEYS #1824","Everyday Expenses:Clothing","Everyday Expenses","Clothing","JOURNEYS #1824",$76.02,$0.00,C,-$433.25
"Venture Card",,,09/15/2015,"CAPITAL ONE ONLINE PYMT AuthDate 15-S EP","Pre-YNAB Debt:Venture Card","Pre-YNAB Debt","Venture Card","CAPITAL ONE ONLINE PYMT AuthDate 15-S EP",$0.00,$493.22,C,$59.97
"Venture Card",,,09/15/2015,"MODCLOTH","Everyday Expenses:Clothing","Everyday Expenses","Clothing","MODCLOTH",$0.29,$0.00,C,$59.68
"Venture Card",,,09/15/2015,"FLEXJOBS.COM","Everyday Expenses:Spending Money","Everyday Expenses","Spending Money","FLEXJOBS.COM",$7.50,$0.00,C,$52.18
"Venture Card",,,09/15/2015,"SUTTER FINE FOOD","Everyday Expenses:Groceries","Everyday Expenses","Groceries","SUTTER FINE FOOD",$28.70,$0.00,C,$23.48
"Venture Card",,,09/15/2015,"TARGET 00027664","Everyday Expenses:Household Goods","Everyday Expenses","Household Goods","TARGET 00027664",$139.24,$0.00,C,-$115.76
"Venture Card",,,09/15/2015,"AT&T*BILL PAYMENT","Monthly Bills:Cell Phone","Monthly Bills","Cell Phone","AT&T*BILL PAYMENT",$142.89,$0.00,C,-$258.65
"Venture Card",,,09/15/2015,"BT TASKRABBIT, 9HX6ZG","Everyday Expenses:Misc","Everyday Expenses","Misc","BT TASKRABBIT, 9HX6ZG",$161.70,$0.00,C,-$420.35
"Venture Card",,,09/16/2015,"PEET'S #30202","Everyday Expenses:Coffee Shop","Everyday Expenses","Coffee Shop","PEET'S #30202",$1.87,$0.00,C,-$422.22
"Venture Card",,,09/16/2015,"LYFT *RIDE TUE 6PM","Everyday Expenses:Transportation","Everyday Expenses","Transportation","LYFT *RIDE TUE 6PM",$6.00,$0.00,C,-$428.22
"Venture Card",,,09/16/2015,"CHIPOTLE 1857","Everyday Expenses:Spending Money","Everyday Expenses","Spending Money","CHIPOTLE 1857",$8.32,$0.00,C,-$436.54
"Venture Card",,,09/16/2015,"DOLCE GELATO","Everyday Expenses:Spending Money","Everyday Expenses","Spending Money","DOLCE GELATO",$8.79,$0.00,C,-$445.33
"Venture Card",,,09/16/2015,"HLU*Hulu 22744533-U","Monthly Bills:Web Stuff","Monthly Bills","Web Stuff","HLU*Hulu 22744533-U",$9.67,$0.00,C,-$455.00
"Venture Card",,,09/16/2015,"WALGREENS #13666","Everyday Expenses:Household Goods","Everyday Expenses","Household Goods","WALGREENS #13666",$32.58,$0.00,C,-$487.58
"Venture Card",,,09/17/2015,"LYFT *RIDE TUE 9PM","Everyday Expenses:Transportation","Everyday Expenses","Transportation","LYFT *RIDE TUE 9PM",$6.00,$0.00,C,-$493.58
"Venture Card",,,09/17/2015,"WALGREENS #4680","Everyday Expenses:Household Goods","Everyday Expenses","Household Goods","WALGREENS #4680",$7.06,$0.00,C,-$500.64
"Venture Card",,,09/17/2015,"SQ *BLUE BOTTLE COFFEE, M","Everyday Expenses:Coffee Shop","Everyday Expenses","Coffee Shop","SQ *BLUE BOTTLE COFFEE, M",$7.25,$0.00,C,-$507.89
"Venture Card",,,09/17/2015,"SUTTER FINE FOOD","Everyday Expenses:Groceries","Everyday Expenses","Groceries","SUTTER FINE FOOD",$11.65,$0.00,C,-$519.54
"Venture Card",,,09/18/2015,"PEET'S #30202","Everyday Expenses:Coffee Shop","Everyday Expenses","Coffee Shop","PEET'S #30202",$1.49,$0.00,C,-$521.03
"Venture Card",,,09/18/2015,"PANDA EXPRESS #2436","Everyday Expenses:Spending Money","Everyday Expenses","Spending Money","PANDA EXPRESS #2436",$5.91,$0.00,C,-$526.94
"Venture Card",,,09/18/2015,"ADY*Spotify USA","Monthly Bills:Web Stuff","Monthly Bills","Web Stuff","ADY*Spotify USA",$9.99,$0.00,C,-$536.93
"Venture Card",,,09/18/2015,"SUTTER FINE FOOD","Everyday Expenses:Groceries","Everyday Expenses","Groceries","SUTTER FINE FOOD",$11.46,$0.00,C,-$548.39
"Venture Card",,,09/19/2015,"SQ *COOKIEBAR CREAMERY","Everyday Expenses:Spending Money","Everyday Expenses","Spending Money","SQ *COOKIEBAR CREAMERY",$4.50,$0.00,C,-$552.89
"Venture Card",,,09/19/2015,"TUI TAI","Everyday Expenses:Spending Money","Everyday Expenses","Spending Money","TUI TAI",$27.94,$0.00,C,-$580.83
"Venture Card",,,09/19/2015,"LIRA'S SUPERMARKET #1","Everyday Expenses:Groceries","Everyday Expenses","Groceries","LIRA'S SUPERMARKET #1",$64.31,$0.00,C,-$645.14
"Venture Card",,,09/21/2015,"CAPITAL ONE ONLINE PYMT AuthDate 20-S EP","Pre-YNAB Debt:Venture Card","Pre-YNAB Debt","Venture Card","CAPITAL ONE ONLINE PYMT AuthDate 20-S EP",$0.00,$705.11,C,$59.97
"Venture Card",,,09/21/2015,"FAMILY DOLLAR #11411","Everyday Expenses:Spending Money","Everyday Expenses","Spending Money","FAMILY DOLLAR #11411",$6.50,$0.00,C,$53.47
"Venture Card",,,09/21/2015,"WASH LAUNDRY WAVEPOINT","Everyday Expenses:Spending Money","Everyday Expenses","Spending Money","WASH LAUNDRY WAVEPOINT",$10.00,$0.00,C,$43.47
"Venture Card",,,09/21/2015,"BURGERLICIOUS","Everyday Expenses:Spending Money","Everyday Expenses","Spending Money","BURGERLICIOUS",$19.38,$0.00,C,$24.09
"Venture Card",,,09/21/2015,"LIRA'S SUPERMARKET #1","Savings Goals:Vacation & Travel","Savings Goals","Vacation & Travel","LIRA'S SUPERMARKET #1",$28.73,$0.00,C,-$4.64
"Venture Card",,,09/21/2015,"MODCLOTH","Everyday Expenses:Clothing","Everyday Expenses","Clothing","MODCLOTH",$66.89,$0.00,C,-$71.53
"Venture Card",,,09/21/2015,"TRADER JOE'S #200 QPS","Everyday Expenses:Groceries","Everyday Expenses","Groceries","TRADER JOE'S #200 QPS",$96.97,$0.00,C,-$168.50
"Venture Card",,,09/22/2015,"WALGREENS #13666","Everyday Expenses:Household Goods","Everyday Expenses","Household Goods","WALGREENS #13666",$6.51,$0.00,C,-$175.01
"Venture Card",,,09/22/2015,"MODCLOTH","Everyday Expenses:Clothing","Everyday Expenses","Clothing","MODCLOTH",$22.53,$0.00,C,-$197.54
"Venture Card",,,09/23/2015,"ADY*Spotify USA","Monthly Bills:Web Stuff","Monthly Bills","Web Stuff","ADY*Spotify USA",$9.99,$0.00,C,-$207.53
"Venture Card",,,09/24/2015,"CAPITAL ONE ONLINE PYMT","Pre-YNAB Debt:Venture Card","Pre-YNAB Debt","Venture Card","CAPITAL ONE ONLINE PYMT AuthDate 24-SEP",$0.00,$267.50,C,$59.97
"Venture Card",,,09/24/2015,"PAYPAL EBAY MARKTPLC USD","Everyday Expenses:Misc","Everyday Expenses","Misc","PAYPAL EBAY MARKTPLC USD",$6.29,$0.00,C,$53.68
"Venture Card",,,09/24/2015,"PAYPAL EBAY MARKTPLC USD","Everyday Expenses:Misc","Everyday Expenses","Misc","PAYPAL EBAY MARKTPLC USD",$379.99,$0.00,C,-$326.31
"Venture Card",,,09/25/2015,"MURPHYS","Everyday Expenses:Spending Money","Everyday Expenses","Spending Money","MURPHYS",$7.25,$0.00,C,-$333.56
"Venture Card",,,09/25/2015,"SUTTER FINE FOOD","Everyday Expenses:Groceries","Everyday Expenses","Groceries","SUTTER FINE FOOD",$8.95,$0.00,C,-$342.51
"Venture Card",,,09/25/2015,"FRESHROLL","Everyday Expenses:Spending Money","Everyday Expenses","Spending Money","FRESHROLL",$9.50,$0.00,C,-$352.01
"Venture Card",,,09/25/2015,"MURPHYS","Everyday Expenses:Spending Money","Everyday Expenses","Spending Money","MURPHYS",$18.00,$0.00,C,-$370.01
"Venture Card",,,09/26/2015,"PEET'S #30202","Everyday Expenses:Coffee Shop","Everyday Expenses","Coffee Shop","PEET'S #30202",$1.42,$0.00,C,-$371.43
"Venture Card",,,09/26/2015,"CHIPOTLE 1857","Everyday Expenses:Spending Money","Everyday Expenses","Spending Money","CHIPOTLE 1857",$8.32,$0.00,C,-$379.75
"Venture Card",,,09/28/2015,"CAPITAL ONE ONLINE PYMT AuthDate 27-S EP","Pre-YNAB Debt:Venture Card","Pre-YNAB Debt","Venture Card","CAPITAL ONE ONLINE PYMT AuthDate 27-S EP",$0.00,$439.72,C,$59.97
"Venture Card",,,09/28/2015,"SQ *CUP A JOE COFFE","Everyday Expenses:Coffee Shop","Everyday Expenses","Coffee Shop","SQ *CUP A JOE COFFE",$3.26,$0.00,C,$56.71
"Venture Card",,,09/28/2015,"LYFT *RIDE SAT 6PM","Everyday Expenses:Transportation","Everyday Expenses","Transportation","LYFT *RIDE SAT 6PM",$5.76,$0.00,C,$50.95
"Venture Card",,,09/28/2015,"LYFT *RIDE FRI 9PM","Everyday Expenses:Transportation","Everyday Expenses","Transportation","LYFT *RIDE FRI 9PM",$6.62,$0.00,C,$44.33
"Venture Card",,,09/28/2015,"SUTTER FINE FOOD","Everyday Expenses:Groceries","Everyday Expenses","Groceries","SUTTER FINE FOOD",$10.33,$0.00,C,$34.00
"Venture Card",,,09/28/2015,"BARE MINERALS #001","Everyday Expenses:Health & Fitness","Everyday Expenses","Health & Fitness","BARE MINERALS #001",$10.88,$0.00,C,$23.12
"Venture Card",,,09/28/2015,"TRADER JOE'S #200 QPS","Everyday Expenses:Groceries","Everyday Expenses","Groceries","TRADER JOE'S #200 QPS",$13.48,$0.00,C,$9.64
"Venture Card",,,09/28/2015,"LYFT *RIDE SAT 10PM","Everyday Expenses:Transportation","Everyday Expenses","Transportation","LYFT *RIDE SAT 10PM",$13.85,$0.00,C,-$4.21
"Venture Card",,,09/28/2015,"NARA SUSHI","Everyday Expenses:Spending Money","Everyday Expenses","Spending Money","NARA SUSHI",$21.07,$0.00,C,-$25.28
"Venture Card",,,09/28/2015,"TRADER JOE'S #200 QPS","Everyday Expenses:Groceries","Everyday Expenses","Groceries","TRADER JOE'S #200 QPS",$117.46,$0.00,C,-$142.74
"Venture Card",,,09/28/2015,"GAP US 143","Everyday Expenses:Clothing","Everyday Expenses","Clothing","GAP US 143",$143.42,$0.00,C,-$286.16
"Venture Card",,,09/29/2015,"GITHUB.COM FVEW","Monthly Bills:Web Stuff","Monthly Bills","Web Stuff","GITHUB.COM FVEW",$7.00,$0.00,C,-$293.16
"Venture Card",,,09/29/2015,"CRAVE","Everyday Expenses:Spending Money","Everyday Expenses","Spending Money","CRAVE",$18.00,$0.00,C,-$311.16
"Venture Card",,,09/29/2015,"IN *DAVID J MACGREGOR MD","Everyday Expenses:Medical","Everyday Expenses","Medical","IN *DAVID J MACGREGOR MD",$150.00,$0.00,C,-$461.16
"Venture Card",,,09/30/2015,"CAPITAL ONE ONLINE PYMT AuthDate 30-S EP","Pre-YNAB Debt:Venture Card","Pre-YNAB Debt","Venture Card","CAPITAL ONE ONLINE PYMT AuthDate 30-S EP",$0.00,$521.13,C,$59.97
"Venture Card",,,09/30/2015,"PAYPAL EBAY MARKTPLC USD","Everyday Expenses:Spending Money","Everyday Expenses","Spending Money","PAYPAL EBAY MARKTPLC USD",$4.89,$0.00,C,$55.08
"Venture Card",,,09/30/2015,"URBAN-OUTFITTERS #0015","Everyday Expenses:Clothing","Everyday Expenses","Clothing","URBAN-OUTFITTERS #0015",$10.21,$0.00,C,$44.87
"Venture Card",,,09/30/2015,"WALGREENS #13666","Everyday Expenses:Household Goods","Everyday Expenses","Household Goods","WALGREENS #13666",$14.64,$0.00,C,$30.23
"Venture Card",,,10/01/2015,"SQ *BEANSTALK CAFE","Everyday Expenses:Spending Money","Everyday Expenses","Spending Money","SQ *BEANSTALK CAFE",$7.24,$0.00,C,$22.99
"Venture Card",,,10/01/2015,"TRADER JOE'S #200 QPS","Everyday Expenses:Groceries","Everyday Expenses","Groceries","TRADER JOE'S #200 QPS",$20.79,$0.00,C,$2.20
"Venture Card",,,10/01/2015,"SQ *ELLIE YELDING-SLOAN,","Everyday Expenses:Medical","Everyday Expenses","Medical","SQ *ELLIE YELDING-SLOAN,",$25.00,$0.00,C,-$22.80
"Venture Card",,,10/01/2015,"SQ *SUGAR SAN FRANCISCO","Everyday Expenses:Health & Fitness","Everyday Expenses","Health & Fitness","SQ *SUGAR SAN FRANCISCO",$60.00,$0.00,C,-$82.80
"Venture Card",,,10/03/2015,"CHIPOTLE 1857","Everyday Expenses:Spending Money","Everyday Expenses","Spending Money","CHIPOTLE 1857",$8.32,$0.00,C,-$91.12
"Venture Card",,,10/03/2015,"UNO DOS TACO","Everyday Expenses:Spending Money","Everyday Expenses","Spending Money","UNO DOS TACO",$8.70,$0.00,C,-$99.82
"Venture Card",,,10/03/2015,"BITE","Everyday Expenses:Spending Money","Everyday Expenses","Spending Money","BITE",$19.99,$0.00,C,-$119.81
"Venture Card",,,10/03/2015,"AMAZON MKTPLACE PMTS","Everyday Expenses:Spending Money","Everyday Expenses","Spending Money","AMAZON MKTPLACE PMTS",$60.82,$0.00,C,-$180.63
"Venture Card",,,10/05/2015,"SQ *LOVING CUP","Everyday Expenses:Spending Money","Everyday Expenses","Spending Money","SQ *LOVING CUP",$5.00,$0.00,C,-$185.63
"Venture Card",,,10/05/2015,"LYFT *RIDE SAT 9PM","Everyday Expenses:Transportation","Everyday Expenses","Transportation","LYFT *RIDE SAT 9PM",$6.69,$0.00,C,-$192.32
"Venture Card",,,10/05/2015,"TARGET 00027664","Everyday Expenses:Household Goods","Everyday Expenses","Household Goods","TARGET 00027664",$6.70,$0.00,C,-$199.02
"Venture Card",,,10/05/2015,"WEST COAST EVENTS BAJA GR","Everyday Expenses:Spending Money","Everyday Expenses","Spending Money","WEST COAST EVENTS BAJA GR",$7.50,$0.00,C,-$206.52
"Venture Card",,,10/05/2015,"AMAZON MKTPLACE PMTS","Everyday Expenses:Spending Money","Everyday Expenses","Spending Money","AMAZON MKTPLACE PMTS",$7.74,$0.00,C,-$214.26
"Venture Card",,,10/05/2015,"BELLISSIMO PIZZA","Everyday Expenses:Spending Money","Everyday Expenses","Spending Money","BELLISSIMO PIZZA",$8.25,$0.00,C,-$222.51
"Venture Card",,,10/05/2015,"SQ *EARTHLY DELIGHTS","Everyday Expenses:Spending Money","Everyday Expenses","Spending Money","SQ *EARTHLY DELIGHTS",$10.88,$0.00,C,-$233.39
"Venture Card",,,10/05/2015,"LYFT *RIDE SAT 10AM","Everyday Expenses:Transportation","Everyday Expenses","Transportation","LYFT *RIDE SAT 10AM",$12.45,$0.00,C,-$245.84
"Venture Card",,,10/05/2015,"LYFT *RIDE THU 6PM","Everyday Expenses:Transportation","Everyday Expenses","Transportation","LYFT *RIDE THU 6PM",$12.73,$0.00,C,-$258.57
"Venture Card",,,10/05/2015,"LYFT *RIDE SAT 3PM","Everyday Expenses:Transportation","Everyday Expenses","Transportation","LYFT *RIDE SAT 3PM",$14.62,$0.00,C,-$273.19
"Venture Card",,,10/05/2015,"SUTTER FINE FOOD","Everyday Expenses:Groceries","Everyday Expenses","Groceries","SUTTER FINE FOOD",$17.67,$0.00,C,-$290.86
"Venture Card",,,10/05/2015,"ROMPER ROOM","Everyday Expenses:Spending Money","Everyday Expenses","Spending Money","ROMPER ROOM",$23.00,$0.00,C,-$313.86
"Venture Card",,,10/05/2015,"RICKHOUSE","Everyday Expenses:Spending Money","Everyday Expenses","Spending Money","RICKHOUSE",$36.28,$0.00,C,-$350.14
"Venture Card",,,10/05/2015,"LOCAL EDITION BAR","Everyday Expenses:Spending Money","Everyday Expenses","Spending Money","LOCAL EDITION BAR",$60.88,$0.00,C,-$411.02
"Venture Card",,,10/05/2015,"RUMORS","Everyday Expenses:Spending Money","Everyday Expenses","Spending Money","RUMORS",$65.73,$0.00,C,-$476.75
"Venture Card",,,10/05/2015,"CLASSPASS.COM","Everyday Expenses:Health & Fitness","Everyday Expenses","Health & Fitness","CLASSPASS.COM",$99.00,$0.00,C,-$575.75
"Venture Card",,,10/05/2015,"MURPHYS","Everyday Expenses:Spending Money","Everyday Expenses","Spending Money","MURPHYS",$100.00,$0.00,C,-$675.75
"Venture Card",,,10/06/2015,"SQ *CUP A JOE COFFE","Everyday Expenses:Coffee Shop","Everyday Expenses","Coffee Shop","SQ *CUP A JOE COFFE",$6.50,$0.00,C,-$682.25
"Venture Card",,,10/06/2015,"FLEUR DE SEL","Everyday Expenses:Spending Money","Everyday Expenses","Spending Money","FLEUR DE SEL",$9.10,$0.00,C,-$691.35
"Venture Card",,,10/06/2015,"GHOST PERSONAL","Monthly Bills:Web Stuff","Monthly Bills","Web Stuff","GHOST PERSONAL",$10.00,$0.00,C,-$701.35
"Venture Card",,,10/06/2015,"AMAZON MKTPLACE PMTS","Everyday Expenses:Spending Money","Everyday Expenses","Spending Money","AMAZON MKTPLACE PMTS",$13.89,$0.00,C,-$715.24
"Venture Card",,,10/06/2015,"LYFT *RIDE SUN 6PM","Everyday Expenses:Transportation","Everyday Expenses","Transportation","LYFT *RIDE SUN 6PM",$24.16,$0.00,C,-$739.40
"Venture Card",,,10/06/2015,"KYOTO SUSHI","Everyday Expenses:Spending Money","Everyday Expenses","Spending Money","KYOTO SUSHI",$45.00,$0.00,C,-$784.40
"Venture Card",,,10/06/2015,"MODCLOTH","Everyday Expenses:Clothing","Everyday Expenses","Clothing","MODCLOTH",$63.18,$0.00,C,-$847.58
"Venture Card",,,10/07/2015,"CAPITAL ONE ONLINE PYMT","Pre-YNAB Debt:Venture Card","Pre-YNAB Debt","Venture Card","CAPITAL ONE ONLINE PYMT AuthDate 06-OCT",$0.00,$500.00,C,-$347.58
"Venture Card",,,10/07/2015,"DAILY BURN, INC.","Everyday Expenses:Health & Fitness","Everyday Expenses","Health & Fitness","DAILY BURN, INC.",$12.95,$0.00,C,-$360.53
"Venture Card",,,10/07/2015,"SUTTER FINE FOOD","Everyday Expenses:Groceries","Everyday Expenses","Groceries","SUTTER FINE FOOD",$17.46,$0.00,C,-$377.99
"Venture Card",,,10/07/2015,"WALGREENS #13666","Everyday Expenses:Household Goods","Everyday Expenses","Household Goods","WALGREENS #13666",$30.91,$0.00,C,-$408.90
"Venture Card",,,10/08/2015,"CHIPOTLE 0839","Everyday Expenses:Spending Money","Everyday Expenses","Spending Money","CHIPOTLE 0839",$8.86,$0.00,C,-$417.76
"Venture Card",,,10/08/2015,"SUTTER FINE FOOD","Everyday Expenses:Groceries","Everyday Expenses","Groceries","SUTTER FINE FOOD",$11.16,$0.00,C,-$428.92
"Venture Card",,,10/08/2015,"MODCLOTH","Everyday Expenses:Clothing","Everyday Expenses","Clothing","MODCLOTH",$79.54,$0.00,C,-$508.46
"Venture Card",,,10/09/2015,"CAPITAL ONE ONLINE PYMT AuthDate 09-O CT","Pre-YNAB Debt:Venture Card","Pre-YNAB Debt","Venture Card","CAPITAL ONE ONLINE PYMT AuthDate 09-O CT",$0.00,$568.43,C,$59.97
"Venture Card",,,10/09/2015,"GAP US 150","Everyday Expenses:Clothing","Everyday Expenses","Clothing","GAP US 150",$0.00,$91.29,C,$151.26
"Venture Card",,,10/09/2015,"Audible US","Monthly Bills:Web Stuff","Monthly Bills","Web Stuff","Audible US",$13.22,$0.00,C,$138.04
"Venture Card",,,10/09/2015,"SUTTER FINE FOOD","Everyday Expenses:Groceries","Everyday Expenses","Groceries","SUTTER FINE FOOD",$16.32,$0.00,C,$121.72
"Venture Card",,,10/09/2015,"TARGET 00032011","Everyday Expenses:Household Goods","Everyday Expenses","Household Goods","TARGET 00032011",$24.03,$0.00,C,$97.69
"Venture Card",,,10/09/2015,"COMCAST CALIFORNIA","Monthly Bills:Internet","Monthly Bills","Internet","COMCAST CALIFORNIA",$77.83,$0.00,C,$19.86
"Venture Card",,,10/09/2015,"GAP US 150","Everyday Expenses:Clothing","Everyday Expenses","Clothing","GAP US 150",$127.17,$0.00,C,-$107.31
"Venture Card",,,10/10/2015,"FOOD FAIR MARKET","Everyday Expenses:Groceries","Everyday Expenses","Groceries","FOOD FAIR MARKET",$11.93,$0.00,C,-$119.24
"Venture Card",,,10/10/2015,"CLASSPASS.COM","Everyday Expenses:Health & Fitness","Everyday Expenses","Health & Fitness","CLASSPASS.COM",$15.00,$0.00,C,-$134.24
"Venture Card",,,10/10/2015,"THIRSTY BEAR BREWING COM","Everyday Expenses:Spending Money","Everyday Expenses","Spending Money","THIRSTY BEAR BREWING COM",$49.00,$0.00,C,-$183.24
"Venture Card",,,10/10/2015,"BRICK HOUSE CAFE","Everyday Expenses:Spending Money","Everyday Expenses","Spending Money","BRICK HOUSE CAFE",$55.96,$0.00,C,-$239.20
"Venture Card",,,10/12/2015,"LYFT *RIDE SAT 12PM","Everyday Expenses:Transportation","Everyday Expenses","Transportation","LYFT *RIDE SAT 12PM",$1.00,$0.00,C,-$240.20
"Venture Card",,,10/12/2015,"LYFT *RIDE SAT 5PM","Everyday Expenses:Transportation","Everyday Expenses","Transportation","LYFT *RIDE SAT 5PM",$1.55,$0.00,C,-$241.75
"Venture Card",,,10/12/2015,"BELLISSIMO PIZZA","Everyday Expenses:Spending Money","Everyday Expenses","Spending Money","BELLISSIMO PIZZA",$6.50,$0.00,C,-$248.25
"Venture Card",,,10/12/2015,"EAT24.COM","Everyday Expenses:Spending Money","Everyday Expenses","Spending Money","EAT24.COM",$8.98,$0.00,C,-$257.23
"Venture Card",,,10/12/2015,"SMALL FOODS","Everyday Expenses:Spending Money","Everyday Expenses","Spending Money","SMALL FOODS",$10.90,$0.00,C,-$268.13
"Venture Card",,,10/12/2015,"SUTTER FINE FOOD","Everyday Expenses:Groceries","Everyday Expenses","Groceries","SUTTER FINE FOOD",$11.19,$0.00,C,-$279.32
"Venture Card",,,10/12/2015,"CHEVRON 00090030","Everyday Expenses:Transportation","Everyday Expenses","Transportation","CHEVRON 00090030",$15.00,$0.00,C,-$294.32
"Venture Card",,,10/12/2015,"TRADER JOE'S #200 QPS","Everyday Expenses:Groceries","Everyday Expenses","Groceries","TRADER JOE'S #200 QPS",$42.37,$0.00,C,-$336.69
"Venture Card",,,10/13/2015,"CAPITAL ONE ONLINE PYMT","Pre-YNAB Debt:Venture Card","Pre-YNAB Debt","Venture Card","CAPITAL ONE ONLINE PYMT AuthDate 12-OCT",$0.00,$396.66,C,$59.97
"Venture Card",,,10/13/2015,"SQ *CUP A JOE COFFE","Everyday Expenses:Coffee Shop","Everyday Expenses","Coffee Shop","SQ *CUP A JOE COFFE",$6.50,$0.00,C,$53.47
"Venture Card",,,10/13/2015,"CHEZ FAYALA LLC","Everyday Expenses:Spending Money","Everyday Expenses","Spending Money","CHEZ FAYALA LLC",$10.33,$0.00,C,$43.14
"Venture Card",,,10/13/2015,"Audible","Monthly Bills:Web Stuff","Monthly Bills","Web Stuff","Audible",$14.95,$0.00,C,$28.19
"Venture Card",,,10/13/2015,"EAT24.COM","Everyday Expenses:Spending Money","Everyday Expenses","Spending Money","EAT24.COM",$16.85,$0.00,C,$11.34
"Venture Card",,,10/13/2015,"FISHERMAN'S GALLEY","Everyday Expenses:Spending Money","Everyday Expenses","Spending Money","FISHERMAN'S GALLEY",$17.29,$0.00,C,-$5.95
"Venture Card",,,10/13/2015,"MODCLOTH","Everyday Expenses:Clothing","Everyday Expenses","Clothing","MODCLOTH",$90.63,$0.00,C,-$96.58
"Venture Card",,,10/14/2015,"CHIPOTLE 1857","Everyday Expenses:Spending Money","Everyday Expenses","Spending Money","CHIPOTLE 1857",$8.32,$0.00,C,-$104.90
"Venture Card",,,10/14/2015,"THE REEF","Everyday Expenses:Spending Money","Everyday Expenses","Spending Money","THE REEF",$13.00,$0.00,C,-$117.90
"Venture Card",,,10/14/2015,"FLEXJOBS.COM","Monthly Bills:Web Stuff","Monthly Bills","Web Stuff","FLEXJOBS.COM",$14.95,$0.00,C,-$132.85
"Venture Card",,,10/14/2015,"WALGREENS #13666","Everyday Expenses:Household Goods","Everyday Expenses","Household Goods","WALGREENS #13666",$28.92,$0.00,C,-$161.77
"Venture Card",,,10/15/2015,"LYFT *RIDE TUE 9PM","Everyday Expenses:Transportation","Everyday Expenses","Transportation","LYFT *RIDE TUE 9PM",$1.00,$0.00,C,-$162.77
"Venture Card",,,10/15/2015,"SQ *CONTRABAND COFFEE IMM","Everyday Expenses:Coffee Shop","Everyday Expenses","Coffee Shop","SQ *CONTRABAND COFFEE IMM",$3.26,$0.00,C,-$166.03
"Venture Card",,,10/15/2015,"SQ *CUP A JOE COFFE","Everyday Expenses:Coffee Shop","Everyday Expenses","Coffee Shop","SQ *CUP A JOE COFFE",$6.50,$0.00,C,-$172.53
"Venture Card",,,10/15/2015,"FLEUR DE SEL","Everyday Expenses:Spending Money","Everyday Expenses","Spending Money","FLEUR DE SEL",$8.10,$0.00,C,-$180.63
"Venture Card",,,10/15/2015,"SPOONROCKET.COM","Everyday Expenses:Spending Money","Everyday Expenses","Spending Money","SPOONROCKET.COM",$8.13,$0.00,C,-$188.76
"Venture Card",,,10/15/2015,"KELLS OF SAN FRANCISCO","Everyday Expenses:Spending Money","Everyday Expenses","Spending Money","KELLS OF SAN FRANCISCO",$9.00,$0.00,C,-$197.76
"Venture Card",,,10/15/2015,"AYOLA (KEARNY)","Everyday Expenses:Spending Money","Everyday Expenses","Spending Money","AYOLA (KEARNY)",$10.56,$0.00,C,-$208.32
"Venture Card",,,10/15/2015,"KELLS OF SAN FRANCISCO","Everyday Expenses:Spending Money","Everyday Expenses","Spending Money","KELLS OF SAN FRANCISCO",$11.00,$0.00,C,-$219.32
"Venture Card",,,10/15/2015,"TOMMASO RISTORANTE ITALIA","Everyday Expenses:Spending Money","Everyday Expenses","Spending Money","TOMMASO RISTORANTE ITALIA",$19.39,$0.00,C,-$238.71
"Venture Card",,,10/15/2015,"TRADER JOE'S #200 QPS","Everyday Expenses:Groceries","Everyday Expenses","Groceries","TRADER JOE'S #200 QPS",$25.00,$0.00,C,-$263.71
"Venture Card",,,10/15/2015,"IDEAL BAR & GRILL","Everyday Expenses:Spending Money","Everyday Expenses","Spending Money","IDEAL BAR & GRILL",$82.70,$0.00,C,-$346.41
"Venture Card",,,10/15/2015,"AT&T*BILL PAYMENT","Monthly Bills:Cell Phone","Monthly Bills","Cell Phone","AT&T*BILL PAYMENT",$109.49,$0.00,C,-$455.90
"Venture Card",,,10/16/2015,"CHEZ FAYALA LLC","Everyday Expenses:Spending Money","Everyday Expenses","Spending Money","CHEZ FAYALA LLC",$6.53,$0.00,C,-$462.43
"Venture Card",,,10/16/2015,"FEDEX 860151842340","Everyday Expenses:Misc","Everyday Expenses","Misc","FEDEX 860151842340",$7.07,$0.00,C,-$469.50
"Venture Card",,,10/16/2015,"WALGREENS #13666","Everyday Expenses:Household Goods","Everyday Expenses","Household Goods","WALGREENS #13666",$7.32,$0.00,C,-$476.82
"Venture Card",,,10/16/2015,"HLU*Hulu 22744533-U","Monthly Bills:Web Stuff","Monthly Bills","Web Stuff","HLU*Hulu 22744533-U",$11.99,$0.00,C,-$488.81
"Venture Card",,,10/16/2015,"TRADER JOE'S #200 QPS","Everyday Expenses:Groceries","Everyday Expenses","Groceries","TRADER JOE'S #200 QPS",$24.13,$0.00,C,-$512.94
"Venture Card",,,10/16/2015,"SOUTHWES 5262151359701","Savings Goals:Vacation & Travel","Savings Goals","Vacation & Travel","SOUTHWES 5262151359701",$274.00,$0.00,C,-$786.94
"Venture Card",,,10/17/2015,"CREDIT-TRAVEL REWARD","Savings Goals:Vacation & Travel","Savings Goals","Vacation & Travel","CREDIT-TRAVEL REWARD",$0.00,$240.44,C,-$546.50
"Venture Card",,,10/17/2015,"AMAZON.COM AMZN.COM/BILL","Everyday Expenses:Spending Money","Everyday Expenses","Spending Money","AMAZON.COM AMZN.COM/BILL",$5.48,$0.00,C,-$551.98
"Venture Card",,,10/17/2015,"LYFT *RIDE FRI 6PM","Everyday Expenses:Transportation","Everyday Expenses","Transportation","LYFT *RIDE FRI 6PM",$6.00,$0.00,C,-$557.98
"Venture Card",,,10/17/2015,"CAFE MADELEINE - CALIF","Everyday Expenses:Spending Money","Everyday Expenses","Spending Money","CAFE MADELEINE - CALIF",$9.53,$0.00,C,-$567.51
"Venture Card",,,10/17/2015,"SQ *LA FROMAGERIE CHEESE","Everyday Expenses:Spending Money","Everyday Expenses","Spending Money","SQ *LA FROMAGERIE CHEESE",$10.99,$0.00,C,-$578.50
"Venture Card",,,10/17/2015,"Amazon.com","Everyday Expenses:Spending Money","Everyday Expenses","Spending Money","Amazon.com",$22.30,$0.00,C,-$600.80
"Venture Card",,,10/17/2015,"USPS 05683200034708701","Everyday Expenses:Spending Money","Everyday Expenses","Spending Money","USPS 05683200034708701",$31.18,$0.00,C,-$631.98
"Venture Card",,,10/17/2015,"WALGREENS #13666","Everyday Expenses:Household Goods","Everyday Expenses","Household Goods","WALGREENS #13666",$36.70,$0.00,C,-$668.68
"Venture Card",,,10/17/2015,"THE FORGE","Everyday Expenses:Spending Money","Everyday Expenses","Spending Money","THE FORGE",$60.24,$0.00,C,-$728.92
"Venture Card",,,10/17/2015,"AMAZON.COM AMZN.COM/BILL","Everyday Expenses:Spending Money","Everyday Expenses","Spending Money","AMAZON.COM AMZN.COM/BILL",$112.04,$0.00,C,-$840.96
"Venture Card",,,10/19/2015,"LYFT *CANCEL FEE","Everyday Expenses:Transportation","Everyday Expenses","Transportation","LYFT *CANCEL FEE",$0.00,$5.00,C,-$835.96
"Venture Card",,,10/19/2015,"LYFT *CANCEL FEE","Everyday Expenses:Transportation","Everyday Expenses","Transportation","LYFT *CANCEL FEE",$5.00,$0.00,C,-$840.96
"Venture Card",,,10/19/2015,"USA*AMI MUSICBOX","Everyday Expenses:Spending Money","Everyday Expenses","Spending Money","USA*AMI MUSICBOX",$5.00,$0.00,C,-$845.96
"Venture Card",,,10/19/2015,"LYFT *RIDE FRI 7PM","Everyday Expenses:Transportation","Everyday Expenses","Transportation","LYFT *RIDE FRI 7PM",$6.00,$0.00,C,-$851.96
"Venture Card",,,10/19/2015,"LYFT *RIDE SUN 4PM","Everyday Expenses:Transportation","Everyday Expenses","Transportation","LYFT *RIDE SUN 4PM",$8.00,$0.00,C,-$859.96
"Venture Card",,,10/19/2015,"LYFT *RIDE SUN 7PM","Everyday Expenses:Transportation","Everyday Expenses","Transportation","LYFT *RIDE SUN 7PM",$8.00,$0.00,C,-$867.96
"Venture Card",,,10/19/2015,"MUSTAFIO'S PIZZA","Everyday Expenses:Spending Money","Everyday Expenses","Spending Money","MUSTAFIO'S PIZZA",$8.50,$0.00,C,-$876.46
"Venture Card",,,10/19/2015,"Amazon.com","Everyday Expenses:Spending Money","Everyday Expenses","Spending Money","Amazon.com",$8.62,$0.00,C,-$885.08
"Venture Card",,,10/19/2015,"ADY*Spotify USA","Monthly Bills:Web Stuff","Monthly Bills","Web Stuff","ADY*Spotify USA",$9.99,$0.00,C,-$895.07
"Venture Card",,,10/19/2015,"THE POSH BAGEL","Everyday Expenses:Spending Money","Everyday Expenses","Spending Money","THE POSH BAGEL",$19.58,$0.00,C,-$914.65
"Venture Card",,,10/19/2015,"SUTTER FINE FOOD","Everyday Expenses:Groceries","Everyday Expenses","Groceries","SUTTER FINE FOOD",$23.97,$0.00,C,-$938.62
"Venture Card",,,10/19/2015,"LYFT *RIDE SAT 11AM","Everyday Expenses:Transportation","Everyday Expenses","Transportation","LYFT *RIDE SAT 11AM",$27.80,$0.00,C,-$966.42
"Venture Card",,,10/19/2015,"NARA SUSHI","Everyday Expenses:Spending Money","Everyday Expenses","Spending Money","NARA SUSHI",$28.41,$0.00,C,-$994.83
"Venture Card",,,10/19/2015,"FANDANGO.COM","Everyday Expenses:Spending Money","Everyday Expenses","Spending Money","FANDANGO.COM",$35.18,$0.00,C,-$1030.01
"Venture Card",,,10/19/2015,"HEINOLD'S FIRST & LAST C","Everyday Expenses:Spending Money","Everyday Expenses","Spending Money","HEINOLD'S FIRST & LAST C",$38.00,$0.00,C,-$1068.01
"Venture Card",,,10/19/2015,"APPLE STORE #R075","Everyday Expenses:Spending Money","Everyday Expenses","Spending Money","APPLE STORE #R075",$118.54,$0.00,C,-$1186.55
"Venture Card",,,10/20/2015,"CAPITAL ONE ONLINE PYMT","Pre-YNAB Debt:Venture Card","Pre-YNAB Debt","Venture Card","CAPITAL ONE ONLINE PYMT AuthDate 19-OCT",$0.00,$1006.52,C,-$180.03
"Venture Card",,,10/20/2015,"WORKING GIRLS CAFE #2","Everyday Expenses:Spending Money","Everyday Expenses","Spending Money","WORKING GIRLS CAFE #2",$10.82,$0.00,C,-$190.85
"Venture Card",,,10/20/2015,"USPS 05683200034708701","Everyday Expenses:Spending Money","Everyday Expenses","Spending Money","USPS 05683200034708701",$30.08,$0.00,C,-$220.93
"Venture Card",,,10/20/2015,"PARK CHOW","Everyday Expenses:Spending Money","Everyday Expenses","Spending Money","PARK CHOW",$42.33,$0.00,C,-$263.26
"Venture Card",,,10/20/2015,"TRADER JOE'S #200 QPS","Everyday Expenses:Groceries","Everyday Expenses","Groceries","TRADER JOE'S #200 QPS",$47.68,$0.00,C,-$310.94
"Venture Card",,,10/21/2015,"WALGREENS #5618","Everyday Expenses:Household Goods","Everyday Expenses","Household Goods","WALGREENS #5618",$11.93,$0.00,C,-$322.87
"Venture Card",,,10/22/2015,"GETAROUND","Everyday Expenses:Transportation","Everyday Expenses","Transportation","GETAROUND",$2.02,$0.00,C,-$324.89
"Venture Card",,,10/22/2015,"AMAZON.COM AMZN.COM/BILL","Everyday Expenses:Spending Money","Everyday Expenses","Spending Money","AMAZON.COM AMZN.COM/BILL",$8.65,$0.00,C,-$333.54
"Venture Card",,,10/22/2015,"UNO DOS TACO","Everyday Expenses:Spending Money","Everyday Expenses","Spending Money","UNO DOS TACO",$73.68,$0.00,C,-$407.22
"Venture Card",,,10/22/2015,"APL*APPLE ONLINE STORE","Everyday Expenses:Misc","Everyday Expenses","Misc","APL*APPLE ONLINE STORE",$85.91,$0.00,C,-$493.13
"Venture Card",,,10/23/2015,"CAPITAL ONE ONLINE PYMT","Pre-YNAB Debt:Venture Card","Pre-YNAB Debt","Venture Card","CAPITAL ONE ONLINE PYMT AuthDate 23-OCT",$0.00,$568.43,C,$75.30
"Venture Card",,,10/23/2015,"SQ *CONTRABAND COFFEE IMM","Everyday Expenses:Coffee Shop","Everyday Expenses","Coffee Shop","SQ *CONTRABAND COFFEE IMM",$2.50,$0.00,C,$72.80
"Venture Card",,,10/23/2015,"ADY*Spotify USA","Monthly Bills:Web Stuff","Monthly Bills","Web Stuff","ADY*Spotify USA",$9.99,$0.00,C,$62.81
"Venture Card",,,10/23/2015,"BELLISSIMO PIZZA","Everyday Expenses:Spending Money","Everyday Expenses","Spending Money","BELLISSIMO PIZZA",$11.50,$0.00,C,$51.31
"Venture Card",,,10/23/2015,"CVS/PHARMACY #10080","Everyday Expenses:Medical","Everyday Expenses","Medical","CVS/PHARMACY #10080",$15.00,$0.00,C,$36.31
"Venture Card",,,10/23/2015,"MODCLOTH","Everyday Expenses:Clothing","Everyday Expenses","Clothing","MODCLOTH",$110.55,$0.00,C,-$74.24
"Venture Card",,,10/24/2015,"SQ *ANOTHER CAFE","Everyday Expenses:Coffee Shop","Everyday Expenses","Coffee Shop","SQ *ANOTHER CAFE",$4.30,$0.00,C,-$78.54
"Venture Card",,,10/24/2015,"USPS 05683200034708701","Everyday Expenses:Spending Money","Everyday Expenses","Spending Money","USPS 05683200034708701",$5.75,$0.00,C,-$84.29
"Venture Card",,,10/24/2015,"SQ *CUP A JOE COFFE","Everyday Expenses:Coffee Shop","Everyday Expenses","Coffee Shop","SQ *CUP A JOE COFFE",$6.50,$0.00,C,-$90.79
"Venture Card",,,10/24/2015,"WALGREENS #13666","Everyday Expenses:Household Goods","Everyday Expenses","Household Goods","WALGREENS #13666",$9.02,$0.00,C,-$99.81
"Venture Card",,,10/24/2015,"RAMEN BAR","Everyday Expenses:Spending Money","Everyday Expenses","Spending Money","RAMEN BAR",$13.50,$0.00,C,-$113.31
"Venture Card",,,10/24/2015,"SUTTER FINE FOOD","Everyday Expenses:Groceries","Everyday Expenses","Groceries","SUTTER FINE FOOD",$16.96,$0.00,C,-$130.27
"Venture Card",,,10/24/2015,"GO GETTERS PIZZA","Everyday Expenses:Spending Money","Everyday Expenses","Spending Money","GO GETTERS PIZZA",$42.69,$0.00,C,-$172.96
"Venture Card",,,10/26/2015,"LYFT *RIDE SAT 6PM","Everyday Expenses:Transportation","Everyday Expenses","Transportation","LYFT *RIDE SAT 6PM",$1.00,$0.00,C,-$173.96
"Venture Card",,,10/26/2015,"LYFT *RIDE SAT 8PM","Everyday Expenses:Transportation","Everyday Expenses","Transportation","LYFT *RIDE SAT 8PM",$1.00,$0.00,C,-$174.96
"Venture Card",,,10/26/2015,"LYFT *RIDE SUN 2AM","Everyday Expenses:Transportation","Everyday Expenses","Transportation","LYFT *RIDE SUN 2AM",$2.78,$0.00,C,-$177.74
"Venture Card",,,10/26/2015,"AJS COFFEE INC - HALF","Everyday Expenses:Coffee Shop","Everyday Expenses","Coffee Shop","AJS COFFEE INC - HALF",$3.20,$0.00,C,-$180.94
"Venture Card",,,10/26/2015,"SQ *BLUE BOTTLE COFFEE","Everyday Expenses:Coffee Shop","Everyday Expenses","Coffee Shop","SQ *BLUE BOTTLE COFFEE",$4.00,$0.00,C,-$184.94
"Venture Card",,,10/26/2015,"LYFT *RIDE FRI 7PM","Everyday Expenses:Transportation","Everyday Expenses","Transportation","LYFT *RIDE FRI 7PM",$4.17,$0.00,C,-$189.11
"Venture Card",,,10/26/2015,"BART-CLIPPER CIVIC CTR","Everyday Expenses:Transportation","Everyday Expenses","Transportation","BART-CLIPPER CIVIC CTR",$6.60,$0.00,C,-$195.71
"Venture Card",,,10/26/2015,"COURTYARD OAKLAND DT","Everyday Expenses:Spending Money","Everyday Expenses","Spending Money","COURTYARD OAKLAND DT",$12.32,$0.00,C,-$208.03
"Venture Card",,,10/26/2015,"VALERO #7262","Everyday Expenses:Transportation","Everyday Expenses","Transportation","VALERO #7262",$15.30,$0.00,C,-$223.33
"Venture Card",,,10/26/2015,"SQ *H2O CAFE","Everyday Expenses:Spending Money","Everyday Expenses","Spending Money","SQ *H2O CAFE",$18.72,$0.00,C,-$242.05
"Venture Card",,,10/26/2015,"SMARTNFINAL44611004462","Everyday Expenses:Spending Money","Everyday Expenses","Spending Money","SMARTNFINAL44611004462",$24.43,$0.00,C,-$266.48
"Venture Card",,,10/26/2015,"SMUGGLER'S COVE","Everyday Expenses:Spending Money","Everyday Expenses","Spending Money","SMUGGLER'S COVE",$29.00,$0.00,C,-$295.48
"Venture Card",,,10/26/2015,"TRADER JOE'S #200 QPS","Everyday Expenses:Groceries","Everyday Expenses","Groceries","TRADER JOE'S #200 QPS",$62.84,$0.00,C,-$358.32
"Venture Card",,,10/27/2015,"CAPITAL ONE ONLINE PYMT AuthDate 26-O CT","Pre-YNAB Debt:Venture Card","Pre-YNAB Debt","Venture Card","CAPITAL ONE ONLINE PYMT AuthDate 26-O CT",$0.00,$418.29,C,$59.97
"Venture Card",,,10/27/2015,"LYFT *RIDE SUN 11AM","Everyday Expenses:Transportation","Everyday Expenses","Transportation","LYFT *RIDE SUN 11AM",$1.27,$0.00,C,$58.70
"Venture Card",,,10/27/2015,"SQ *BLUE BOTTLE COFFEE","Everyday Expenses:Coffee Shop","Everyday Expenses","Coffee Shop","SQ *BLUE BOTTLE COFFEE",$4.50,$0.00,C,$54.20
"Venture Card",,,10/27/2015,"CHIPOTLE 1857","Everyday Expenses:Spending Money","Everyday Expenses","Spending Money","CHIPOTLE 1857",$8.32,$0.00,C,$45.88
"Venture Card",,,10/27/2015,"AMAZON MKTPLACE PMTS","Everyday Expenses:Spending Money","Everyday Expenses","Spending Money","AMAZON MKTPLACE PMTS",$18.79,$0.00,C,$27.09
"Venture Card",,,10/27/2015,"AMAZON MKTPLACE PMTS","Everyday Expenses:Spending Money","Everyday Expenses","Spending Money","AMAZON MKTPLACE PMTS",$26.59,$0.00,C,$0.50
"Venture Card",,,10/27/2015,"BARLAGO","Everyday Expenses:Spending Money","Everyday Expenses","Spending Money","BARLAGO",$50.98,$0.00,C,-$50.48
"Venture Card",,,10/27/2015,"COURTYARD OAKLAND DT","Everyday Expenses:Spending Money","Everyday Expenses","Spending Money","COURTYARD OAKLAND DT",$194.32,$0.00,C,-$244.80
"Venture Card",,,10/28/2015,"GITHUB.COM","Monthly Bills:Web Stuff","Monthly Bills","Web Stuff","GITHUB.COM",$0.00,$6.78,C,-$238.02
"Venture Card",,,10/28/2015,"GITHUB.COM FVEW","Monthly Bills:Web Stuff","Monthly Bills","Web Stuff","GITHUB.COM FVEW",$7.00,$0.00,C,-$245.02
"Venture Card",,,10/28/2015,"FRESHROLL","Everyday Expenses:Spending Money","Everyday Expenses","Spending Money","FRESHROLL",$9.50,$0.00,C,-$254.52
"Venture Card",,,10/28/2015,"WALGREENS #13666","Everyday Expenses:Household Goods","Everyday Expenses","Household Goods","WALGREENS #13666",$34.77,$0.00,C,-$289.29
"Venture Card",,,10/29/2015,"SPIRO COFFEE AND C","Everyday Expenses:Spending Money","Everyday Expenses","Spending Money","SPIRO COFFEE AND C",$10.06,$0.00,C,-$299.35
"Venture Card",,,10/29/2015,"TARGET 00032011","Everyday Expenses:Household Goods","Everyday Expenses","Household Goods","TARGET 00032011",$10.96,$0.00,C,-$310.31
"Venture Card",,,10/29/2015,"FORA THINK SPACE","Everyday Expenses:Spending Money","Everyday Expenses","Spending Money","FORA THINK SPACE",$12.78,$0.00,C,-$323.09
"Venture Card",,,10/29/2015,"FLY","Everyday Expenses:Spending Money","Everyday Expenses","Spending Money","FLY",$35.02,$0.00,C,-$358.11
"Venture Card",,,10/29/2015,"GAP ONLINE","Everyday Expenses:Clothing","Everyday Expenses","Clothing","GAP ONLINE",$51.04,$0.00,C,-$409.15
"Venture Card",,,10/30/2015,"CAPITAL ONE ONLINE PYMT AuthDate 30-O CT","Pre-YNAB Debt:Venture Card","Pre-YNAB Debt","Venture Card","CAPITAL ONE ONLINE PYMT AuthDate 30-O CT",$0.00,$469.12,C,$59.97
"Venture Card",,,10/30/2015,"SQ *ANOTHER CAFE","Everyday Expenses:Coffee Shop","Everyday Expenses","Coffee Shop","SQ *ANOTHER CAFE",$2.99,$0.00,C,$56.98
"Venture Card",,,10/30/2015,"WALGREENS #5618","Everyday Expenses:Household Goods","Everyday Expenses","Household Goods","WALGREENS #5618",$3.25,$0.00,C,$53.73
"Venture Card",,,10/30/2015,"SQ *ANOTHER CAFE","Everyday Expenses:Coffee Shop","Everyday Expenses","Coffee Shop","SQ *ANOTHER CAFE",$4.30,$0.00,C,$49.43
"Venture Card",,,10/30/2015,"CAFE VENUE","Everyday Expenses:Spending Money","Everyday Expenses","Spending Money","CAFE VENUE",$10.19,$0.00,C,$39.24
"Venture Card",,,10/30/2015,"SUTTER FINE FOOD","Everyday Expenses:Groceries","Everyday Expenses","Groceries","SUTTER FINE FOOD",$10.47,$0.00,C,$28.77
"Venture Card",,,10/30/2015,"ORDERAHEAD ONIGILLY","Everyday Expenses:Spending Money","Everyday Expenses","Spending Money","ORDERAHEAD ONIGILLY",$11.79,$0.00,C,$16.98
"Venture Card",,,10/30/2015,"H&M #80","Everyday Expenses:Clothing","Everyday Expenses","Clothing","H&M #80",$44.55,$0.00,C,-$27.57
"Venture Card",,,10/30/2015,"AMAZON MKTPLACE PMTS","Everyday Expenses:Spending Money","Everyday Expenses","Spending Money","AMAZON MKTPLACE PMTS",$50.96,$0.00,C,-$78.53
"Venture Card",,,10/30/2015,"DENTAL AESTHETICA","Everyday Expenses:Medical","Everyday Expenses","Medical","DENTAL AESTHETICA",$250.00,$0.00,C,-$328.53
"Venture Card",,,10/30/2015,"DENTAL AESTHETICA","Everyday Expenses:Medical","Everyday Expenses","Medical","DENTAL AESTHETICA",$305.00,$0.00,C,-$633.53
"Venture Card",,,10/31/2015,"LYFT *RIDE THU 9PM","Everyday Expenses:Transportation","Everyday Expenses","Transportation","LYFT *RIDE THU 9PM",$5.00,$0.00,C,-$638.53
"Venture Card",,,10/31/2015,"SUTTER FINE FOOD","Everyday Expenses:Groceries","Everyday Expenses","Groceries","SUTTER FINE FOOD",$6.29,$0.00,C,-$644.82
"Venture Card",,,10/31/2015,"THE POSH BAGEL","Everyday Expenses:Spending Money","Everyday Expenses","Spending Money","THE POSH BAGEL",$7.60,$0.00,C,-$652.42
"Venture Card",,,10/31/2015,"SF PARTY","Everyday Expenses:Spending Money","Everyday Expenses","Spending Money","SF PARTY",$71.72,$0.00,C,-$724.14
"Venture Card",,,11/02/2015,"CAPITAL ONE ONLINE PYMT","Pre-YNAB Debt:Venture Card","Pre-YNAB Debt","Venture Card","CAPITAL ONE ONLINE PYMT AuthDate 01-NOV",$0.00,$784.11,C,$59.97
"Venture Card",,,11/02/2015,"LYFT *RIDE FRI 9AM","Everyday Expenses:Transportation","Everyday Expenses","Transportation","LYFT *RIDE FRI 9AM",$6.00,$0.00,C,$53.97
"Venture Card",,,11/02/2015,"HY VEE 1385","Everyday Expenses:Groceries","Everyday Expenses","Groceries","HY VEE 1385",$6.94,$0.00,C,$47.03
"Venture Card",,,11/02/2015,"SWA INFLIGHT WIFI","Everyday Expenses:Spending Money","Everyday Expenses","Spending Money","SWA INFLIGHT WIFI",$8.00,$0.00,C,$39.03
"Venture Card",,,11/02/2015,"LOVES COUNTRY 00003475","Everyday Expenses:Spending Money","Everyday Expenses","Spending Money","LOVES COUNTRY 00003475",$9.33,$0.00,C,$29.70
"Venture Card",,,11/02/2015,"DEMPSEYS IRISH PUB","Everyday Expenses:Spending Money","Everyday Expenses","Spending Money","DEMPSEYS IRISH PUB",$10.00,$0.00,C,$19.70
"Venture Card",,,11/02/2015,"C FRENCH MEADO20604781","Everyday Expenses:Spending Money","Everyday Expenses","Spending Money","C FRENCH MEADO20604781",$10.59,$0.00,C,$9.11
"Venture Card",,,11/02/2015,"PANERA BREAD #1044","Everyday Expenses:Spending Money","Everyday Expenses","Spending Money","PANERA BREAD #1044",$11.24,$0.00,C,-$2.13
"Venture Card",,,11/02/2015,"TAVERN ON THE SQUARE","Everyday Expenses:Spending Money","Everyday Expenses","Spending Money","TAVERN ON THE SQUARE",$13.75,$0.00,C,-$15.88
"Venture Card",,,11/02/2015,"STARBUCKS CARD RELOAD","Everyday Expenses:Coffee Shop","Everyday Expenses","Coffee Shop","STARBUCKS CARD RELOAD",$15.00,$0.00,C,-$30.88
"Venture Card",,,11/02/2015,"CHIPOTLE 0669","Everyday Expenses:Spending Money","Everyday Expenses","Spending Money","CHIPOTLE 0669",$16.21,$0.00,C,-$47.09
"Venture Card",,,11/02/2015,"AMAZON MKTPLACE PMTS","Everyday Expenses:Spending Money","Everyday Expenses","Spending Money","AMAZON MKTPLACE PMTS",$21.97,$0.00,C,-$69.06
"Venture Card",,,11/02/2015,"WALGREENS #0541","Everyday Expenses:Household Goods","Everyday Expenses","Household Goods","WALGREENS #0541",$22.48,$0.00,C,-$91.54
"Venture Card",,,11/02/2015,"SQ *CULTIVA","Everyday Expenses:Spending Money","Everyday Expenses","Spending Money","SQ *CULTIVA",$24.35,$0.00,C,-$115.89
"Venture Card",,,11/02/2015,"WILLOW CRK GRL SFO TRM","Everyday Expenses:Spending Money","Everyday Expenses","Spending Money","WILLOW CRK GRL SFO TRM",$25.57,$0.00,C,-$141.46
"Venture Card",,,11/02/2015,"Amazon.com","Everyday Expenses:Spending Money","Everyday Expenses","Spending Money","Amazon.com",$26.00,$0.00,C,-$167.46
"Venture Card",,,11/02/2015,"WM SUPERCENTER #1943","Everyday Expenses:Spending Money","Everyday Expenses","Spending Money","WM SUPERCENTER #1943",$51.61,$0.00,C,-$219.07
"Venture Card",,,11/02/2015,"HY VEE 1385","Everyday Expenses:Groceries","Everyday Expenses","Groceries","HY VEE 1385",$143.64,$0.00,C,-$362.71
"Venture Card",,,11/03/2015,"APL* ITUNES.COM/BILL","Everyday Expenses:Spending Money","Everyday Expenses","Spending Money","APL* ITUNES.COM/BILL",$1.99,$0.00,C,-$364.70
"Venture Card",,,11/03/2015,"SQ *THE MILL IN THE HAYMA","Everyday Expenses:Spending Money","Everyday Expenses","Spending Money","SQ *THE MILL IN THE HAYMA",$3.10,$0.00,C,-$367.80
"Venture Card",,,11/03/2015,"BARRYMORES LOUNGE","Everyday Expenses:Spending Money","Everyday Expenses","Spending Money","BARRYMORES LOUNGE",$15.70,$0.00,C,-$383.50
"Venture Card",,,11/03/2015,"AMAZON MKTPLACE PMTS","Everyday Expenses:Spending Money","Everyday Expenses","Spending Money","AMAZON MKTPLACE PMTS",$32.24,$0.00,C,-$415.74
"Venture Card",,,11/04/2015,"CAPITAL ONE ONLINE PYMT","Pre-YNAB Debt:Venture Card","Pre-YNAB Debt","Venture Card","CAPITAL ONE ONLINE PYMT AuthDate 04-NOV",$0.00,$475.71,C,$59.97
"Venture Card",,,11/04/2015,"SQ *THE COFFEE HOUSE","Everyday Expenses:Coffee Shop","Everyday Expenses","Coffee Shop","SQ *THE COFFEE HOUSE",$4.10,$0.00,C,$55.87
"Venture Card",,,11/04/2015,"YMCA-METRO","Everyday Expenses:Health & Fitness","Everyday Expenses","Health & Fitness","YMCA-METRO",$47.37,$0.00,C,$8.50
"Venture Card",,,11/04/2015,"AIRBNB INC","Savings Goals:Vacation & Travel","Savings Goals","Vacation & Travel","AIRBNB INC",$586.00,$0.00,C,-$577.50
"Venture Card",,,11/05/2015,"CAPITAL ONE AUTOPAY PYMT","Pre-YNAB Debt:Venture Card","Pre-YNAB Debt","Venture Card","CAPITAL ONE AUTOPAY PYMT AuthDate 05-NOV",$0.00,$475.71,C,-$101.79
"Venture Card",,,11/05/2015,"GAP ONLINE","Everyday Expenses:Clothing","Everyday Expenses","Clothing","GAP ONLINE",$0.00,$7.30,C,-$94.49
"Venture Card",,,11/05/2015,"SQ *THE MILL IN THE HAYMA","Everyday Expenses:Spending Money","Everyday Expenses","Spending Money","SQ *THE MILL IN THE HAYMA",$3.60,$0.00,C,-$98.09
"Venture Card",,,11/05/2015,"ROJO'S GOODS","Everyday Expenses:Spending Money","Everyday Expenses","Spending Money","ROJO'S GOODS",$5.16,$0.00,C,-$103.25
"Venture Card",,,11/05/2015,"SQ *THE MILL IN THE HAYMA","Everyday Expenses:Coffee Shop","Everyday Expenses","Coffee Shop","SQ *THE MILL IN THE HAYMA",$5.90,$0.00,C,-$109.15
"Venture Card",,,11/05/2015,"JAKE'S CIGARS & SPIRITS","Everyday Expenses:Spending Money","Everyday Expenses","Spending Money","JAKE'S CIGARS & SPIRITS",$9.21,$0.00,C,-$118.36
"Venture Card",,,11/05/2015,"YIAS YIAS","Everyday Expenses:Spending Money","Everyday Expenses","Spending Money","YIAS YIAS",$10.75,$0.00,C,-$129.11
"Venture Card",,,11/05/2015,"SQ *MAGGIE'S CAFE","Everyday Expenses:Spending Money","Everyday Expenses","Spending Money","SQ *MAGGIE'S CAFE",$21.21,$0.00,C,-$150.32
"Venture Card",,,11/06/2015,"CAPITAL ONE ONLINE PYMT","Pre-YNAB Debt:Venture Card","Pre-YNAB Debt","Venture Card","CAPITAL ONE ONLINE PYMT AuthDate 06-NOV",$0.00,$210.29,C,$59.97
"Venture Card",,,11/06/2015,"GAP ONLINE","Everyday Expenses:Clothing","Everyday Expenses","Clothing","GAP ONLINE",$0.00,$0.87,C,$60.84
"Venture Card",,,11/06/2015,"13TH STREET COFFEE","Everyday Expenses:Coffee Shop","Everyday Expenses","Coffee Shop","13TH STREET COFFEE",$4.60,$0.00,C,$56.24
"Venture Card",,,11/06/2015,"FUZZYS TACO SHOP LINCOLN","Everyday Expenses:Spending Money","Everyday Expenses","Spending Money","FUZZYS TACO SHOP LINCOLN",$16.00,$0.00,C,$40.24
"Venture Card",,,11/06/2015,"MODCLOTH","Everyday Expenses:Clothing","Everyday Expenses","Clothing","MODCLOTH",$18.80,$0.00,C,$21.44
"Venture Card",,,11/07/2015,"BLISS BAKERY","Everyday Expenses:Spending Money","Everyday Expenses","Spending Money","BLISS BAKERY",$4.00,$0.00,C,$17.44
"Venture Card",,,11/07/2015,"SQ *THE COFFEE HOUSE","Everyday Expenses:Coffee Shop","Everyday Expenses","Coffee Shop","SQ *THE COFFEE HOUSE",$4.10,$0.00,C,$13.34
"Venture Card",,,11/07/2015,"APL* ITUNES.COM/BILL","Everyday Expenses:Spending Money","Everyday Expenses","Spending Money","APL* ITUNES.COM/BILL",$10.96,$0.00,C,$2.38
"Venture Card",,,11/07/2015,"USPS 30516605029105202","Everyday Expenses:Spending Money","Everyday Expenses","Spending Money","USPS 30516605029105202",$19.99,$0.00,C,-$17.61
"Venture Card",,,11/07/2015,"CHEESEBURGER IN PRDS","Everyday Expenses:Spending Money","Everyday Expenses","Spending Money","CHEESEBURGER IN PRDS",$25.97,$0.00,C,-$43.58
"Venture Card",,,11/07/2015,"EL POTRERO MEXICAN RESTAU","Everyday Expenses:Spending Money","Everyday Expenses","Spending Money","EL POTRERO MEXICAN RESTAU",$45.98,$0.00,C,-$89.56
"Venture Card",,,11/07/2015,"APPLE STORE #R190","Everyday Expenses:Misc","Everyday Expenses","Misc","APPLE STORE #R190",$116.63,$0.00,C,-$206.19
"Venture Card",,,11/09/2015,"AIRBNB INC","Savings Goals:Vacation & Travel","Savings Goals","Vacation & Travel","AIRBNB INC",$0.00,$430.00,C,$223.81
"Venture Card",,,11/09/2015,"SQ *THE COFFEE HOUSE","Everyday Expenses:Coffee Shop","Everyday Expenses","Coffee Shop","SQ *THE COFFEE HOUSE",$3.55,$0.00,C,$220.26
"Venture Card",,,11/09/2015,"SQ *THE COFFEE HOUSE","Everyday Expenses:Coffee Shop","Everyday Expenses","Coffee Shop","SQ *THE COFFEE HOUSE",$9.86,$0.00,C,$210.40
"Venture Card",,,11/09/2015,"AMAZON.COM AMZN.COM/BILL","Everyday Expenses:Spending Money","Everyday Expenses","Spending Money","AMAZON.COM AMZN.COM/BILL",$9.91,$0.00,C,$200.49
"Venture Card",,,11/09/2015,"GHOST PERSONAL","Monthly Bills:Web Stuff","Monthly Bills","Web Stuff","GHOST PERSONAL",$10.00,$0.00,C,$190.49
"Venture Card",,,11/09/2015,"PANERA BREAD #1374","Everyday Expenses:Spending Money","Everyday Expenses","Spending Money","PANERA BREAD #1374",$10.46,$0.00,C,$180.03
"Venture Card",,,11/09/2015,"MELLOW MUSHROOM","Everyday Expenses:Spending Money","Everyday Expenses","Spending Money","MELLOW MUSHROOM",$10.75,$0.00,C,$169.28
"Venture Card",,,11/09/2015,"BRUEGGERS #258","Everyday Expenses:Spending Money","Everyday Expenses","Spending Money","BRUEGGERS #258",$11.54,$0.00,C,$157.74
"Venture Card",,,11/09/2015,"THE CASK - LINCOLN","Everyday Expenses:Spending Money","Everyday Expenses","Spending Money","THE CASK - LINCOLN",$14.75,$0.00,C,$142.99
"Venture Card",,,11/09/2015,"SEBASTIAN'S TABLE","Everyday Expenses:Spending Money","Everyday Expenses","Spending Money","SEBASTIAN'S TABLE",$15.13,$0.00,C,$127.86
"Venture Card",,,11/09/2015,"MELLOW MUSHROOM","Everyday Expenses:Spending Money","Everyday Expenses","Spending Money","MELLOW MUSHROOM",$35.16,$0.00,C,$92.70
"Venture Card",,,11/09/2015,"COMCAST CALIFORNIA","Monthly Bills:Internet","Monthly Bills","Internet","COMCAST CALIFORNIA",$77.83,$0.00,C,$14.87
"Venture Card",,,11/09/2015,"NATURAL GROCERS","Everyday Expenses:Groceries","Everyday Expenses","Groceries","NATURAL GROCERS",$104.02,$0.00,C,-$89.15
"Venture Card",,,11/09/2015,"AIRBNB INC","Savings Goals:Vacation & Travel","Savings Goals","Vacation & Travel","AIRBNB INC",$477.00,$0.00,C,-$566.15
"Venture Card",,,11/09/2015,"AIRBNB INC","Savings Goals:Vacation & Travel","Savings Goals","Vacation & Travel","AIRBNB INC",$482.00,$0.00,C,-$1048.15
"Venture Card",,,11/10/2015,"MODCLOTH","Everyday Expenses:Clothing","Everyday Expenses","Clothing","MODCLOTH",$2.19,$0.00,C,-$1050.34
"Venture Card",,,11/10/2015,"SQ *THE MILL IN THE HAYMA","Everyday Expenses:Coffee Shop","Everyday Expenses","Coffee Shop","SQ *THE MILL IN THE HAYMA",$3.25,$0.00,C,-$1053.59
"Venture Card",,,11/10/2015,"BARRYMORES LOUNGE","Everyday Expenses:Spending Money","Everyday Expenses","Spending Money","BARRYMORES LOUNGE",$7.55,$0.00,C,-$1061.14
"Venture Card",,,11/11/2015,"CAPITAL ONE ONLINE PYMT","Pre-YNAB Debt:Venture Card","Pre-YNAB Debt","Venture Card","CAPITAL ONE ONLINE PYMT AuthDate 11-NOV",$0.00,$1000.00,C,-$61.14
"Venture Card",,,11/11/2015,"SQ *CULTIVA","Everyday Expenses:Spending Money","Everyday Expenses","Spending Money","SQ *CULTIVA",$4.80,$0.00,C,-$65.94
"Venture Card",,,11/12/2015,"SQ *THE COFFEE HOUSE","Everyday Expenses:Coffee Shop","Everyday Expenses","Coffee Shop","SQ *THE COFFEE HOUSE",$3.28,$0.00,C,-$69.22
"Venture Card",,,11/12/2015,"LINCOLN GRAND CINEMAS-24","Everyday Expenses:Spending Money","Everyday Expenses","Spending Money","LINCOLN GRAND CINEMAS-24",$10.00,$0.00,C,-$79.22
"Venture Card",,,11/12/2015,"WALGREENS #0541","Everyday Expenses:Household Goods","Everyday Expenses","Household Goods","WALGREENS #0541",$18.20,$0.00,C,-$97.42
"Venture Card",,,11/13/2015,"CAPITAL ONE ONLINE PYMT","Pre-YNAB Debt:Venture Card","Pre-YNAB Debt","Venture Card","CAPITAL ONE ONLINE PYMT AuthDate 13-NOV",$0.00,$157.39,C,$59.97
"Venture Card",,,11/13/2015,"SQ *THE MILL IN THE HAYMA","Everyday Expenses:Coffee Shop","Everyday Expenses","Coffee Shop","SQ *THE MILL IN THE HAYMA",$2.95,$0.00,C,$57.02
"Venture Card",,,11/13/2015,"SQ *THE MILL IN THE HAYMA","Everyday Expenses:Coffee Shop","Everyday Expenses","Coffee Shop","SQ *THE MILL IN THE HAYMA",$3.10,$0.00,C,$53.92
"Venture Card",,,11/13/2015,"SQ *MAGGIE'S CAFE","Everyday Expenses:Spending Money","Everyday Expenses","Spending Money","SQ *MAGGIE'S CAFE",$24.21,$0.00,C,$29.71
"Venture Card",,,11/13/2015,"AMAZON MKTPLACE PMTS","Everyday Expenses:Misc","Everyday Expenses","Misc","AMAZON MKTPLACE PMTS",$707.99,$0.00,C,-$678.28
"Venture Card",,,11/14/2015,"SQ *THE MILL IN THE HAYMA","Everyday Expenses:Coffee Shop","Everyday Expenses","Coffee Shop","SQ *THE MILL IN THE HAYMA",$3.50,$0.00,C,-$681.78
"Venture Card",,,11/14/2015,"SQ *THE COFFEE HOUSE","Everyday Expenses:Coffee Shop","Everyday Expenses","Coffee Shop","SQ *THE COFFEE HOUSE",$4.10,$0.00,C,-$685.88
"Venture Card",,,11/14/2015,"WALGREENS #0541","Everyday Expenses:Household Goods","Everyday Expenses","Household Goods","WALGREENS #0541",$7.50,$0.00,C,-$693.38
"Venture Card",,,11/16/2015,"CAPITAL ONE ONLINE PYMT","Pre-YNAB Debt:Venture Card","Pre-YNAB Debt","Venture Card","CAPITAL ONE ONLINE PYMT AuthDate 15-NOV",$0.00,$753.35,C,$59.97
"Venture Card",,,11/16/2015,"HLU*Hulu 22744533-U","Monthly Bills:Web Stuff","Monthly Bills","Web Stuff","HLU*Hulu 22744533-U",$11.99,$0.00,C,$47.98
"Venture Card",,,11/16/2015,"PANERA BREAD #1374","Everyday Expenses:Spending Money","Everyday Expenses","Spending Money","PANERA BREAD #1374",$15.06,$0.00,C,$32.92
"Venture Card",,,11/16/2015,"DOCS PLACE","Everyday Expenses:Spending Money","Everyday Expenses","Spending Money","DOCS PLACE",$19.00,$0.00,C,$13.92
"Venture Card",,,11/16/2015,"THE GREEN GATEAU","Everyday Expenses:Spending Money","Everyday Expenses","Spending Money","THE GREEN GATEAU",$41.93,$0.00,C,-$28.01
"Venture Card",,,11/16/2015,"BUFFALO WILD WINGS DOWNTO","Everyday Expenses:Spending Money","Everyday Expenses","Spending Money","BUFFALO WILD WINGS DOWNTO",$83.99,$0.00,C,-$112.00
"Venture Card",,,11/16/2015,"NATURAL GROCERS","Everyday Expenses:Groceries","Everyday Expenses","Groceries","NATURAL GROCERS",$113.56,$0.00,C,-$225.56
"Venture Card",,,11/16/2015,"AT&T*BILL PAYMENT","Monthly Bills:Cell Phone","Monthly Bills","Cell Phone","AT&T*BILL PAYMENT",$116.79,$0.00,C,-$342.35
"Venture Card",,,11/16/2015,"EBAY INC.","Everyday Expenses:Misc","Everyday Expenses","Misc","EBAY INC.",$208.80,$0.00,C,-$551.15
"Venture Card",,,11/17/2015,"CAPITAL ONE ONLINE PYMT","Pre-YNAB Debt:Venture Card","Pre-YNAB Debt","Venture Card","CAPITAL ONE ONLINE PYMT AuthDate 17-NOV",$0.00,$611.12,C,$59.97
"Venture Card",,,11/17/2015,"SQ *THE COFFEE HOUSE","Everyday Expenses:Coffee Shop","Everyday Expenses","Coffee Shop","SQ *THE COFFEE HOUSE",$4.55,$0.00,C,$55.42
"Venture Card",,,11/17/2015,"LAZZARIS DOWNTOWN","Everyday Expenses:Spending Money","Everyday Expenses","Spending Money","LAZZARIS DOWNTOWN",$7.66,$0.00,C,$47.76
"Venture Card",,,11/17/2015,"AMAZON MKTPLACE PMTS","Everyday Expenses:Spending Money","Everyday Expenses","Spending Money","AMAZON MKTPLACE PMTS",$19.99,$0.00,C,$27.77
"Venture Card",,,11/18/2015,"SQ *THE MILL IN THE HAYMA","Everyday Expenses:Coffee Shop","Everyday Expenses","Coffee Shop","SQ *THE MILL IN THE HAYMA",$1.95,$0.00,C,$25.82
"Venture Card",,,11/18/2015,"SQ *THE COFFEE HOUSE","Everyday Expenses:Coffee Shop","Everyday Expenses","Coffee Shop","SQ *THE COFFEE HOUSE",$3.55,$0.00,C,$22.27
"Venture Card",,,11/18/2015,"APL* ITUNES.COM/BILL","Everyday Expenses:Spending Money","Everyday Expenses","Spending Money","APL* ITUNES.COM/BILL",$3.98,$0.00,C,$18.29
"Venture Card",,,11/18/2015,"ADY*Spotify 148326869085-","Monthly Bills:Web Stuff","Monthly Bills","Web Stuff","ADY*Spotify 148326869085-",$9.99,$0.00,C,$8.30
"Venture Card",,,11/18/2015,"JUICE STOP Q ST","Everyday Expenses:Spending Money","Everyday Expenses","Spending Money","JUICE STOP Q ST",$12.55,$0.00,C,-$4.25
"Venture Card",,,11/18/2015,"WALGREENS #0541","Everyday Expenses:Household Goods","Everyday Expenses","Household Goods","WALGREENS #0541",$41.89,$0.00,C,-$46.14
"Venture Card",,,11/18/2015,"ELLE ESTHETICS","Everyday Expenses:Health & Fitness","Everyday Expenses","Health & Fitness","ELLE ESTHETICS",$55.00,$0.00,C,-$101.14
"Venture Card",,,11/19/2015,"SQ *THE COFFEE HOUSE","Everyday Expenses:Coffee Shop","Everyday Expenses","Coffee Shop","SQ *THE COFFEE HOUSE",$4.55,$0.00,C,-$105.69
"Venture Card",,,11/19/2015,"WAHOOS FISH TACOS - LI","Everyday Expenses:Spending Money","Everyday Expenses","Spending Money","WAHOOS FISH TACOS - LI",$17.06,$0.00,C,-$122.75
"Venture Card",,,11/19/2015,"AMAZON MKTPLACE PMTS","Everyday Expenses:Spending Money","Everyday Expenses","Spending Money","AMAZON MKTPLACE PMTS",$19.95,$0.00,C,-$142.70
"Venture Card",,,11/20/2015,"CAPITAL ONE ONLINE PYMT","Pre-YNAB Debt:Venture Card","Pre-YNAB Debt","Venture Card","CAPITAL ONE ONLINE PYMT AuthDate 20-NOV",$0.00,$202.67,C,$59.97
"Venture Card",,,11/20/2015,"SQ *THE MILL IN THE HAYMA","Everyday Expenses:Coffee Shop","Everyday Expenses","Coffee Shop","SQ *THE MILL IN THE HAYMA",$3.60,$0.00,C,$56.37
"Venture Card",,,11/20/2015,"QDOBA MEXICAN GRILL-647","Everyday Expenses:Spending Money","Everyday Expenses","Spending Money","QDOBA MEXICAN GRILL-647",$17.06,$0.00,C,$39.31
"Venture Card",,,11/20/2015,"AIRBNB INC","Savings Goals:Vacation & Travel","Savings Goals","Vacation & Travel","AIRBNB INC",$73.00,$0.00,C,-$33.69
"Venture Card",,,11/21/2015,"SQ *CRESCENT MOON COFFEE","Everyday Expenses:Coffee Shop","Everyday Expenses","Coffee Shop","SQ *CRESCENT MOON COFFEE",$2.08,$0.00,C,-$35.77
"Venture Card",,,11/21/2015,"SQ *CULTIVA","Everyday Expenses:Coffee Shop","Everyday Expenses","Coffee Shop","SQ *CULTIVA",$3.77,$0.00,C,-$39.54
"Venture Card",,,11/21/2015,"BARRYMORES LOUNGE","Everyday Expenses:Spending Money","Everyday Expenses","Spending Money","BARRYMORES LOUNGE",$29.50,$0.00,C,-$69.04
"Venture Card",,,11/21/2015,"GAP ONLINE","Everyday Expenses:Clothing","Everyday Expenses","Clothing","GAP ONLINE",$83.56,$0.00,C,-$152.60
"Venture Card",,,11/23/2015,"CAPITAL ONE ONLINE PYMT","Pre-YNAB Debt:Venture Card","Pre-YNAB Debt","Venture Card","CAPITAL ONE ONLINE PYMT AuthDate 23-NOV",$0.00,$212.57,C,$59.97
"Venture Card",,,11/23/2015,"GAP US 2760","Everyday Expenses:Clothing","Everyday Expenses","Clothing","GAP US 2760",$0.00,$42.87,C,$102.84
"Venture Card",,,11/23/2015,"SQ *THE MILL IN THE HAYMA","Everyday Expenses:Coffee Shop","Everyday Expenses","Coffee Shop","SQ *THE MILL IN THE HAYMA",$6.20,$0.00,C,$96.64
"Venture Card",,,11/23/2015,"PANERA BREAD #1374","Everyday Expenses:Spending Money","Everyday Expenses","Spending Money","PANERA BREAD #1374",$8.07,$0.00,C,$88.57
"Venture Card",,,11/23/2015,"ADY*Spotify 151054587085-","Monthly Bills:Web Stuff","Monthly Bills","Web Stuff","ADY*Spotify 151054587085-",$9.99,$0.00,C,$78.58
"Venture Card",,,11/23/2015,"JOYSTICKS","Everyday Expenses:Spending Money","Everyday Expenses","Spending Money","JOYSTICKS",$10.00,$0.00,C,$68.58
"Venture Card",,,11/23/2015,"OLD CHICAGO LINCOLN","Everyday Expenses:Spending Money","Everyday Expenses","Spending Money","OLD CHICAGO LINCOLN",$15.61,$0.00,C,$52.97
"Venture Card",,,11/23/2015,"OMAHA ZOO ONSITE","Everyday Expenses:Spending Money","Everyday Expenses","Spending Money","OMAHA ZOO ONSITE",$27.90,$0.00,C,$25.07
"Venture Card",,,11/23/2015,"DOZO SUSHI GRILL","Everyday Expenses:Spending Money","Everyday Expenses","Spending Money","DOZO SUSHI GRILL",$30.16,$0.00,C,-$5.09
"Venture Card",,,11/23/2015,"SQ *ESCAPE LINCOLN","Everyday Expenses:Spending Money","Everyday Expenses","Spending Money","SQ *ESCAPE LINCOLN",$42.80,$0.00,C,-$47.89
"Venture Card",,,11/23/2015,"MODCLOTH","Everyday Expenses:Clothing","Everyday Expenses","Clothing","MODCLOTH",$44.69,$0.00,C,-$92.58
"Venture Card",,,11/23/2015,"MELLOW MUSHROOM","Everyday Expenses:Spending Money","Everyday Expenses","Spending Money","MELLOW MUSHROOM",$54.94,$0.00,C,-$147.52
"Venture Card",,,11/23/2015,"MODCLOTH","Everyday Expenses:Clothing","Everyday Expenses","Clothing","MODCLOTH",$57.27,$0.00,C,-$204.79
"Venture Card",,,11/23/2015,"NATURAL GROCERS","Everyday Expenses:Groceries","Everyday Expenses","Groceries","NATURAL GROCERS",$83.88,$0.00,C,-$288.67
"Venture Card",,,11/24/2015,"WALGREENS #0541","Everyday Expenses:Household Goods","Everyday Expenses","Household Goods","WALGREENS #0541",$11.24,$0.00,C,-$299.91
"Venture Card",,,11/24/2015,"LINCOLN GRAND CINEMAS-24","Everyday Expenses:Spending Money","Everyday Expenses","Spending Money","LINCOLN GRAND CINEMAS-24",$20.00,$0.00,C,-$319.91
"Venture Card",,,11/25/2015,"SQ *THE COFFEE HOUSE","Everyday Expenses:Coffee Shop","Everyday Expenses","Coffee Shop","SQ *THE COFFEE HOUSE",$3.55,$0.00,C,-$323.46
"Venture Card",,,11/25/2015,"THE FLATWATER BISTRO","Everyday Expenses:Spending Money","Everyday Expenses","Spending Money","THE FLATWATER BISTRO",$24.28,$0.00,C,-$347.74
"Venture Card",,,11/27/2015,"LOVES TRAVEL S00006213","Everyday Expenses:Transportation","Everyday Expenses","Transportation","LOVES TRAVEL S00006213",$6.82,$0.00,C,-$354.56
"Venture Card",,,11/27/2015,"SUBWAY 00234104","Everyday Expenses:Spending Money","Everyday Expenses","Spending Money","SUBWAY 00234104",$7.78,$0.00,C,-$362.34
"Venture Card",,,11/27/2015,"BREAK TIME 3125","Everyday Expenses:Transportation","Everyday Expenses","Transportation","BREAK TIME 3125",$8.14,$0.00,C,-$370.48
"Venture Card",,,11/27/2015,"CHIPOTLE 2213","Everyday Expenses:Spending Money","Everyday Expenses","Spending Money","CHIPOTLE 2213",$14.25,$0.00,C,-$384.73
"Venture Card",,,11/27/2015,"HONEST ABES","Everyday Expenses:Spending Money","Everyday Expenses","Spending Money","HONEST ABES",$19.10,$0.00,C,-$403.83
"Venture Card",,,11/27/2015,"THE OVEN","Everyday Expenses:Spending Money","Everyday Expenses","Spending Money","THE OVEN",$24.00,$0.00,C,-$427.83
"Venture Card",,,11/27/2015,"THE HAPPY RAVEN","Everyday Expenses:Spending Money","Everyday Expenses","Spending Money","THE HAPPY RAVEN",$26.00,$0.00,C,-$453.83
"Venture Card",,,11/27/2015,"U-STOP #6","Everyday Expenses:Spending Money","Everyday Expenses","Spending Money","U-STOP #6",$26.07,$0.00,C,-$479.90
"Venture Card",,,11/27/2015,"KROGER #386","Everyday Expenses:Groceries","Everyday Expenses","Groceries","KROGER #386",$57.85,$0.00,C,-$537.75
"Venture Card",,,11/28/2015,"CVS/PHARMACY #10281","Everyday Expenses:Household Goods","Everyday Expenses","Household Goods","CVS/PHARMACY #10281",$39.44,$0.00,C,-$577.19
"Venture Card",,,11/30/2015,"WAL-MART #0019","Everyday Expenses:Spending Money","Everyday Expenses","Spending Money","WAL-MART #0019",$10.62,$0.00,C,-$587.81
"Venture Card",,,11/30/2015,"THE WINE RACK JAVA STOP","Everyday Expenses:Spending Money","Everyday Expenses","Spending Money","THE WINE RACK JAVA STOP",$15.75,$0.00,C,-$603.56
"Venture Card",,,11/30/2015,"LONG JOHN SILVERS - A&W","Everyday Expenses:Spending Money","Everyday Expenses","Spending Money","LONG JOHN SILVERS - A&W",$16.29,$0.00,C,-$619.85
"Venture Card",,,11/30/2015,"WAL-MART #0019","Everyday Expenses:Spending Money","Everyday Expenses","Spending Money","WAL-MART #0019",$16.82,$0.00,C,-$636.67
"Venture Card",,,11/30/2015,"TIOS MEXICAN BAR & GRILL","Everyday Expenses:Spending Money","Everyday Expenses","Spending Money","TIOS MEXICAN BAR & GRILL",$17.20,$0.00,C,-$653.87
"Venture Card",,,11/30/2015,"MODCLOTH","Everyday Expenses:Clothing","Everyday Expenses","Clothing","MODCLOTH",$42.47,$0.00,C,-$696.34
"Venture Card",,,11/30/2015,"MARSHALLS #1301","Everyday Expenses:Clothing","Everyday Expenses","Clothing","MARSHALLS #1301",$47.74,$0.00,C,-$744.08
"Venture Card",,,11/30/2015,"SCHNUCKS #743","Everyday Expenses:Groceries","Everyday Expenses","Groceries","SCHNUCKS #743",$73.07,$0.00,C,-$817.15
"Venture Card",,,12/01/2015,"CAPITAL ONE ONLINE PYMT AuthDate 01-D EC","Pre-YNAB Debt:Venture Card","Pre-YNAB Debt","Venture Card","CAPITAL ONE ONLINE PYMT AuthDate 01-D EC",$0.00,$877.12,C,$59.97
"Venture Card",,,12/01/2015,"PANERA BREAD # 601733","Everyday Expenses:Spending Money","Everyday Expenses","Spending Money","PANERA BREAD # 601733",$12.63,$0.00,C,$47.34
"Venture Card",,,12/01/2015,"KROGER #386","Everyday Expenses:Groceries","Everyday Expenses","Groceries","KROGER #386",$15.21,$0.00,C,$32.13
"Venture Card",,,12/02/2015,"THE BREAD COMPANY","Everyday Expenses:Spending Money","Everyday Expenses","Spending Money","THE BREAD COMPANY",$2.16,$0.00,C,$29.97
"Venture Card",,,12/02/2015,"THE BREAD COMPANY","Everyday Expenses:Spending Money","Everyday Expenses","Spending Money","THE BREAD COMPANY",$3.25,$0.00,C,$26.72
"Venture Card",,,12/02/2015,"THE BREAD COMPANY","Everyday Expenses:Spending Money","Everyday Expenses","Spending Money","THE BREAD COMPANY",$6.62,$0.00,C,$20.10
"Venture Card",,,12/02/2015,"THE BREAD COMPANY","Everyday Expenses:Spending Money","Everyday Expenses","Spending Money","THE BREAD COMPANY",$8.74,$0.00,C,$11.36
"Venture Card",,,12/02/2015,"THE WINE RACK JAVA STOP","Everyday Expenses:Spending Money","Everyday Expenses","Spending Money","THE WINE RACK JAVA STOP",$9.26,$0.00,C,$2.10
"Venture Card",,,12/02/2015,"EXXONMOBIL 97548705","Everyday Expenses:Transportation","Everyday Expenses","Transportation","EXXONMOBIL 97548705",$24.13,$0.00,C,-$22.03
"Venture Card",,,12/02/2015,"SQ *EXOTIC GRILL","Everyday Expenses:Spending Money","Everyday Expenses","Spending Money","SQ *EXOTIC GRILL",$26.09,$0.00,C,-$48.12
"Venture Card",,,12/02/2015,"COMCAST CALIFORN CS 1X","Monthly Bills:Internet","Monthly Bills","Internet","COMCAST CALIFORN CS 1X",$77.83,$0.00,C,-$125.95
"Venture Card",,,12/03/2015,"WAL-MART #0019","Everyday Expenses:Spending Money","Everyday Expenses","Spending Money","WAL-MART #0019",$10.72,$0.00,C,-$136.67
"Venture Card",,,12/03/2015,"COLTONS - POPLAR B","Everyday Expenses:Spending Money","Everyday Expenses","Spending Money","COLTONS - POPLAR B",$22.42,$0.00,C,-$159.09
"Venture Card",,,12/04/2015,"WAL-MART #7127","Everyday Expenses:Spending Money","Everyday Expenses","Spending Money","WAL-MART #7127",$7.42,$0.00,C,-$166.51
"Venture Card",,,12/04/2015,"KROGER #386","Everyday Expenses:Groceries","Everyday Expenses","Groceries","KROGER #386",$27.61,$0.00,C,-$194.12
"Venture Card",,,12/04/2015,"STATUE CRUISES","Savings Goals:Vacation & Travel","Savings Goals","Vacation & Travel","STATUE CRUISES",$72.00,$0.00,C,-$266.12
"Venture Card",,,12/05/2015,"TIOS MEXICAN BAR & GRILL","Everyday Expenses:Spending Money","Everyday Expenses","Spending Money","TIOS MEXICAN BAR & GRILL",$23.60,$0.00,C,-$289.72
"Venture Card",,,12/05/2015,"KROGER #386","Everyday Expenses:Groceries","Everyday Expenses","Groceries","KROGER #386",$42.52,$0.00,C,-$332.24
"Venture Card",,,12/05/2015,"HARP'S #272","Everyday Expenses:Groceries","Everyday Expenses","Groceries","HARP'S #272",$58.81,$0.00,C,-$391.05
"Venture Card",,,12/07/2015,"CAPITAL ONE MOBILE PYMT AuthDate 05-D EC","Pre-YNAB Debt:Venture Card","Pre-YNAB Debt","Venture Card","CAPITAL ONE MOBILE PYMT AuthDate 05-D EC",$0.00,$451.02,C,$59.97
"Venture Card",,,12/07/2015,"APPLEBEES 810997881965","Everyday Expenses:Spending Money","Everyday Expenses","Spending Money","APPLEBEES 810997881965",$7.52,$0.00,C,$52.45
"Venture Card",,,12/07/2015,"SQ *VIBE COFFEE","Everyday Expenses:Coffee Shop","Everyday Expenses","Coffee Shop","SQ *VIBE COFFEE",$7.67,$0.00,C,$44.78
"Venture Card",,,12/07/2015,"BREAK TIME 3125","Everyday Expenses:Transportation","Everyday Expenses","Transportation","BREAK TIME 3125",$10.00,$0.00,C,$34.78
"Venture Card",,,12/07/2015,"THE JUICE CAFE","Everyday Expenses:Spending Money","Everyday Expenses","Spending Money","THE JUICE CAFE",$11.85,$0.00,C,$22.93
"Venture Card",,,12/07/2015,"MARATHON PETRO189704","Everyday Expenses:Spending Money","Everyday Expenses","Spending Money","MARATHON PETRO189704",$12.11,$0.00,C,$10.82
"Venture Card",,,12/07/2015,"KROGER #386","Everyday Expenses:Groceries","Everyday Expenses","Groceries","KROGER #386",$12.69,$0.00,C,-$1.87
"Venture Card",,,12/07/2015,"CVS/PHARMACY #10281","Everyday Expenses:Groceries","Everyday Expenses","Groceries","CVS/PHARMACY #10281",$17.71,$0.00,C,-$19.58
"Venture Card",,,12/07/2015,"HASTINGS 9878 POPLARB","Everyday Expenses:Spending Money","Everyday Expenses","Spending Money","HASTINGS 9878 POPLARB",$19.55,$0.00,C,-$39.13
"Venture Card",,,12/07/2015,"WM SUPERCENTER #19","Everyday Expenses:Spending Money","Everyday Expenses","Spending Money","WM SUPERCENTER #19",$27.50,$0.00,C,-$66.63
"Venture Card",,,12/07/2015,"THE BEE HIVE","Everyday Expenses:Groceries","Everyday Expenses","Groceries","THE BEE HIVE",$35.80,$0.00,C,-$102.43
"Venture Card",,,12/08/2015,"PILOT 00006601","Everyday Expenses:Transportation","Everyday Expenses","Transportation","PILOT 00006601",$7.43,$0.00,C,-$109.86
"Venture Card",,,12/08/2015,"GHOST PERSONAL","Monthly Bills:Web Stuff","Monthly Bills","Web Stuff","GHOST PERSONAL",$10.00,$0.00,C,-$119.86
"Venture Card",,,12/08/2015,"ROXIES","Everyday Expenses:Spending Money","Everyday Expenses","Spending Money","ROXIES",$21.35,$0.00,C,-$141.21
"Venture Card",,,12/09/2015,"CAPITAL ONE ONLINE PYMT AuthDate 09-D EC","Pre-YNAB Debt:Venture Card","Pre-YNAB Debt","Venture Card","CAPITAL ONE ONLINE PYMT AuthDate 09-D EC",$0.00,$201.18,C,$59.97
"Venture Card",,,12/09/2015,"7-ELEVEN 33089","Everyday Expenses:Spending Money","Everyday Expenses","Spending Money","7-ELEVEN 33089",$4.68,$0.00,C,$55.29
"Venture Card",,,12/09/2015,"POPEYE'S #12021","Everyday Expenses:Spending Money","Everyday Expenses","Spending Money","POPEYE'S #12021",$8.47,$0.00,C,$46.82
"Venture Card",,,12/09/2015,"POPEYE'S #12021","Everyday Expenses:Spending Money","Everyday Expenses","Spending Money","POPEYE'S #12021",$8.70,$0.00,C,$38.12
"Venture Card",,,12/09/2015,"7-ELEVEN 33089","Everyday Expenses:Spending Money","Everyday Expenses","Spending Money","7-ELEVEN 33089",$15.25,$0.00,C,$22.87
"Venture Card",,,12/09/2015,"WALGREENS #7675","Everyday Expenses:Household Goods","Everyday Expenses","Household Goods","WALGREENS #7675",$16.83,$0.00,C,$6.04
"Venture Card",,,12/09/2015,"THE CORNUCOPIA CAFE","Everyday Expenses:Spending Money","Everyday Expenses","Spending Money","THE CORNUCOPIA CAFE",$20.99,$0.00,C,-$14.95
"Venture Card",,,12/09/2015,"SQ *NO 7 SUB","Everyday Expenses:Spending Money","Everyday Expenses","Spending Money","SQ *NO 7 SUB",$25.59,$0.00,C,-$40.54
"Venture Card",,,12/09/2015,"TROPHY BAR","Everyday Expenses:Spending Money","Everyday Expenses","Spending Money","TROPHY BAR",$43.00,$0.00,C,-$83.54
"Venture Card",,,12/10/2015,"THE PIT","Everyday Expenses:Spending Money","Everyday Expenses","Spending Money","THE PIT",$10.00,$0.00,C,-$93.54
"Venture Card",,,12/10/2015,"PIT EAST","Everyday Expenses:Spending Money","Everyday Expenses","Spending Money","PIT EAST",$12.00,$0.00,C,-$105.54
"Venture Card",,,12/10/2015,"MTA MVM*FLUSHING AVENUE","Everyday Expenses:Transportation","Everyday Expenses","Transportation","MTA MVM*FLUSHING AVENUE",$20.00,$0.00,C,-$125.54
"Venture Card",,,12/10/2015,"MTA MVM*FLUSHING AVENUE","Everyday Expenses:Transportation","Everyday Expenses","Transportation","MTA MVM*FLUSHING AVENUE",$20.00,$0.00,C,-$145.54
"Venture Card",,,12/10/2015,"BEST PIZZA","Everyday Expenses:Spending Money","Everyday Expenses","Spending Money","BEST PIZZA",$24.50,$0.00,C,-$170.04
"Venture Card",,,12/10/2015,"LIVE BAIT","Everyday Expenses:Spending Money","Everyday Expenses","Spending Money","LIVE BAIT",$29.08,$0.00,C,-$199.12
"Venture Card",,,12/10/2015,"MODCLOTH","Everyday Expenses:Clothing","Everyday Expenses","Clothing","MODCLOTH",$54.68,$0.00,C,-$253.80
"Venture Card",,,12/10/2015,"GALARZASUAREZ LLC","Everyday Expenses:Spending Money","Everyday Expenses","Spending Money","GALARZASUAREZ LLC",$60.42,$0.00,C,-$314.22
"Venture Card",,,12/11/2015,"BISTRO FARE","Everyday Expenses:Spending Money","Everyday Expenses","Spending Money","BISTRO FARE",$8.44,$0.00,C,-$322.66
"Venture Card",,,12/11/2015,"MTA MVM*N501A-47-50 STS","Everyday Expenses:Transportation","Everyday Expenses","Transportation","MTA MVM*N501A-47-50 STS",$10.00,$0.00,C,-$332.66
"Venture Card",,,12/11/2015,"MOUNTAIN PROVINCE","Everyday Expenses:Spending Money","Everyday Expenses","Spending Money","MOUNTAIN PROVINCE",$21.50,$0.00,C,-$354.16
"Venture Card",,,12/11/2015,"MODCLOTH","Everyday Expenses:Clothing","Everyday Expenses","Clothing","MODCLOTH",$27.30,$0.00,C,-$381.46
"Venture Card",,,12/11/2015,"MODCLOTH","Everyday Expenses:Clothing","Everyday Expenses","Clothing","MODCLOTH",$101.73,$0.00,C,-$483.19
"Venture Card",,,12/12/2015,"NEW YORK DELI","Everyday Expenses:Spending Money","Everyday Expenses","Spending Money","NEW YORK DELI",$6.00,$0.00,C,-$489.19
"Venture Card",,,12/12/2015,"DONATH WINES","Everyday Expenses:Spending Money","Everyday Expenses","Spending Money","DONATH WINES",$11.98,$0.00,C,-$501.17
"Venture Card",,,12/12/2015,"AMERICAN APPAREL-200FLE","Everyday Expenses:Clothing","Everyday Expenses","Clothing","AMERICAN APPAREL-200FLE",$36.00,$0.00,C,-$537.17
"Venture Card",,,12/12/2015,"BEST BUY MHT 00015313","Everyday Expenses:Spending Money","Everyday Expenses","Spending Money","BEST BUY MHT 00015313",$54.42,$0.00,C,-$591.59
"Venture Card",,,12/14/2015,"CAPITAL ONE ONLINE PYMT","Pre-YNAB Debt:Venture Card","Pre-YNAB Debt","Venture Card","CAPITAL ONE ONLINE PYMT AuthDate 13-DEC",$0.00,$651.56,C,$59.97
"Venture Card",,,12/14/2015,"APL* ITUNES.COM/BILL","Everyday Expenses:Spending Money","Everyday Expenses","Spending Money","APL* ITUNES.COM/BILL",$1.99,$0.00,C,$57.98
"Venture Card",,,12/14/2015,"7-ELEVEN 35857","Everyday Expenses:Spending Money","Everyday Expenses","Spending Money","7-ELEVEN 35857",$4.08,$0.00,C,$53.90
"Venture Card",,,12/14/2015,"US GAS","Everyday Expenses:Transportation","Everyday Expenses","Transportation","US GAS",$5.26,$0.00,C,$48.64
"Venture Card",,,12/14/2015,"KROGER #536","Everyday Expenses:Groceries","Everyday Expenses","Groceries","KROGER #536",$8.81,$0.00,C,$39.83
"Venture Card",,,12/14/2015,"MTA MVM*MARCY AVENUE &","Everyday Expenses:Transportation","Everyday Expenses","Transportation","MTA MVM*MARCY AVENUE &",$10.00,$0.00,C,$29.83
"Venture Card",,,12/14/2015,"SHELL OIL 91002545419","Everyday Expenses:Transportation","Everyday Expenses","Transportation","SHELL OIL 91002545419",$12.01,$0.00,C,$17.82
"Venture Card",,,12/14/2015,"KROGER #536","Everyday Expenses:Groceries","Everyday Expenses","Groceries","KROGER #536",$13.74,$0.00,C,$4.08
"Venture Card",,,12/14/2015,"GOOD NATURED LLC","Everyday Expenses:Spending Money","Everyday Expenses","Spending Money","GOOD NATURED LLC",$13.77,$0.00,C,-$9.69
"Venture Card",,,12/14/2015,"SHELL OIL 91002545419","Everyday Expenses:Transportation","Everyday Expenses","Transportation","SHELL OIL 91002545419",$14.20,$0.00,C,-$23.89
"Venture Card",,,12/14/2015,"VANESSA'S DUMPLING HOU","Everyday Expenses:Spending Money","Everyday Expenses","Spending Money","VANESSA'S DUMPLING HOU",$15.50,$0.00,C,-$39.39
"Venture Card",,,12/14/2015,"WAL-MART #0678","Everyday Expenses:Groceries","Everyday Expenses","Groceries","WAL-MART #0678",$15.50,$0.00,C,-$54.89
"Venture Card",,,12/14/2015,"MAUZY LIBERTY","Everyday Expenses:Spending Money","Everyday Expenses","Spending Money","MAUZY LIBERTY",$17.00,$0.00,C,-$71.89
"Venture Card",,,12/14/2015,"OTHA'S COFFEE","Everyday Expenses:Spending Money","Everyday Expenses","Spending Money","OTHA'S COFFEE",$19.29,$0.00,C,-$91.18
"Venture Card",,,12/14/2015,"WM SUPERCENTER #678","Everyday Expenses:Spending Money","Everyday Expenses","Spending Money","WM SUPERCENTER #678",$23.76,$0.00,C,-$114.94
"Venture Card",,,12/14/2015,"GOOD NATURED LLC","Everyday Expenses:Spending Money","Everyday Expenses","Spending Money","GOOD NATURED LLC",$25.42,$0.00,C,-$140.36
"Venture Card",,,12/14/2015,"ZOOMIN PARABO PRESS","Everyday Expenses:Spending Money","Everyday Expenses","Spending Money","ZOOMIN PARABO PRESS",$30.50,$0.00,C,-$170.86
"Venture Card",,,12/14/2015,"THE CELLAR NYC","Everyday Expenses:Spending Money","Everyday Expenses","Spending Money","THE CELLAR NYC",$34.49,$0.00,C,-$205.35
"Venture Card",,,12/14/2015,"GRUBHUBCHEERSTHAIREST","Everyday Expenses:Spending Money","Everyday Expenses","Spending Money","GRUBHUBCHEERSTHAIREST",$43.07,$0.00,C,-$248.42
"Venture Card",,,12/14/2015,"MELLOW MUSHROOM GTLNBRG","Everyday Expenses:Spending Money","Everyday Expenses","Spending Money","MELLOW MUSHROOM GTLNBRG",$79.51,$0.00,C,-$327.93
"Venture Card",,,12/15/2015,"KROGER #536","Everyday Expenses:Groceries","Everyday Expenses","Groceries","KROGER #536",$7.28,$0.00,C,-$335.21
"Venture Card",,,12/15/2015,"THE COASTER","Savings Goals:Vacation & Travel","Savings Goals","Vacation & Travel","THE COASTER",$10.00,$0.00,C,-$345.21
"Venture Card",,,12/15/2015,"TABLES FOR TWO, LLC","Everyday Expenses:Spending Money","Everyday Expenses","Spending Money","TABLES FOR TWO, LLC",$20.64,$0.00,C,-$365.85
"Venture Card",,,12/15/2015,"SAWYERS MOUNTAIN GRILL","Everyday Expenses:Spending Money","Everyday Expenses","Spending Money","SAWYERS MOUNTAIN GRILL",$23.79,$0.00,C,-$389.64
"Venture Card",,,12/15/2015,"IN *FORT FUN","Everyday Expenses:Spending Money","Everyday Expenses","Spending Money","IN *FORT FUN",$33.50,$0.00,C,-$423.14
"Venture Card",,,12/15/2015,"BEST ITALIAN CAFE & PI","Everyday Expenses:Spending Money","Everyday Expenses","Spending Money","BEST ITALIAN CAFE & PI",$41.01,$0.00,C,-$464.15
"Venture Card",,,12/15/2015,"KROGER #536","Everyday Expenses:Groceries","Everyday Expenses","Groceries","KROGER #536",$52.87,$0.00,C,-$517.02
"Venture Card",,,12/15/2015,"AT&T*BILL PAYMENT","Monthly Bills:Cell Phone","Monthly Bills","Cell Phone","AT&T*BILL PAYMENT",$131.65,$0.00,C,-$648.67
